,customer_id,quantity,subtotal,tax,total,order_id,created_at
0,409,2,598,77,675,1,2021-01-01 00:13:22
1,917,2,459,59,518,2,2021-01-01 00:57:44
2,743,5,1625,211,1836,3,2021-01-01 02:06:11
3,585,3,597,77,674,4,2021-01-01 03:53:29
4,774,3,478,62,540,5,2021-01-01 04:14:19
5,662,6,1405,182,1587,6,2021-01-01 05:20:58
6,60,3,697,90,787,7,2021-01-01 05:37:32
7,855,2,498,64,562,8,2021-01-01 08:14:53
8,728,5,1725,224,1949,9,2021-01-01 08:15:02
9,268,2,498,64,562,10,2021-01-01 09:48:58
10,116,2,598,77,675,11,2021-01-01 10:58:23
11,408,2,898,116,1014,12,2021-01-01 11:00:52
12,299,2,798,103,901,13,2021-01-01 11:03:12
13,272,3,1347,175,1522,14,2021-01-01 12:55:11
14,782,3,827,107,934,15,2021-01-01 13:23:43
15,589,3,797,103,900,16,2021-01-01 13:54:56
16,736,1,699,90,789,17,2021-01-01 15:01:19
17,443,2,1098,142,1240,18,2021-01-01 15:33:22
18,500,2,659,85,744,19,2021-01-01 16:44:36
19,753,2,659,85,744,20,2021-01-01 19:20:53
20,729,3,658,85,743,21,2021-01-01 22:06:58
21,519,3,808,105,913,22,2021-01-01 23:46:56
22,165,3,1127,146,1273,23,2021-01-02 01:27:07
23,470,5,1495,194,1689,24,2021-01-02 02:30:00
24,716,3,558,72,630,25,2021-01-02 04:21:59
25,14,2,598,77,675,26,2021-01-02 05:23:58
26,447,2,459,59,518,27,2021-01-02 07:16:31
27,664,2,429,55,484,28,2021-01-02 07:16:43
28,769,3,727,94,821,29,2021-01-02 09:36:52
29,796,2,698,90,788,30,2021-01-02 11:33:05
30,454,3,558,72,630,31,2021-01-02 11:44:16
31,156,1,399,51,450,32,2021-01-02 13:47:51
32,42,3,528,68,596,33,2021-01-02 16:17:09
33,210,5,1545,200,1745,34,2021-01-02 17:52:57
34,559,2,898,116,1014,35,2021-01-02 18:14:08
35,76,2,448,58,506,36,2021-01-02 19:18:32
36,558,3,1047,136,1183,37,2021-01-02 20:42:23
37,787,3,658,85,743,38,2021-01-02 22:32:33
38,561,3,647,84,731,39,2021-01-02 23:59:35
39,949,3,747,97,844,40,2021-01-03 00:10:18
40,94,2,898,116,1014,41,2021-01-03 01:31:38
41,279,3,647,84,731,42,2021-01-03 02:01:50
42,824,5,1645,213,1858,43,2021-01-03 02:19:44
43,725,1,699,90,789,44,2021-01-03 03:15:53
44,435,2,459,59,518,45,2021-01-03 03:20:42
45,959,2,898,116,1014,46,2021-01-03 03:30:42
46,5,3,578,75,653,47,2021-01-03 06:06:10
47,70,3,428,55,483,48,2021-01-03 08:41:03
48,135,3,727,94,821,49,2021-01-03 10:20:48
49,760,1,399,51,450,50,2021-01-03 12:42:47
50,824,3,597,77,674,51,2021-01-03 14:17:55
51,624,3,647,84,731,52,2021-01-03 14:46:29
52,533,2,1098,142,1240,53,2021-01-03 16:43:07
53,254,6,1824,237,2061,54,2021-01-03 17:46:40
54,360,3,578,75,653,55,2021-01-03 19:30:13
55,330,2,648,84,732,56,2021-01-03 19:46:24
56,683,2,798,103,901,57,2021-01-03 19:53:35
57,570,2,698,90,788,58,2021-01-03 21:08:50
58,965,3,727,94,821,59,2021-01-03 21:47:41
59,335,5,1795,233,2028,60,2021-01-03 22:33:53
60,421,2,1098,142,1240,61,2021-01-03 23:02:26
61,567,3,688,89,777,62,2021-01-03 23:13:33
62,925,6,1475,191,1666,63,2021-01-04 00:46:39
63,649,3,1247,162,1409,64,2021-01-04 03:16:27
64,536,3,797,103,900,65,2021-01-04 04:03:42
65,737,3,1327,172,1499,66,2021-01-04 06:41:10
66,892,2,459,59,518,67,2021-01-04 06:55:05
67,636,2,898,116,1014,68,2021-01-04 09:38:00
68,636,2,898,116,1014,68,2021-01-04 09:38:00
69,938,5,1286,167,1453,69,2021-01-04 12:16:20
70,425,3,1047,136,1183,70,2021-01-04 12:05:28
71,15,3,827,107,934,71,2021-01-04 14:12:10
72,276,2,698,90,788,72,2021-01-04 13:14:02
73,427,3,578,75,653,73,2021-01-04 14:37:31
74,477,2,329,42,371,74,2021-01-04 14:14:46
75,598,3,797,103,900,75,2021-01-04 17:22:25
76,120,2,898,116,1014,76,2021-01-04 14:44:26
77,870,2,498,64,562,77,2021-01-04 19:09:16
78,291,3,658,85,743,78,2021-01-04 17:15:12
79,627,2,448,58,506,79,2021-01-04 19:28:15
80,970,2,898,116,1014,80,2021-01-04 18:17:20
81,259,3,1247,162,1409,81,2021-01-04 20:03:45
82,637,3,997,129,1126,82,2021-01-04 19:25:19
83,479,2,598,77,675,83,2021-01-04 22:19:15
84,955,5,1147,149,1296,84,2021-01-04 20:03:06
85,232,2,598,77,675,85,2021-01-05 00:00:17
86,833,2,459,59,518,86,2021-01-04 21:46:47
87,531,3,658,85,743,87,2021-01-05 00:02:53
88,452,3,888,115,1003,88,2021-01-04 23:09:39
89,69,3,1047,136,1183,89,2021-01-05 02:33:10
90,214,4,1726,224,1950,90,2021-01-04 23:43:57
91,634,3,727,94,821,91,2021-01-05 03:42:59
92,760,1,499,64,563,92,2021-01-05 02:18:07
93,351,3,747,97,844,93,2021-01-05 03:46:04
94,584,5,1545,200,1745,94,2021-01-05 05:03:56
95,716,3,897,116,1013,95,2021-01-05 04:50:29
96,81,2,848,110,958,96,2021-01-05 05:42:03
97,143,3,727,94,821,97,2021-01-05 05:30:45
98,912,3,558,72,630,98,2021-01-05 06:02:11
99,805,3,797,103,900,99,2021-01-05 07:32:42
100,923,3,597,77,674,100,2021-01-05 07:37:08
101,818,1,499,64,563,101,2021-01-05 08:56:35
102,116,3,847,110,957,102,2021-01-05 08:38:28
103,72,2,548,71,619,103,2021-01-05 11:41:41
104,99,2,898,116,1014,104,2021-01-05 10:07:20
105,600,3,1127,146,1273,105,2021-01-05 12:56:42
106,7,2,1098,142,1240,106,2021-01-05 12:33:37
107,417,3,1027,133,1160,107,2021-01-05 15:01:23
108,603,3,558,72,630,108,2021-01-05 14:17:04
109,163,3,1127,146,1273,109,2021-01-05 15:11:45
110,227,3,747,97,844,110,2021-01-05 14:19:40
111,474,5,1156,150,1306,111,2021-01-05 17:23:52
112,701,3,428,55,483,112,2021-01-05 16:43:53
113,162,2,698,90,788,113,2021-01-05 17:25:13
114,198,3,1047,136,1183,114,2021-01-05 17:39:12
115,596,3,927,120,1047,115,2021-01-05 18:40:21
116,148,4,1446,187,1633,116,2021-01-05 18:44:08
117,346,3,997,129,1126,117,2021-01-05 20:28:04
118,359,2,898,116,1014,118,2021-01-05 20:34:52
119,172,3,688,89,777,119,2021-01-05 20:59:34
120,514,3,927,120,1047,120,2021-01-05 22:35:23
121,819,3,897,116,1013,121,2021-01-05 21:40:00
122,995,3,1027,133,1160,122,2021-01-05 23:08:51
123,455,3,697,90,787,123,2021-01-05 22:44:08
124,779,2,598,77,675,124,2021-01-06 01:06:28
125,265,3,1047,136,1183,125,2021-01-05 23:56:30
126,633,3,608,79,687,126,2021-01-06 01:40:58
127,147,3,747,97,844,127,2021-01-06 01:24:48
128,349,6,1444,187,1631,128,2021-01-06 02:10:04
129,657,5,1226,159,1385,129,2021-01-06 01:57:39
130,84,3,658,85,743,130,2021-01-06 04:50:24
131,506,2,659,85,744,131,2021-01-06 03:17:19
132,829,2,459,59,518,132,2021-01-06 05:31:35
133,658,2,1098,142,1240,133,2021-01-06 05:12:12
134,231,2,498,64,562,134,2021-01-06 05:36:08
135,238,6,1424,185,1609,135,2021-01-06 07:58:36
136,964,3,808,105,913,136,2021-01-06 08:17:24
137,852,3,597,77,674,137,2021-01-06 09:20:36
138,833,3,478,62,540,138,2021-01-06 10:47:17
139,529,3,597,77,674,139,2021-01-06 10:24:11
140,497,3,558,72,630,140,2021-01-06 13:02:16
141,411,2,598,77,675,141,2021-01-06 11:34:36
142,908,3,1127,146,1273,142,2021-01-06 14:00:02
143,646,3,727,94,821,143,2021-01-06 12:20:38
144,820,4,1626,211,1837,144,2021-01-06 16:17:46
145,938,2,548,71,619,145,2021-01-06 12:36:15
146,662,4,846,109,955,146,2021-01-06 18:11:54
147,297,3,808,105,913,147,2021-01-06 14:09:48
148,198,2,498,64,562,148,2021-01-06 19:18:09
149,240,3,558,72,630,149,2021-01-06 15:48:38
150,7,1,149,19,168,150,2021-01-06 19:29:47
151,639,3,608,79,687,151,2021-01-06 17:52:25
152,249,3,578,75,653,152,2021-01-06 19:56:14
153,360,1,499,64,563,153,2021-01-06 20:11:12
154,309,3,697,90,787,154,2021-01-06 21:23:10
155,302,5,1545,200,1745,155,2021-01-06 21:05:06
156,152,3,827,107,934,156,2021-01-06 23:48:05
157,908,3,797,103,900,157,2021-01-06 23:46:38
158,456,2,628,81,709,158,2021-01-07 01:40:14
159,584,2,659,85,744,159,2021-01-07 00:22:29
160,444,3,478,62,540,160,2021-01-07 03:59:48
161,786,3,758,98,856,161,2021-01-07 03:04:52
162,124,4,896,116,1012,162,2021-01-07 04:42:46
163,189,2,898,116,1014,163,2021-01-07 04:54:09
164,515,3,747,97,844,164,2021-01-07 05:35:13
165,584,2,1098,142,1240,165,2021-01-07 05:40:03
166,982,3,897,116,1013,166,2021-01-07 05:43:21
167,701,6,1574,204,1778,167,2021-01-07 07:42:33
168,169,3,1027,133,1160,168,2021-01-07 07:15:12
169,754,3,997,129,1126,169,2021-01-07 08:42:39
170,693,3,1197,155,1352,170,2021-01-07 08:21:17
171,777,1,149,19,168,171,2021-01-07 10:10:01
172,315,3,558,72,630,172,2021-01-07 08:53:41
173,196,3,1197,155,1352,173,2021-01-07 11:49:01
174,295,3,727,94,821,174,2021-01-07 11:16:36
175,309,3,1127,146,1273,175,2021-01-07 12:27:13
176,972,1,399,51,450,176,2021-01-07 13:41:39
177,272,3,747,97,844,177,2021-01-07 14:48:04
178,365,3,927,120,1047,178,2021-01-07 14:44:32
179,376,3,1327,172,1499,179,2021-01-07 17:14:22
180,292,2,798,103,901,180,2021-01-07 15:17:36
181,647,3,558,72,630,181,2021-01-07 18:05:08
182,316,5,1087,141,1228,182,2021-01-07 17:08:30
183,428,1,99,12,111,183,2021-01-07 19:08:59
184,424,3,827,107,934,184,2021-01-07 18:10:11
185,204,2,698,90,788,185,2021-01-07 21:36:47
186,476,6,1474,191,1665,186,2021-01-07 19:58:18
187,970,2,698,90,788,187,2021-01-07 22:20:18
188,183,2,1098,142,1240,188,2021-01-07 20:11:41
189,869,2,1098,142,1240,189,2021-01-07 23:17:33
190,801,3,997,129,1126,190,2021-01-07 21:57:50
191,929,5,1076,139,1215,191,2021-01-08 01:10:17
192,378,6,1854,241,2095,192,2021-01-08 00:13:06
193,815,5,1026,133,1159,193,2021-01-08 03:34:10
194,389,5,1117,145,1262,194,2021-01-08 02:15:57
195,814,3,597,77,674,195,2021-01-08 06:16:21
196,756,4,1346,174,1520,196,2021-01-08 03:02:55
197,422,3,747,97,844,197,2021-01-08 08:53:24
198,915,2,429,55,484,198,2021-01-08 03:24:57
199,481,2,498,64,562,199,2021-01-08 09:40:03
200,663,3,1247,162,1409,200,2021-01-08 06:00:35
201,957,2,748,97,845,201,2021-01-08 11:39:27
202,32,3,1327,172,1499,202,2021-01-08 07:59:10
203,439,5,1245,161,1406,203,2021-01-08 12:11:46
204,152,3,947,123,1070,204,2021-01-08 08:41:18
205,315,2,528,68,596,205,2021-01-08 13:27:57
206,234,3,558,72,630,206,2021-01-08 10:02:38
207,227,2,798,103,901,207,2021-01-08 15:40:14
208,473,6,2094,272,2366,208,2021-01-08 11:28:52
209,222,2,648,84,732,209,2021-01-08 17:45:14
210,149,5,1355,176,1531,210,2021-01-08 13:14:33
211,482,5,1195,155,1350,211,2021-01-08 19:14:07
212,78,3,947,123,1070,212,2021-01-08 14:47:14
213,14,3,1327,172,1499,213,2021-01-08 19:18:17
214,927,2,598,77,675,214,2021-01-08 16:05:02
215,353,5,1156,150,1306,215,2021-01-08 20:28:36
216,685,3,608,79,687,216,2021-01-08 17:49:56
217,545,3,647,84,731,217,2021-01-08 23:08:45
218,279,2,898,116,1014,218,2021-01-08 18:18:51
219,931,3,558,72,630,219,2021-01-09 00:09:39
220,370,5,1695,220,1915,220,2021-01-08 19:42:56
221,246,3,827,107,934,221,2021-01-09 01:28:20
222,508,3,578,75,653,222,2021-01-08 21:53:40
223,462,3,997,129,1126,223,2021-01-09 01:55:38
224,232,5,1645,213,1858,224,2021-01-08 23:06:18
225,726,2,498,64,562,225,2021-01-09 03:27:45
226,478,3,827,107,934,226,2021-01-09 01:50:40
227,672,1,149,19,168,227,2021-01-09 06:05:18
228,268,3,997,129,1126,228,2021-01-09 04:02:51
229,97,3,827,107,934,229,2021-01-09 08:47:25
230,992,1,599,77,676,230,2021-01-09 05:58:14
231,299,2,598,77,675,231,2021-01-09 11:03:13
232,902,2,548,71,619,232,2021-01-09 06:04:31
233,564,3,797,103,900,233,2021-01-09 13:19:47
234,974,5,1456,189,1645,234,2021-01-09 06:20:20
235,80,3,528,68,596,235,2021-01-09 14:57:39
236,315,3,528,68,596,236,2021-01-09 06:54:44
237,817,3,558,72,630,237,2021-01-09 15:05:00
238,143,3,827,107,934,238,2021-01-09 07:03:01
239,864,3,827,107,934,239,2021-01-09 16:23:11
240,128,3,1327,172,1499,240,2021-01-09 08:52:32
241,414,3,478,62,540,241,2021-01-09 17:57:14
242,725,3,1127,146,1273,242,2021-01-09 09:21:48
243,273,2,1098,142,1240,243,2021-01-09 19:34:07
244,668,3,558,72,630,244,2021-01-09 09:57:40
245,825,3,608,79,687,245,2021-01-09 20:42:30
246,187,2,1098,142,1240,246,2021-01-09 11:50:47
247,910,2,498,64,562,247,2021-01-09 21:43:51
248,766,3,528,68,596,248,2021-01-09 13:19:43
249,511,3,747,97,844,249,2021-01-09 22:52:17
250,968,6,1605,208,1813,250,2021-01-09 14:15:27
251,706,2,898,116,1014,251,2021-01-10 00:31:12
252,144,3,597,77,674,252,2021-01-09 14:23:07
253,300,6,1544,200,1744,253,2021-01-10 01:09:53
254,460,3,1247,162,1409,254,2021-01-09 15:52:58
255,261,3,1247,162,1409,255,2021-01-10 02:23:28
256,360,3,658,85,743,256,2021-01-09 17:22:55
257,385,2,798,103,901,257,2021-01-10 02:30:54
258,513,3,1127,146,1273,258,2021-01-09 19:06:20
259,799,3,808,105,913,259,2021-01-10 04:39:09
260,531,3,888,115,1003,260,2021-01-09 20:56:22
261,154,3,797,103,900,261,2021-01-10 06:19:57
262,303,4,1346,174,1520,262,2021-01-09 21:00:13
263,226,3,1027,133,1160,263,2021-01-10 07:34:12
264,621,2,498,64,562,264,2021-01-09 22:45:45
265,85,2,848,110,958,265,2021-01-10 10:16:15
266,764,2,498,64,562,266,2021-01-09 23:36:21
267,702,3,827,107,934,267,2021-01-10 11:29:25
268,912,3,947,123,1070,268,2021-01-10 00:48:05
269,178,1,399,51,450,269,2021-01-10 14:14:03
270,808,3,658,85,743,270,2021-01-10 03:24:55
271,665,3,428,55,483,271,2021-01-10 16:55:00
272,376,3,697,90,787,272,2021-01-10 04:28:11
273,228,2,498,64,562,273,2021-01-10 18:15:44
274,187,3,608,79,687,274,2021-01-10 05:30:33
275,395,6,1036,134,1170,275,2021-01-10 18:43:51
276,927,2,848,110,958,276,2021-01-10 06:55:34
277,425,1,99,12,111,277,2021-01-10 19:04:11
278,871,3,697,90,787,278,2021-01-10 09:06:31
279,153,3,697,90,787,279,2021-01-10 20:42:01
280,989,3,558,72,630,280,2021-01-10 11:21:34
281,354,3,478,62,540,281,2021-01-10 23:04:58
282,52,3,997,129,1126,282,2021-01-10 12:15:53
283,401,3,697,90,787,283,2021-01-11 01:09:07
284,908,2,698,90,788,284,2021-01-10 14:42:49
285,201,2,659,85,744,285,2021-01-11 02:26:00
286,35,2,898,116,1014,286,2021-01-10 17:11:44
287,567,3,608,79,687,287,2021-01-11 04:43:04
288,339,5,1386,180,1566,288,2021-01-10 17:59:31
289,197,3,827,107,934,289,2021-01-11 05:22:26
290,941,3,897,116,1013,290,2021-01-10 19:40:46
291,879,3,897,116,1013,291,2021-01-11 06:44:32
292,950,3,558,72,630,292,2021-01-10 20:24:21
293,656,2,498,64,562,293,2021-01-11 07:55:21
294,75,2,598,77,675,294,2021-01-10 22:55:50
295,566,2,598,77,675,295,2021-01-11 09:11:15
296,529,3,997,129,1126,296,2021-01-11 01:21:23
297,422,2,798,103,901,297,2021-01-11 11:39:33
298,339,3,747,97,844,298,2021-01-11 01:52:20
299,128,3,897,116,1013,299,2021-01-11 14:03:45
300,861,3,808,105,913,300,2021-01-11 03:16:53
301,763,2,698,90,788,301,2021-01-11 14:34:27
302,5,3,1197,155,1352,302,2021-01-11 04:01:06
303,744,3,797,103,900,303,2021-01-11 16:58:23
304,659,5,1625,211,1836,304,2021-01-11 04:25:42
305,964,2,459,59,518,305,2021-01-11 19:23:14
306,243,3,428,55,483,306,2021-01-11 04:47:16
307,610,3,727,94,821,307,2021-01-11 20:28:51
308,737,3,758,98,856,308,2021-01-11 07:04:30
309,114,3,1247,162,1409,309,2021-01-11 21:48:42
310,157,5,1325,172,1497,310,2021-01-11 08:15:22
311,427,2,748,97,845,311,2021-01-11 22:05:30
312,94,3,927,120,1047,312,2021-01-11 09:39:53
313,259,5,1445,187,1632,313,2021-01-11 23:51:53
314,810,2,898,116,1014,314,2021-01-11 11:55:21
315,466,3,1127,146,1273,315,2021-01-12 00:31:21
316,551,2,659,85,744,316,2021-01-11 12:49:45
317,82,2,898,116,1014,317,2021-01-12 01:03:58
318,18,3,697,90,787,318,2021-01-11 15:15:40
319,909,3,888,115,1003,319,2021-01-12 03:48:33
320,153,3,808,105,913,320,2021-01-11 15:37:43
321,609,3,697,90,787,321,2021-01-12 05:14:14
322,260,2,459,59,518,322,2021-01-11 17:54:09
323,449,3,608,79,687,323,2021-01-12 05:17:07
324,883,5,1256,163,1419,324,2021-01-11 18:25:50
325,578,2,598,77,675,325,2021-01-12 06:12:08
326,475,4,1626,211,1837,326,2021-01-11 19:00:20
327,304,3,827,107,934,327,2021-01-12 08:05:23
328,260,3,947,123,1070,328,2021-01-11 19:21:43
329,130,3,847,110,957,329,2021-01-12 09:51:37
330,706,3,1127,146,1273,330,2021-01-11 21:08:40
331,734,3,827,107,934,331,2021-01-12 11:15:11
332,803,3,428,55,483,332,2021-01-11 23:20:14
333,247,2,459,59,518,333,2021-01-12 13:10:31
334,416,3,927,120,1047,334,2021-01-11 23:31:24
335,167,3,827,107,934,335,2021-01-12 14:21:43
336,792,3,608,79,687,336,2021-01-12 02:10:18
337,659,3,1327,172,1499,337,2021-01-12 16:28:30
338,650,2,459,59,518,338,2021-01-12 04:19:51
339,153,5,1645,213,1858,339,2021-01-12 18:47:07
340,879,3,1127,146,1273,340,2021-01-12 05:56:05
341,643,3,688,89,777,341,2021-01-12 20:22:08
342,296,3,888,115,1003,342,2021-01-12 07:52:02
343,623,3,688,89,777,343,2021-01-12 23:04:13
344,498,3,888,115,1003,344,2021-01-12 09:52:37
345,298,2,429,55,484,345,2021-01-13 00:20:29
346,358,3,1047,136,1183,346,2021-01-12 10:53:32
347,944,4,1196,155,1351,347,2021-01-13 01:57:25
348,96,2,898,116,1014,348,2021-01-12 11:44:25
349,910,2,798,103,901,349,2021-01-13 03:51:41
350,783,3,997,129,1126,350,2021-01-12 12:29:20
351,679,2,498,64,562,351,2021-01-13 06:18:59
352,821,2,598,77,675,352,2021-01-12 14:42:57
353,479,3,1247,162,1409,353,2021-01-13 08:34:42
354,565,2,928,120,1048,354,2021-01-12 16:44:49
355,932,3,747,97,844,355,2021-01-13 10:05:47
356,263,2,598,77,675,356,2021-01-12 18:16:15
357,377,1,229,29,258,357,2021-01-13 11:18:40
358,880,5,1606,208,1814,358,2021-01-12 20:36:42
359,951,3,608,79,687,359,2021-01-13 11:35:47
360,960,2,598,77,675,360,2021-01-12 20:56:23
361,436,1,149,19,168,361,2021-01-13 13:44:51
362,848,2,898,116,1014,362,2021-01-12 21:29:40
363,756,2,429,55,484,363,2021-01-13 15:43:54
364,823,6,1555,202,1757,364,2021-01-12 22:49:37
365,334,3,888,115,1003,365,2021-01-13 16:30:00
366,709,2,898,116,1014,366,2021-01-13 00:34:04
367,347,3,997,129,1126,367,2021-01-13 17:05:49
368,550,2,429,55,484,368,2021-01-13 02:43:54
369,908,3,727,94,821,369,2021-01-13 18:19:18
370,939,3,927,120,1047,370,2021-01-13 03:22:49
371,951,2,548,71,619,371,2021-01-13 19:52:23
372,99,2,659,85,744,372,2021-01-13 05:48:43
373,266,2,659,85,744,373,2021-01-13 20:49:18
374,750,3,578,75,653,374,2021-01-13 06:02:51
375,648,3,658,85,743,375,2021-01-13 21:12:57
376,893,2,828,107,935,376,2021-01-13 06:13:31
377,538,3,747,97,844,377,2021-01-13 21:33:10
378,674,2,1098,142,1240,378,2021-01-13 07:19:04
379,50,2,598,77,675,379,2021-01-13 23:05:33
380,504,3,727,94,821,380,2021-01-13 09:15:58
381,204,3,947,123,1070,381,2021-01-13 23:54:14
382,891,1,229,29,258,382,2021-01-13 09:16:16
383,41,3,647,84,731,383,2021-01-14 00:41:53
384,434,3,1027,133,1160,384,2021-01-13 11:56:00
385,912,2,429,55,484,385,2021-01-14 02:42:44
386,912,2,429,55,484,385,2021-01-14 02:42:44
387,277,3,897,116,1013,386,2021-01-13 13:30:11
388,454,2,698,90,788,387,2021-01-14 03:44:25
389,208,3,478,62,540,388,2021-01-14 02:56:06
390,170,2,598,77,675,389,2021-01-13 15:01:06
391,917,5,1386,180,1566,390,2021-01-14 03:46:21
392,307,2,429,55,484,391,2021-01-14 05:34:59
393,827,3,997,129,1126,392,2021-01-13 16:32:12
394,364,3,927,120,1047,393,2021-01-14 06:02:24
395,922,6,1405,182,1587,394,2021-01-14 05:36:24
396,10,2,598,77,675,395,2021-01-13 18:27:32
397,979,3,1047,136,1183,396,2021-01-14 08:26:13
398,470,3,647,84,731,397,2021-01-14 07:08:32
399,11,3,797,103,900,398,2021-01-13 19:53:40
400,553,3,1027,133,1160,399,2021-01-14 09:30:59
401,669,3,658,85,743,400,2021-01-14 07:47:14
402,322,2,498,64,562,401,2021-01-13 20:41:33
403,74,2,598,77,675,402,2021-01-14 10:43:46
404,252,3,888,115,1003,403,2021-01-14 08:38:58
405,709,2,798,103,901,404,2021-01-13 22:30:59
406,593,3,827,107,934,405,2021-01-14 12:39:52
407,574,1,399,51,450,406,2021-01-14 08:41:19
408,885,3,578,75,653,407,2021-01-13 23:32:59
409,28,3,697,90,787,408,2021-01-14 13:15:53
410,370,4,1057,137,1194,409,2021-01-14 09:39:54
411,929,2,898,116,1014,410,2021-01-14 01:55:45
412,561,3,1327,172,1499,411,2021-01-14 14:42:55
413,228,3,947,123,1070,412,2021-01-14 11:19:45
414,18,3,827,107,934,413,2021-01-14 02:55:46
415,185,2,528,68,596,414,2021-01-14 16:09:56
416,662,3,558,72,630,415,2021-01-14 14:03:47
417,544,3,947,123,1070,416,2021-01-14 04:14:11
418,447,5,1345,174,1519,417,2021-01-14 16:43:03
419,671,3,1047,136,1183,418,2021-01-14 15:17:12
420,733,5,1425,185,1610,419,2021-01-14 06:13:04
421,425,2,329,42,371,420,2021-01-14 17:41:45
422,989,3,897,116,1013,421,2021-01-14 17:56:26
423,58,3,1247,162,1409,422,2021-01-14 06:41:54
424,889,2,698,90,788,423,2021-01-14 19:36:47
425,907,5,1495,194,1689,424,2021-01-14 18:18:36
426,512,3,927,120,1047,425,2021-01-14 06:57:16
427,311,3,947,123,1070,426,2021-01-14 21:15:48
428,381,3,727,94,821,427,2021-01-14 18:46:10
429,129,3,558,72,630,428,2021-01-14 07:12:59
430,789,3,827,107,934,429,2021-01-14 23:12:06
431,496,2,828,107,935,430,2021-01-14 20:06:13
432,615,3,1327,172,1499,431,2021-01-14 07:57:27
433,21,2,329,42,371,432,2021-01-15 00:21:25
434,749,3,558,72,630,433,2021-01-14 21:20:06
435,440,4,1326,172,1498,434,2021-01-14 08:36:04
436,628,2,828,107,935,435,2021-01-15 00:40:35
437,410,2,698,90,788,436,2021-01-14 23:30:05
438,135,3,847,110,957,437,2021-01-14 09:02:55
439,197,3,808,105,913,438,2021-01-15 00:51:06
440,12,6,2254,293,2547,439,2021-01-15 00:49:20
441,126,3,1047,136,1183,440,2021-01-14 11:02:54
442,125,3,1127,146,1273,441,2021-01-15 01:51:15
443,562,5,1825,237,2062,442,2021-01-15 01:15:36
444,269,3,428,55,483,443,2021-01-14 12:33:33
445,40,3,697,90,787,444,2021-01-15 02:44:06
446,242,3,747,97,844,445,2021-01-15 02:57:11
447,358,1,149,19,168,446,2021-01-14 15:06:59
448,323,1,399,51,450,447,2021-01-15 04:30:36
449,543,3,808,105,913,448,2021-01-15 03:33:59
450,139,2,828,107,935,449,2021-01-14 15:36:57
451,382,3,888,115,1003,450,2021-01-15 06:12:19
452,661,5,1506,195,1701,451,2021-01-15 03:48:33
453,157,5,1595,207,1802,452,2021-01-14 16:11:20
454,926,4,1296,168,1464,453,2021-01-15 06:25:00
455,18,3,827,107,934,454,2021-01-15 05:22:35
456,36,2,459,59,518,455,2021-01-14 18:08:16
457,40,6,1735,225,1960,456,2021-01-15 07:34:42
458,499,2,498,64,562,457,2021-01-15 07:45:45
459,26,3,747,97,844,458,2021-01-14 19:53:40
460,716,3,747,97,844,459,2021-01-15 09:35:16
461,840,3,558,72,630,460,2021-01-15 09:20:40
462,297,3,747,97,844,461,2021-01-14 20:28:34
463,262,3,1047,136,1183,462,2021-01-15 11:43:43
464,656,6,1466,190,1656,463,2021-01-15 11:08:16
465,572,3,997,129,1126,464,2021-01-14 22:04:19
466,913,2,548,71,619,465,2021-01-15 12:35:46
467,913,2,548,71,619,465,2021-01-15 12:35:46
468,839,3,897,116,1013,466,2021-01-15 12:01:12
469,71,4,1396,181,1577,467,2021-01-14 23:03:00
470,183,2,848,110,958,468,2021-01-15 14:35:13
471,383,3,688,89,777,469,2021-01-15 15:09:21
472,39,3,1127,146,1273,470,2021-01-15 13:07:20
473,956,2,798,103,901,471,2021-01-15 01:33:17
474,956,2,798,103,901,471,2021-01-15 01:33:17
475,737,2,1098,142,1240,472,2021-01-15 15:05:13
476,769,5,1545,200,1745,473,2021-01-15 16:52:48
477,979,3,808,105,913,474,2021-01-15 15:20:19
478,857,2,498,64,562,475,2021-01-15 04:13:29
479,346,6,1566,203,1769,476,2021-01-15 02:18:43
480,149,3,897,116,1013,477,2021-01-15 15:44:50
481,270,3,647,84,731,478,2021-01-15 17:39:52
482,180,2,898,116,1014,479,2021-01-15 15:46:48
483,121,2,598,77,675,480,2021-01-15 05:36:15
484,360,3,808,105,913,481,2021-01-15 04:28:22
485,223,1,229,29,258,482,2021-01-15 17:25:29
486,523,3,827,107,934,483,2021-01-15 17:50:04
487,60,3,558,72,630,484,2021-01-15 17:41:06
488,527,3,997,129,1126,485,2021-01-15 06:51:12
489,640,2,598,77,675,486,2021-01-15 06:40:58
490,724,3,827,107,934,487,2021-01-15 19:41:14
491,113,3,747,97,844,488,2021-01-15 18:31:21
492,709,3,808,105,913,489,2021-01-15 19:57:49
493,794,3,1127,146,1273,490,2021-01-15 08:30:06
494,506,3,558,72,630,491,2021-01-15 07:58:20
495,885,6,1444,187,1631,492,2021-01-15 21:35:36
496,337,5,1176,152,1328,493,2021-01-15 19:29:54
497,377,3,997,129,1126,494,2021-01-15 22:17:43
498,615,3,578,75,653,495,2021-01-15 09:24:52
499,967,4,1296,168,1464,496,2021-01-15 09:44:21
500,489,3,808,105,913,497,2021-01-16 00:17:55
501,113,2,928,120,1048,498,2021-01-15 20:14:11
502,104,2,598,77,675,499,2021-01-16 00:57:45
503,552,5,1176,152,1328,500,2021-01-15 11:08:05
504,988,2,459,59,518,501,2021-01-15 10:43:34
505,906,3,597,77,674,502,2021-01-16 01:45:21
506,793,3,947,123,1070,503,2021-01-15 22:24:20
507,900,3,528,68,596,504,2021-01-16 01:33:55
508,370,5,2045,265,2310,505,2021-01-15 11:22:27
509,911,2,398,51,449,506,2021-01-15 12:20:30
510,323,3,1127,146,1273,507,2021-01-16 02:28:59
511,338,3,428,55,483,508,2021-01-15 23:03:14
512,958,2,828,107,935,509,2021-01-16 01:38:54
513,925,3,947,123,1070,510,2021-01-15 11:34:21
514,642,1,229,29,258,511,2021-01-15 12:21:41
515,642,1,229,29,258,511,2021-01-15 12:21:41
516,87,3,578,75,653,512,2021-01-16 03:24:09
517,205,2,598,77,675,513,2021-01-15 23:58:05
518,463,2,329,42,371,514,2021-01-16 02:24:36
519,196,3,697,90,787,515,2021-01-15 13:01:42
520,568,3,428,55,483,516,2021-01-15 15:06:10
521,87,3,558,72,630,517,2021-01-15 14:26:34
522,988,2,329,42,371,518,2021-01-16 03:40:13
523,403,3,827,107,934,519,2021-01-16 01:23:54
524,772,2,459,59,518,520,2021-01-16 02:56:39
525,29,3,758,98,856,521,2021-01-15 15:44:19
526,764,3,927,120,1047,522,2021-01-15 16:08:46
527,300,2,459,59,518,523,2021-01-15 16:58:51
528,386,3,578,75,653,524,2021-01-16 04:19:51
529,536,3,1027,133,1160,525,2021-01-16 03:02:36
530,161,1,399,51,450,526,2021-01-16 03:12:08
531,884,2,698,90,788,527,2021-01-15 16:23:25
532,262,2,898,116,1014,528,2021-01-15 17:38:02
533,972,3,658,85,743,529,2021-01-15 17:02:20
534,550,2,429,55,484,530,2021-01-16 05:46:04
535,321,3,1127,146,1273,531,2021-01-16 05:25:36
536,459,2,498,64,562,532,2021-01-16 03:30:23
537,569,2,898,116,1014,533,2021-01-15 18:33:17
538,847,3,647,84,731,534,2021-01-15 19:30:01
539,782,3,997,129,1126,535,2021-01-15 19:30:12
540,555,2,698,90,788,536,2021-01-16 06:55:16
541,537,3,658,85,743,537,2021-01-16 07:49:38
542,635,3,1327,172,1499,538,2021-01-16 04:16:23
543,559,5,1906,247,2153,539,2021-01-15 20:51:51
544,454,6,1515,196,1711,540,2021-01-15 20:20:31
545,12,3,647,84,731,541,2021-01-15 19:48:21
546,682,2,429,55,484,542,2021-01-16 09:13:54
547,204,3,827,107,934,543,2021-01-16 08:43:41
548,732,2,659,85,744,544,2021-01-16 06:07:50
549,443,3,578,75,653,545,2021-01-15 22:29:36
550,387,4,1146,148,1294,546,2021-01-15 22:21:07
551,577,3,558,72,630,547,2021-01-15 21:21:36
552,601,3,1047,136,1183,548,2021-01-16 10:51:02
553,942,2,728,94,822,549,2021-01-16 10:29:52
554,420,2,548,71,619,550,2021-01-16 06:37:23
555,889,1,499,64,563,551,2021-01-16 00:51:29
556,85,3,897,116,1013,552,2021-01-16 00:59:09
557,354,2,459,59,518,553,2021-01-15 22:48:06
558,933,2,828,107,935,554,2021-01-16 12:24:27
559,557,1,229,29,258,555,2021-01-16 12:58:15
560,760,4,1446,187,1633,556,2021-01-16 06:58:05
561,994,3,658,85,743,557,2021-01-16 02:47:13
562,558,5,1406,182,1588,558,2021-01-16 01:41:45
563,521,3,927,120,1047,559,2021-01-15 23:09:29
564,831,3,997,129,1126,560,2021-01-16 14:25:40
565,864,3,1127,146,1273,561,2021-01-16 15:00:15
566,925,2,898,116,1014,562,2021-01-16 07:14:06
567,958,2,598,77,675,563,2021-01-16 05:08:35
568,764,2,498,64,562,564,2021-01-16 01:51:21
569,286,2,498,64,562,565,2021-01-16 01:56:08
570,987,5,1326,172,1498,566,2021-01-16 16:06:12
571,8,2,598,77,675,567,2021-01-16 17:06:30
572,796,5,1276,165,1441,568,2021-01-16 08:33:41
573,176,3,827,107,934,569,2021-01-16 06:31:04
574,433,3,997,129,1126,570,2021-01-16 03:55:02
575,722,2,329,42,371,571,2021-01-16 03:47:07
576,578,2,498,64,562,572,2021-01-16 16:48:36
577,132,2,598,77,675,573,2021-01-16 17:18:00
578,9,2,598,77,675,574,2021-01-16 11:14:46
579,400,3,747,97,844,575,2021-01-16 08:03:18
580,365,2,798,103,901,576,2021-01-16 05:37:50
581,987,2,898,116,1014,577,2021-01-16 03:56:01
582,411,2,928,120,1048,578,2021-01-16 19:20:55
583,88,3,1047,136,1183,579,2021-01-16 18:15:10
584,36,5,1795,233,2028,580,2021-01-16 12:06:32
585,323,3,947,123,1070,581,2021-01-16 08:55:02
586,114,2,928,120,1048,582,2021-01-16 07:16:42
587,434,3,528,68,596,583,2021-01-16 04:51:20
588,636,2,898,116,1014,584,2021-01-16 19:54:04
589,405,4,927,120,1047,585,2021-01-16 19:19:23
590,537,3,897,116,1013,586,2021-01-16 13:49:20
591,998,3,597,77,674,587,2021-01-16 09:28:42
592,496,4,927,120,1047,588,2021-01-16 08:03:19
593,553,3,797,103,900,589,2021-01-16 07:35:48
594,138,3,558,72,630,590,2021-01-16 21:01:20
595,346,3,747,97,844,591,2021-01-16 19:48:51
596,727,3,578,75,653,592,2021-01-16 16:05:30
597,799,3,578,75,653,593,2021-01-16 11:28:45
598,662,3,797,103,900,594,2021-01-16 09:21:43
599,750,3,558,72,630,595,2021-01-16 07:57:50
600,458,2,798,103,901,596,2021-01-16 21:06:10
601,596,3,947,123,1070,597,2021-01-16 22:30:21
602,350,2,898,116,1014,598,2021-01-16 18:18:49
603,531,3,1127,146,1273,599,2021-01-16 12:44:02
604,268,2,798,103,901,600,2021-01-16 09:28:19
605,624,3,528,68,596,601,2021-01-16 10:19:16
606,943,3,747,97,844,602,2021-01-16 23:50:32
607,168,3,697,90,787,603,2021-01-17 00:44:24
608,689,2,898,116,1014,604,2021-01-16 20:55:05
609,658,2,728,94,822,605,2021-01-16 13:26:10
610,270,3,997,129,1126,606,2021-01-16 09:36:28
611,183,2,798,103,901,607,2021-01-16 11:00:41
612,20,6,1355,176,1531,608,2021-01-17 01:11:09
613,550,3,1127,146,1273,609,2021-01-17 01:53:13
614,873,2,598,77,675,610,2021-01-16 23:19:41
615,644,5,1267,164,1431,611,2021-01-16 15:19:24
616,909,3,1197,155,1352,612,2021-01-16 09:47:57
617,815,2,598,77,675,613,2021-01-16 11:16:21
618,54,3,897,116,1013,614,2021-01-17 03:05:41
619,591,3,1247,162,1409,615,2021-01-17 02:46:05
620,561,3,888,115,1003,616,2021-01-17 01:15:00
621,517,3,608,79,687,617,2021-01-16 17:13:10
622,942,5,1256,163,1419,618,2021-01-16 10:28:38
623,615,3,1247,162,1409,619,2021-01-16 12:29:23
624,972,2,498,64,562,620,2021-01-17 04:06:01
625,85,1,699,90,789,621,2021-01-17 03:30:41
626,601,2,698,90,788,622,2021-01-17 02:33:12
627,329,3,647,84,731,623,2021-01-16 18:26:45
628,24,2,898,116,1014,624,2021-01-16 12:22:59
629,794,3,808,105,913,625,2021-01-16 13:06:16
630,133,3,947,123,1070,626,2021-01-17 04:51:44
631,329,4,1027,133,1160,627,2021-01-17 05:11:01
632,802,2,848,110,958,628,2021-01-17 05:06:21
633,231,2,459,59,518,629,2021-01-16 18:53:30
634,270,3,747,97,844,630,2021-01-16 12:27:47
635,270,3,747,97,844,630,2021-01-16 12:27:47
636,706,2,598,77,675,631,2021-01-16 14:13:02
637,557,2,429,55,484,632,2021-01-17 06:01:06
638,23,5,1725,224,1949,633,2021-01-17 06:40:57
639,443,3,697,90,787,634,2021-01-17 07:41:18
640,630,2,598,77,675,635,2021-01-16 20:59:32
641,604,3,758,98,856,636,2021-01-16 13:26:21
642,186,3,1047,136,1183,637,2021-01-16 12:35:01
643,962,3,827,107,934,638,2021-01-16 16:07:55
644,219,2,1098,142,1240,639,2021-01-17 07:41:19
645,4,5,1986,258,2244,640,2021-01-17 07:02:43
646,838,2,698,90,788,641,2021-01-17 08:21:51
647,937,3,888,115,1003,642,2021-01-16 21:59:04
648,99,5,1475,191,1666,643,2021-01-16 14:16:45
649,166,4,1496,194,1690,644,2021-01-16 13:03:32
650,61,1,229,29,258,645,2021-01-16 17:35:12
651,379,3,727,94,821,646,2021-01-17 10:05:06
652,860,1,399,51,450,647,2021-01-17 08:28:19
653,887,2,728,94,822,648,2021-01-17 10:01:27
654,119,2,898,116,1014,649,2021-01-17 00:05:49
655,124,3,688,89,777,650,2021-01-16 15:16:52
656,923,3,747,97,844,651,2021-01-16 15:37:33
657,63,2,898,116,1014,652,2021-01-16 20:13:11
658,906,6,2054,267,2321,653,2021-01-17 11:49:10
659,906,6,2054,267,2321,653,2021-01-17 11:49:10
660,990,3,747,97,844,654,2021-01-17 09:20:46
661,201,3,1047,136,1183,655,2021-01-17 10:32:01
662,716,2,498,64,562,656,2021-01-17 00:38:06
663,789,3,597,77,674,657,2021-01-16 17:47:55
664,152,2,798,103,901,658,2021-01-16 16:52:29
665,716,2,498,64,562,659,2021-01-16 20:22:06
666,905,2,598,77,675,660,2021-01-17 12:38:14
667,287,5,1276,165,1441,661,2021-01-17 14:19:30
668,950,2,498,64,562,662,2021-01-17 11:19:15
669,968,3,1127,146,1273,663,2021-01-17 10:50:19
670,472,6,1394,181,1575,664,2021-01-17 00:52:11
671,651,3,727,94,821,665,2021-01-16 17:57:42
672,738,2,459,59,518,666,2021-01-16 18:27:56
673,642,3,478,62,540,667,2021-01-16 20:34:49
674,674,2,898,116,1014,668,2021-01-17 14:03:36
675,461,6,1724,224,1948,669,2021-01-17 15:29:32
676,618,2,459,59,518,670,2021-01-17 12:39:14
677,713,2,628,81,709,671,2021-01-17 12:21:53
678,320,5,1147,149,1296,672,2021-01-17 02:49:37
679,601,2,598,77,675,673,2021-01-16 20:40:29
680,655,3,847,110,957,674,2021-01-16 20:44:51
681,245,1,149,19,168,675,2021-01-16 21:23:15
682,91,3,808,105,913,676,2021-01-17 15:37:52
683,992,3,688,89,777,677,2021-01-17 16:16:42
684,276,2,828,107,935,678,2021-01-17 14:05:51
685,666,3,1047,136,1183,679,2021-01-17 14:15:23
686,496,3,697,90,787,680,2021-01-17 03:10:09
687,390,5,1525,198,1723,681,2021-01-16 20:41:20
688,414,2,659,85,744,682,2021-01-16 21:54:24
689,752,2,498,64,562,683,2021-01-16 21:26:30
690,479,3,428,55,483,684,2021-01-17 15:39:12
691,386,2,548,71,619,685,2021-01-17 16:20:57
692,890,2,898,116,1014,686,2021-01-17 16:34:18
693,212,3,697,90,787,687,2021-01-17 14:20:11
694,243,2,598,77,675,688,2021-01-17 05:23:22
695,159,5,1426,185,1611,689,2021-01-16 21:42:16
696,820,2,459,59,518,690,2021-01-16 23:53:13
697,709,1,399,51,450,691,2021-01-16 22:23:27
698,52,3,888,115,1003,692,2021-01-17 17:19:10
699,243,3,608,79,687,693,2021-01-17 17:31:20
700,180,2,898,116,1014,694,2021-01-17 16:39:43
701,351,3,758,98,856,695,2021-01-17 16:11:45
702,971,3,1247,162,1409,696,2021-01-17 07:54:06
703,849,2,598,77,675,697,2021-01-16 22:40:08
704,591,2,898,116,1014,698,2021-01-17 02:12:36
705,833,3,688,89,777,699,2021-01-16 23:41:05
706,807,5,1795,233,2028,700,2021-01-17 19:39:14
707,985,2,698,90,788,701,2021-01-17 18:19:49
708,416,3,1247,162,1409,702,2021-01-17 19:23:10
709,478,2,898,116,1014,703,2021-01-17 16:25:48
710,11,1,399,51,450,704,2021-01-17 07:54:06
711,475,3,727,94,821,705,2021-01-16 23:20:44
712,909,1,599,77,676,706,2021-01-17 03:23:59
713,690,3,1047,136,1183,707,2021-01-17 00:07:39
714,328,3,578,75,653,708,2021-01-17 22:21:45
715,525,2,798,103,901,709,2021-01-17 18:43:03
716,661,5,1376,178,1554,710,2021-01-17 20:48:31
717,943,2,429,55,484,711,2021-01-17 18:44:11
718,294,2,659,85,744,712,2021-01-17 07:59:01
719,323,3,697,90,787,713,2021-01-17 00:00:27
720,292,3,827,107,934,714,2021-01-17 05:47:54
721,201,5,1356,176,1532,715,2021-01-17 00:30:53
722,664,3,578,75,653,716,2021-01-17 23:29:49
723,385,2,498,64,562,717,2021-01-17 20:45:13
724,894,5,1925,250,2175,718,2021-01-17 23:16:42
725,20,3,997,129,1126,719,2021-01-17 19:15:02
726,872,5,1555,202,1757,720,2021-01-17 09:24:51
727,702,3,428,55,483,721,2021-01-17 02:46:55
728,863,2,429,55,484,722,2021-01-17 07:21:40
729,658,3,847,110,957,723,2021-01-17 00:42:10
730,623,2,628,81,709,724,2021-01-18 01:45:54
731,221,1,229,29,258,725,2021-01-17 23:08:27
732,85,3,658,85,743,726,2021-01-17 23:47:19
733,517,4,907,117,1024,727,2021-01-17 19:59:11
734,61,3,947,123,1070,728,2021-01-17 12:02:48
735,933,3,997,129,1126,729,2021-01-17 03:29:44
736,42,3,558,72,630,730,2021-01-17 07:47:46
737,773,2,598,77,675,731,2021-01-17 02:55:51
738,485,1,699,90,789,732,2021-01-18 03:55:31
739,403,1,399,51,450,733,2021-01-18 00:45:07
740,244,4,1007,130,1137,734,2021-01-18 01:38:38
741,244,4,1007,130,1137,734,2021-01-18 01:38:38
742,124,5,1845,239,2084,735,2021-01-17 20:26:50
743,767,6,1935,251,2186,736,2021-01-17 13:17:25
744,420,3,888,115,1003,737,2021-01-17 03:56:12
745,562,5,2055,267,2322,738,2021-01-17 09:45:13
746,489,3,1327,172,1499,739,2021-01-17 04:03:21
747,298,1,299,38,337,740,2021-01-18 06:12:38
748,87,3,927,120,1047,741,2021-01-18 01:38:30
749,71,3,827,107,934,742,2021-01-18 02:54:18
750,497,2,498,64,562,743,2021-01-18 04:01:20
751,135,3,528,68,596,744,2021-01-17 20:31:20
752,11,5,1825,237,2062,745,2021-01-17 14:02:45
753,179,3,1047,136,1183,746,2021-01-17 04:50:02
754,898,3,947,123,1070,747,2021-01-17 10:04:32
755,432,6,1305,169,1474,748,2021-01-17 06:06:56
756,603,3,827,107,934,749,2021-01-18 08:03:07
757,28,3,697,90,787,750,2021-01-18 03:42:41
758,647,3,528,68,596,751,2021-01-18 05:10:08
759,747,2,898,116,1014,752,2021-01-18 04:25:21
760,91,2,498,64,562,753,2021-01-17 22:44:07
761,45,5,1745,226,1971,754,2021-01-17 15:55:04
762,137,3,1247,162,1409,755,2021-01-17 07:24:43
763,365,6,1305,169,1474,756,2021-01-17 12:28:48
764,390,3,558,72,630,757,2021-01-17 06:34:28
765,299,5,2145,278,2423,758,2021-01-18 08:22:16
766,351,3,797,103,900,759,2021-01-18 06:11:23
767,800,3,1327,172,1499,760,2021-01-18 07:29:46
768,817,2,598,77,675,761,2021-01-18 06:57:17
769,55,3,1047,136,1183,762,2021-01-18 00:29:08
770,707,2,459,59,518,763,2021-01-17 16:31:04
771,621,3,658,85,743,764,2021-01-17 08:12:09
772,352,3,1197,155,1352,765,2021-01-17 13:13:45
773,682,4,996,129,1125,766,2021-01-17 07:21:57
774,966,2,659,85,744,767,2021-01-18 10:56:43
775,230,5,1556,202,1758,768,2021-01-18 08:56:41
776,844,3,747,97,844,769,2021-01-18 09:59:16
777,413,3,997,129,1126,770,2021-01-18 09:00:37
778,55,2,1098,142,1240,771,2021-01-18 01:28:04
779,211,2,698,90,788,772,2021-01-17 17:08:59
780,251,5,1495,194,1689,773,2021-01-17 10:44:12
781,231,3,1127,146,1273,774,2021-01-17 15:56:42
782,314,2,598,77,675,775,2021-01-17 08:58:11
783,252,2,698,90,788,776,2021-01-18 12:26:38
784,85,5,1825,237,2062,777,2021-01-18 09:19:53
785,186,3,847,110,957,778,2021-01-18 10:27:06
786,559,3,997,129,1126,779,2021-01-18 09:16:53
787,777,3,1047,136,1183,780,2021-01-18 02:37:27
788,798,2,429,55,484,781,2021-01-17 18:16:38
789,637,2,898,116,1014,782,2021-01-17 12:32:41
790,637,2,898,116,1014,782,2021-01-17 12:32:41
791,228,3,997,129,1126,783,2021-01-17 17:38:25
792,588,2,898,116,1014,784,2021-01-17 09:59:40
793,108,3,758,98,856,785,2021-01-18 15:02:15
794,905,2,459,59,518,786,2021-01-18 10:03:03
795,313,2,598,77,675,787,2021-01-18 12:33:12
796,422,4,1426,185,1611,788,2021-01-18 11:17:55
797,700,2,459,59,518,789,2021-01-18 02:49:32
798,95,1,399,51,450,790,2021-01-17 19:44:13
799,388,3,847,110,957,791,2021-01-17 13:36:16
800,798,3,1047,136,1183,792,2021-01-17 13:14:52
801,427,3,597,77,674,793,2021-01-17 18:20:32
802,136,4,1226,159,1385,794,2021-01-17 10:41:21
803,296,3,697,90,787,795,2021-01-18 17:20:38
804,952,5,1895,246,2141,796,2021-01-18 11:35:18
805,836,2,728,94,822,797,2021-01-18 12:45:48
806,607,2,498,64,562,798,2021-01-18 11:40:41
807,942,1,149,19,168,799,2021-01-18 03:38:42
808,527,2,798,103,901,800,2021-01-17 21:08:49
809,696,3,528,68,596,801,2021-01-17 15:48:56
810,422,2,598,77,675,802,2021-01-17 14:09:13
811,387,3,1047,136,1183,803,2021-01-17 18:23:44
812,919,4,1526,198,1724,804,2021-01-17 11:48:20
813,235,3,827,107,934,805,2021-01-18 19:06:59
814,387,3,947,123,1070,806,2021-01-18 12:51:28
815,761,3,647,84,731,807,2021-01-18 13:37:19
816,446,3,1197,155,1352,808,2021-01-18 13:19:00
817,330,2,698,90,788,809,2021-01-18 05:50:14
818,788,3,947,123,1070,810,2021-01-17 22:09:15
819,880,3,727,94,821,811,2021-01-17 15:53:23
820,621,2,898,116,1014,812,2021-01-17 15:53:06
821,976,3,688,89,777,813,2021-01-17 18:48:53
822,63,1,599,77,676,814,2021-01-17 14:05:36
823,618,2,429,55,484,815,2021-01-18 20:20:50
824,636,3,727,94,821,816,2021-01-18 15:15:36
825,103,3,1247,162,1409,817,2021-01-18 15:48:52
826,188,3,478,62,540,818,2021-01-18 15:57:34
827,452,3,558,72,630,819,2021-01-18 08:30:28
828,919,3,688,89,777,820,2021-01-18 00:37:48
829,809,3,428,55,483,821,2021-01-17 15:58:40
830,985,4,1726,224,1950,822,2021-01-17 18:27:53
831,995,3,997,129,1126,823,2021-01-17 18:54:44
832,727,3,747,97,844,824,2021-01-17 14:07:27
833,892,3,558,72,630,825,2021-01-18 21:11:45
834,617,3,747,97,844,826,2021-01-18 16:33:21
835,400,1,399,51,450,827,2021-01-18 18:23:41
836,400,1,399,51,450,827,2021-01-18 18:23:41
837,627,2,598,77,675,828,2021-01-18 16:06:55
838,87,2,898,116,1014,829,2021-01-18 10:55:59
839,807,3,597,77,674,830,2021-01-18 03:21:52
840,807,1,399,51,450,831,2021-01-17 17:45:01
841,659,5,1845,239,2084,832,2021-01-17 18:33:26
842,971,3,927,120,1047,833,2021-01-17 19:53:49
843,735,3,1027,133,1160,834,2021-01-17 15:32:42
844,137,6,1794,233,2027,835,2021-01-18 21:46:52
845,884,3,697,90,787,836,2021-01-18 18:38:09
846,884,3,697,90,787,836,2021-01-18 18:38:09
847,64,3,597,77,674,837,2021-01-18 19:09:19
848,562,3,608,79,687,838,2021-01-18 19:41:44
849,204,3,658,85,743,839,2021-01-18 16:32:49
850,233,3,558,72,630,840,2021-01-18 11:43:02
851,332,3,808,105,913,841,2021-01-18 05:58:39
852,525,2,898,116,1014,842,2021-01-17 17:50:28
853,425,3,688,89,777,843,2021-01-17 18:48:47
854,501,3,1027,133,1160,844,2021-01-17 21:52:51
855,22,3,658,85,743,845,2021-01-17 16:00:38
856,379,3,727,94,821,846,2021-01-18 22:18:42
857,707,3,927,120,1047,847,2021-01-18 19:25:24
858,435,3,997,129,1126,848,2021-01-18 20:10:01
859,987,2,798,103,901,849,2021-01-18 21:32:08
860,721,3,1127,146,1273,850,2021-01-18 21:50:10
861,784,3,597,77,674,851,2021-01-18 16:50:08
862,185,3,1047,136,1183,852,2021-01-18 12:15:58
863,185,2,898,116,1014,853,2021-01-18 08:17:23
864,572,2,898,116,1014,854,2021-01-17 20:13:46
865,916,2,898,116,1014,855,2021-01-17 20:05:05
866,195,2,398,51,449,856,2021-01-17 23:06:44
867,347,2,528,68,596,857,2021-01-17 18:12:51
868,455,1,99,12,111,858,2021-01-18 23:32:18
869,4,3,647,84,731,859,2021-01-18 21:28:43
870,280,5,1476,191,1667,860,2021-01-18 22:18:47
871,88,3,808,105,913,861,2021-01-19 00:05:53
872,981,1,149,19,168,862,2021-01-19 00:24:23
873,813,2,598,77,675,863,2021-01-18 18:49:17
874,935,3,608,79,687,864,2021-01-18 13:42:06
875,223,3,808,105,913,865,2021-01-18 08:57:47
876,908,1,399,51,450,866,2021-01-17 20:46:32
877,64,3,608,79,687,867,2021-01-17 22:42:25
878,132,2,898,116,1014,868,2021-01-17 23:46:45
879,391,3,727,94,821,869,2021-01-17 18:21:07
880,902,3,827,107,934,870,2021-01-19 00:47:25
881,126,3,578,75,653,871,2021-01-19 00:12:57
882,506,2,1098,142,1240,872,2021-01-19 00:06:41
883,12,3,1027,133,1160,873,2021-01-19 00:42:01
884,474,3,827,107,934,874,2021-01-19 02:19:16
885,717,3,758,98,856,875,2021-01-18 19:33:03
886,475,3,758,98,856,876,2021-01-18 15:43:31
887,465,3,608,79,687,877,2021-01-18 10:15:21
888,337,3,808,105,913,878,2021-01-17 21:34:20
889,825,3,688,89,777,879,2021-01-17 23:06:26
890,338,3,827,107,934,880,2021-01-18 00:54:48
891,882,2,659,85,744,881,2021-01-17 21:01:00
892,80,3,1047,136,1183,882,2021-01-19 03:04:37
893,352,3,558,72,630,883,2021-01-19 01:58:47
894,14,3,747,97,844,884,2021-01-19 01:04:05
895,38,3,697,90,787,885,2021-01-19 02:54:13
896,38,3,647,84,731,886,2021-01-19 03:15:47
897,155,2,748,97,845,887,2021-01-18 19:37:56
898,70,2,1098,142,1240,888,2021-01-18 16:06:22
899,308,3,688,89,777,889,2021-01-18 11:07:49
900,308,3,688,89,777,889,2021-01-18 11:07:49
901,420,1,699,90,789,890,2021-01-17 21:51:50
902,50,3,1247,162,1409,891,2021-01-18 01:08:59
903,455,1,399,51,450,892,2021-01-18 02:16:32
904,399,3,808,105,913,893,2021-01-17 23:29:23
905,347,3,1327,172,1499,894,2021-01-19 03:29:17
906,37,3,578,75,653,895,2021-01-19 02:22:49
907,183,2,659,85,744,896,2021-01-19 03:32:10
908,247,4,1196,155,1351,897,2021-01-19 05:33:51
909,770,3,727,94,821,898,2021-01-19 04:25:58
910,513,4,888,115,1003,899,2021-01-18 21:50:41
911,770,1,149,19,168,900,2021-01-18 18:17:56
912,669,3,727,94,821,901,2021-01-18 13:44:06
913,876,2,798,103,901,902,2021-01-18 12:05:28
914,141,3,758,98,856,903,2021-01-18 00:32:45
915,322,5,1306,169,1475,904,2021-01-18 02:25:05
916,686,6,2054,267,2321,905,2021-01-18 02:59:19
917,655,2,898,116,1014,906,2021-01-18 01:20:11
918,788,3,1247,162,1409,907,2021-01-19 06:10:04
919,471,5,1706,221,1927,908,2021-01-19 04:53:48
920,267,2,1098,142,1240,909,2021-01-19 05:03:22
921,602,3,758,98,856,910,2021-01-19 07:46:21
922,446,1,99,12,111,911,2021-01-19 05:24:40
923,833,3,608,79,687,912,2021-01-18 22:03:28
924,373,3,947,123,1070,913,2021-01-18 20:23:52
925,103,3,1197,155,1352,914,2021-01-18 15:31:17
926,250,3,578,75,653,915,2021-01-18 14:20:14
927,188,1,99,12,111,916,2021-01-18 01:09:02
928,177,3,1047,136,1183,917,2021-01-18 04:44:18
929,568,3,1047,136,1183,918,2021-01-18 03:02:54
930,82,2,1098,142,1240,919,2021-01-18 02:37:04
931,741,4,696,90,786,920,2021-01-19 07:19:33
932,483,5,1406,182,1588,921,2021-01-19 07:26:49
933,49,4,1146,148,1294,922,2021-01-19 07:05:59
934,483,3,1127,146,1273,923,2021-01-19 09:21:31
935,854,2,329,42,371,924,2021-01-19 06:32:52
936,352,3,997,129,1126,925,2021-01-18 23:03:26
937,687,3,888,115,1003,926,2021-01-18 21:45:25
938,461,6,1116,145,1261,927,2021-01-18 16:21:43
939,518,2,848,110,958,928,2021-01-18 14:34:42
940,518,2,848,110,958,928,2021-01-18 14:34:42
941,252,2,898,116,1014,929,2021-01-18 01:52:40
942,772,2,329,42,371,930,2021-01-18 05:46:36
943,791,3,647,84,731,931,2021-01-18 04:46:54
944,987,3,727,94,821,932,2021-01-18 03:08:02
945,371,5,1375,178,1553,933,2021-01-19 08:07:42
946,631,3,727,94,821,934,2021-01-19 09:05:09
947,829,2,659,85,744,935,2021-01-19 07:23:43
948,356,3,888,115,1003,936,2021-01-19 10:16:16
949,720,2,528,68,596,937,2021-01-19 08:47:46
950,197,3,1127,146,1273,938,2021-01-18 23:38:13
951,700,3,1127,146,1273,939,2021-01-18 22:13:35
952,996,2,1098,142,1240,940,2021-01-18 18:44:28
953,289,2,659,85,744,941,2021-01-18 15:45:39
954,520,2,798,103,901,942,2021-01-18 17:19:06
955,579,5,1525,198,1723,943,2021-01-18 04:15:36
956,120,3,558,72,630,944,2021-01-18 06:00:34
957,564,2,548,71,619,945,2021-01-18 06:14:15
958,554,2,848,110,958,946,2021-01-18 03:16:46
959,350,6,1444,187,1631,947,2021-01-19 10:30:15
960,886,3,827,107,934,948,2021-01-19 09:08:50
961,156,3,847,110,957,949,2021-01-19 08:13:55
962,502,2,659,85,744,950,2021-01-19 11:53:45
963,638,2,598,77,675,951,2021-01-19 10:57:56
964,738,2,598,77,675,952,2021-01-18 23:54:07
965,774,3,1027,133,1160,953,2021-01-18 23:43:21
966,157,2,898,116,1014,954,2021-01-18 19:13:27
967,101,6,1275,165,1440,955,2021-01-18 15:53:54
968,568,2,659,85,744,956,2021-01-18 19:46:12
969,323,3,558,72,630,957,2021-01-18 05:38:05
970,263,4,1196,155,1351,958,2021-01-18 06:53:41
971,371,5,1326,172,1498,959,2021-01-18 07:22:21
972,715,1,699,90,789,960,2021-01-18 05:36:32
973,710,2,459,59,518,961,2021-01-19 11:18:42
974,79,3,747,97,844,962,2021-01-19 09:30:10
975,408,3,758,98,856,963,2021-01-19 10:41:14
976,673,3,847,110,957,964,2021-01-19 12:05:00
977,248,3,528,68,596,965,2021-01-19 12:50:58
978,784,2,598,77,675,966,2021-01-19 01:17:30
979,812,5,1645,213,1858,967,2021-01-19 02:17:23
980,412,3,1027,133,1160,968,2021-01-18 21:38:56
981,871,3,597,77,674,969,2021-01-18 17:13:22
982,547,3,1127,146,1273,970,2021-01-18 20:41:35
983,402,2,329,42,371,971,2021-01-18 08:04:21
984,995,3,558,72,630,972,2021-01-18 07:12:51
985,545,3,888,115,1003,973,2021-01-18 07:56:45
986,998,3,697,90,787,974,2021-01-18 07:56:19
987,117,6,1944,252,2196,975,2021-01-19 11:53:22
988,745,3,1127,146,1273,976,2021-01-19 11:30:16
989,285,5,1695,220,1915,977,2021-01-19 13:13:08
990,405,3,1047,136,1183,978,2021-01-19 12:47:21
991,803,3,847,110,957,979,2021-01-19 14:18:12
992,357,3,947,123,1070,980,2021-01-19 01:29:49
993,56,3,797,103,900,981,2021-01-19 03:18:28
994,334,2,329,42,371,982,2021-01-18 23:15:38
995,54,2,698,90,788,983,2021-01-18 18:34:49
996,188,2,1098,142,1240,984,2021-01-18 20:55:29
997,13,2,598,77,675,985,2021-01-18 10:48:17
998,229,2,498,64,562,986,2021-01-18 08:51:07
999,299,3,827,107,934,987,2021-01-18 08:00:50
1000,930,2,848,110,958,988,2021-01-18 09:54:20
1001,581,3,478,62,540,989,2021-01-19 12:43:58
1002,878,3,578,75,653,990,2021-01-19 12:15:31
1003,642,2,598,77,675,991,2021-01-19 14:39:02
1004,590,3,1197,155,1352,992,2021-01-19 15:24:02
1005,361,2,648,84,732,993,2021-01-19 15:41:28
1006,572,3,888,115,1003,994,2021-01-19 01:31:29
1007,72,3,747,97,844,995,2021-01-19 03:22:20
1008,885,2,659,85,744,996,2021-01-19 01:50:34
1009,210,2,448,58,506,997,2021-01-18 19:19:32
1010,320,3,1247,162,1409,998,2021-01-18 20:56:39
1011,561,2,1098,142,1240,999,2021-01-18 11:39:56
1012,915,3,997,129,1126,1000,2021-01-18 10:23:11
1013,292,3,658,85,743,1001,2021-01-18 08:56:23
1014,464,2,598,77,675,1002,2021-01-18 11:52:37
1015,419,1,399,51,450,1003,2021-01-19 14:34:50
1016,419,1,399,51,450,1003,2021-01-19 14:34:50
1017,764,3,1197,155,1352,1004,2021-01-19 14:24:25
1018,950,1,99,12,111,1005,2021-01-19 15:57:47
1019,979,3,558,72,630,1006,2021-01-19 16:05:44
1020,608,3,827,107,934,1007,2021-01-19 16:52:01
1021,230,5,987,128,1115,1008,2021-01-19 01:39:41
1022,19,2,848,110,958,1009,2021-01-19 04:55:44
1023,632,3,1247,162,1409,1010,2021-01-19 01:56:36
1024,55,1,499,64,563,1011,2021-01-18 21:48:10
1025,443,2,748,97,845,1012,2021-01-18 22:12:16
1026,23,3,797,103,900,1013,2021-01-18 13:07:29
1027,128,3,558,72,630,1014,2021-01-18 11:42:53
1028,285,3,997,129,1126,1015,2021-01-18 10:42:04
1029,918,2,429,55,484,1016,2021-01-18 12:17:03
1030,639,3,747,97,844,1017,2021-01-19 14:36:54
1031,676,2,459,59,518,1018,2021-01-19 17:07:44
1032,232,3,428,55,483,1019,2021-01-19 17:06:14
1033,228,3,727,94,821,1020,2021-01-19 17:50:09
1034,967,3,697,90,787,1021,2021-01-19 16:51:32
1035,152,3,808,105,913,1022,2021-01-19 18:57:50
1036,647,2,659,85,744,1023,2021-01-19 01:47:44
1037,948,2,459,59,518,1024,2021-01-19 07:36:05
1038,728,6,1585,206,1791,1025,2021-01-19 04:11:01
1039,240,5,1256,163,1419,1026,2021-01-18 22:29:44
1040,700,3,647,84,731,1027,2021-01-18 23:41:26
1041,359,3,747,97,844,1028,2021-01-18 15:41:45
1042,794,3,558,72,630,1029,2021-01-18 14:08:21
1043,21,6,2074,269,2343,1030,2021-01-18 11:45:49
1044,206,3,1247,162,1409,1031,2021-01-18 14:54:03
1045,492,5,1026,133,1159,1032,2021-01-19 14:43:43
1046,417,3,1047,136,1183,1033,2021-01-19 19:44:43
1047,784,3,1027,133,1160,1034,2021-01-19 18:00:38
1048,275,2,429,55,484,1035,2021-01-19 19:14:56
1049,424,2,498,64,562,1036,2021-01-19 18:24:52
1050,177,2,648,84,732,1037,2021-01-19 20:54:12
1051,742,6,1755,228,1983,1038,2021-01-19 03:23:00
1052,239,3,747,97,844,1039,2021-01-19 09:28:54
1053,207,3,747,97,844,1040,2021-01-19 04:15:40
1054,75,3,597,77,674,1041,2021-01-19 00:51:21
1055,346,4,1726,224,1950,1042,2021-01-18 23:45:44
1056,724,2,698,90,788,1043,2021-01-18 17:06:39
1057,645,3,827,107,934,1044,2021-01-18 14:12:01
1058,376,3,947,123,1070,1045,2021-01-18 13:37:52
1059,128,3,947,123,1070,1046,2021-01-18 15:39:30
1060,544,3,647,84,731,1047,2021-01-19 15:48:57
1061,857,3,558,72,630,1048,2021-01-19 20:54:58
1062,597,5,937,121,1058,1049,2021-01-19 19:24:24
1063,780,3,528,68,596,1050,2021-01-19 19:22:53
1064,191,2,598,77,675,1051,2021-01-19 20:31:49
1065,779,2,728,94,822,1052,2021-01-19 21:06:17
1066,528,2,459,59,518,1053,2021-01-19 03:28:54
1067,288,3,697,90,787,1054,2021-01-19 10:58:38
1068,504,2,429,55,484,1055,2021-01-19 05:06:26
1069,703,3,688,89,777,1056,2021-01-19 02:18:45
1070,608,2,798,103,901,1057,2021-01-19 01:06:10
1071,391,3,597,77,674,1058,2021-01-18 19:05:52
1072,776,4,896,116,1012,1059,2021-01-18 14:14:28
1073,348,2,648,84,732,1060,2021-01-18 15:18:05
1074,218,3,658,85,743,1061,2021-01-18 17:15:46
1075,100,3,847,110,957,1062,2021-01-19 18:27:56
1076,777,3,997,129,1126,1063,2021-01-19 22:07:15
1077,901,2,698,90,788,1064,2021-01-19 21:29:58
1078,659,3,478,62,540,1065,2021-01-19 20:23:18
1079,86,2,459,59,518,1066,2021-01-19 22:03:20
1080,197,3,997,129,1126,1067,2021-01-19 21:08:58
1081,958,6,1524,198,1722,1068,2021-01-19 03:51:20
1082,37,4,1676,217,1893,1069,2021-01-19 12:02:03
1083,350,3,478,62,540,1070,2021-01-19 07:06:10
1084,453,3,558,72,630,1071,2021-01-19 04:38:36
1085,957,3,997,129,1126,1072,2021-01-19 01:16:35
1086,163,5,1575,204,1779,1073,2021-01-18 21:44:40
1087,308,1,149,19,168,1074,2021-01-18 14:20:55
1088,915,1,599,77,676,1075,2021-01-18 16:15:21
1089,825,3,608,79,687,1076,2021-01-18 17:59:35
1090,677,3,897,116,1013,1077,2021-01-19 21:08:05
1091,922,3,1127,146,1273,1078,2021-01-19 23:13:57
1092,89,3,747,97,844,1079,2021-01-19 22:47:21
1093,663,3,927,120,1047,1080,2021-01-19 22:40:18
1094,802,2,598,77,675,1081,2021-01-19 23:19:23
1095,988,3,997,129,1126,1082,2021-01-19 21:45:45
1096,624,3,808,105,913,1083,2021-01-19 06:23:22
1097,156,6,2124,276,2400,1084,2021-01-19 14:04:11
1098,613,2,698,90,788,1085,2021-01-19 07:32:28
1099,950,2,648,84,732,1086,2021-01-19 07:13:48
1100,703,3,727,94,821,1087,2021-01-19 02:06:19
1101,916,2,498,64,562,1088,2021-01-19 00:13:27
1102,886,2,698,90,788,1089,2021-01-18 16:36:30
1103,427,2,1098,142,1240,1090,2021-01-18 16:25:21
1104,460,3,947,123,1070,1091,2021-01-18 20:33:26
1105,572,2,398,51,449,1092,2021-01-19 22:11:55
1106,503,5,1217,158,1375,1093,2021-01-20 00:52:30
1107,842,3,597,77,674,1094,2021-01-19 23:25:33
1108,674,2,928,120,1048,1095,2021-01-20 01:20:17
1109,554,4,1496,194,1690,1096,2021-01-20 01:00:52
1110,337,2,598,77,675,1097,2021-01-19 22:14:21
1111,622,4,1037,134,1171,1098,2021-01-19 08:23:45
1112,446,3,558,72,630,1099,2021-01-19 15:19:12
1113,417,6,1355,176,1531,1100,2021-01-19 09:16:27
1114,999,2,459,59,518,1101,2021-01-19 09:22:27
1115,646,3,888,115,1003,1102,2021-01-19 03:13:20
1116,947,3,697,90,787,1103,2021-01-19 01:06:26
1117,247,2,498,64,562,1104,2021-01-18 18:43:33
1118,779,2,798,103,901,1105,2021-01-18 16:27:49
1119,137,3,558,72,630,1106,2021-01-18 20:43:34
1120,203,2,598,77,675,1107,2021-01-19 23:41:50
1121,22,2,648,84,732,1108,2021-01-20 02:04:13
1122,891,3,827,107,934,1109,2021-01-20 02:02:32
1123,999,3,697,90,787,1110,2021-01-20 03:17:52
1124,432,3,697,90,787,1111,2021-01-20 02:52:06
1125,40,2,429,55,484,1112,2021-01-19 23:30:10
1126,623,3,658,85,743,1113,2021-01-19 08:43:05
1127,511,5,937,121,1058,1114,2021-01-19 16:09:40
1128,786,3,688,89,777,1115,2021-01-19 10:42:05
1129,435,4,1096,142,1238,1116,2021-01-19 10:22:01
1130,83,5,1745,226,1971,1117,2021-01-19 04:33:09
1131,562,3,727,94,821,1118,2021-01-19 01:28:09
1132,955,3,558,72,630,1119,2021-01-18 19:39:07
1133,769,4,1587,206,1793,1120,2021-01-18 17:59:11
1134,962,5,1076,139,1215,1121,2021-01-18 21:21:00
1135,892,3,428,55,483,1122,2021-01-19 23:49:49
1136,282,3,658,85,743,1123,2021-01-20 02:05:41
1137,826,3,747,97,844,1124,2021-01-20 03:03:11
1138,304,3,1247,162,1409,1125,2021-01-20 03:31:00
1139,145,3,1047,136,1183,1126,2021-01-20 04:28:43
1140,353,5,1456,189,1645,1127,2021-01-20 00:33:28
1141,566,3,558,72,630,1128,2021-01-19 08:55:51
1142,430,3,997,129,1126,1129,2021-01-19 18:47:43
1143,440,3,1197,155,1352,1130,2021-01-19 11:29:15
1144,203,3,658,85,743,1131,2021-01-19 11:13:22
1145,11,3,478,62,540,1132,2021-01-19 05:11:41
1146,571,3,697,90,787,1133,2021-01-19 03:02:59
1147,965,2,329,42,371,1134,2021-01-18 21:55:39
1148,24,2,898,116,1014,1135,2021-01-18 18:50:42
1149,659,2,898,116,1014,1136,2021-01-18 23:03:33
1150,914,3,1327,172,1499,1137,2021-01-20 02:14:51
1151,615,3,827,107,934,1138,2021-01-20 02:35:32
1152,788,3,578,75,653,1139,2021-01-20 03:34:35
1153,165,3,997,129,1126,1140,2021-01-20 04:22:31
1154,106,2,698,90,788,1141,2021-01-20 05:00:43
1155,155,1,399,51,450,1142,2021-01-20 02:24:12
1156,860,2,898,116,1014,1143,2021-01-19 10:34:56
1157,968,3,558,72,630,1144,2021-01-19 20:21:15
1158,843,2,1098,142,1240,1145,2021-01-19 11:53:56
1159,745,1,699,90,789,1146,2021-01-19 13:47:13
1160,65,1,499,64,563,1147,2021-01-19 05:52:46
1161,328,3,947,123,1070,1148,2021-01-19 04:59:39
1162,485,2,498,64,562,1149,2021-01-18 23:53:33
1163,92,3,558,72,630,1150,2021-01-18 20:17:28
1164,384,6,1805,234,2039,1151,2021-01-19 00:33:04
1165,490,3,947,123,1070,1152,2021-01-20 03:14:21
1166,932,3,808,105,913,1153,2021-01-20 02:41:30
1167,637,3,1247,162,1409,1154,2021-01-20 05:50:07
1168,691,2,898,116,1014,1155,2021-01-20 05:41:39
1169,691,2,898,116,1014,1155,2021-01-20 05:41:39
1170,213,1,699,90,789,1156,2021-01-20 05:42:25
1171,213,1,699,90,789,1156,2021-01-20 05:42:25
1172,440,3,697,90,787,1157,2021-01-20 03:09:58
1173,328,3,558,72,630,1158,2021-01-19 11:41:48
1174,352,3,827,107,934,1159,2021-01-19 20:38:50
1175,554,5,2095,272,2367,1160,2021-01-19 14:05:09
1176,179,3,1047,136,1183,1161,2021-01-19 15:17:50
1177,885,3,608,79,687,1162,2021-01-19 06:10:45
1178,870,3,797,103,900,1163,2021-01-19 06:22:59
1179,632,6,1575,204,1779,1164,2021-01-19 00:55:10
1180,785,3,747,97,844,1165,2021-01-18 21:13:59
1181,799,4,1157,150,1307,1166,2021-01-19 02:13:47
1182,364,2,659,85,744,1167,2021-01-20 03:42:42
1183,837,3,827,107,934,1168,2021-01-20 04:46:55
1184,979,2,1098,142,1240,1169,2021-01-20 05:51:38
1185,633,3,888,115,1003,1170,2021-01-20 05:48:09
1186,24,3,688,89,777,1171,2021-01-20 07:42:37
1187,587,3,597,77,674,1172,2021-01-20 06:29:42
1188,733,1,499,64,563,1173,2021-01-20 06:14:39
1189,643,4,1646,213,1859,1174,2021-01-20 05:14:27
1190,508,3,1047,136,1183,1175,2021-01-19 13:13:58
1191,363,3,827,107,934,1176,2021-01-19 22:58:32
1192,146,3,797,103,900,1177,2021-01-19 15:16:38
1193,616,5,1686,219,1905,1178,2021-01-19 15:20:24
1194,309,3,688,89,777,1179,2021-01-19 07:33:11
1195,803,5,1675,217,1892,1180,2021-01-19 07:35:46
1196,919,2,329,42,371,1181,2021-01-19 03:41:33
1197,585,5,1276,165,1441,1182,2021-01-18 21:18:24
1198,267,2,598,77,675,1183,2021-01-19 02:46:58
1199,475,3,747,97,844,1184,2021-01-20 06:16:36
1200,285,2,898,116,1014,1185,2021-01-20 06:58:26
1201,933,2,1098,142,1240,1186,2021-01-20 06:35:50
1202,956,3,827,107,934,1187,2021-01-20 07:14:18
1203,318,3,597,77,674,1188,2021-01-20 08:45:48
1204,290,3,1127,146,1273,1189,2021-01-20 08:53:22
1205,449,2,329,42,371,1190,2021-01-20 06:21:26
1206,722,1,499,64,563,1191,2021-01-20 05:23:58
1207,319,1,699,90,789,1192,2021-01-19 14:53:36
1208,631,2,598,77,675,1193,2021-01-19 23:44:11
1209,594,3,1327,172,1499,1194,2021-01-19 17:07:13
1210,641,2,329,42,371,1195,2021-01-19 17:21:12
1211,370,2,898,116,1014,1196,2021-01-19 08:32:05
1212,553,3,747,97,844,1197,2021-01-19 08:37:18
1213,271,2,898,116,1014,1198,2021-01-19 04:42:39
1214,141,2,498,64,562,1199,2021-01-18 22:24:00
1215,334,2,1098,142,1240,1200,2021-01-19 05:18:19
1216,986,2,1098,142,1240,1201,2021-01-20 08:21:04
1217,954,6,1455,189,1644,1202,2021-01-20 08:40:35
1218,92,3,1197,155,1352,1203,2021-01-20 08:07:02
1219,715,3,558,72,630,1204,2021-01-20 07:25:19
1220,428,3,847,110,957,1205,2021-01-20 11:07:53
1221,614,3,927,120,1047,1206,2021-01-20 10:26:13
1222,844,3,578,75,653,1207,2021-01-20 06:48:46
1223,400,3,897,116,1013,1208,2021-01-20 06:43:18
1224,750,2,798,103,901,1209,2021-01-19 16:30:00
1225,499,2,728,94,822,1210,2021-01-20 00:53:41
1226,95,6,1654,215,1869,1211,2021-01-19 18:16:05
1227,627,3,1047,136,1183,1212,2021-01-19 18:40:46
1228,361,2,498,64,562,1213,2021-01-19 11:18:08
1229,86,3,697,90,787,1214,2021-01-19 10:29:38
1230,89,3,1197,155,1352,1215,2021-01-19 04:56:38
1231,893,3,558,72,630,1216,2021-01-18 23:20:21
1232,342,3,1127,146,1273,1217,2021-01-19 07:31:21
1233,986,3,647,84,731,1218,2021-01-20 09:12:58
1234,718,2,498,64,562,1219,2021-01-20 08:41:39
1235,330,2,798,103,901,1220,2021-01-20 08:13:41
1236,761,1,229,29,258,1221,2021-01-20 09:25:14
1237,282,3,997,129,1126,1222,2021-01-20 11:55:27
1238,241,3,1047,136,1183,1223,2021-01-20 11:06:47
1239,894,3,847,110,957,1224,2021-01-20 08:00:34
1240,797,3,808,105,913,1225,2021-01-20 06:43:43
1241,82,5,1306,169,1475,1226,2021-01-19 17:21:23
1242,931,5,1426,185,1611,1227,2021-01-20 01:13:49
1243,460,3,578,75,653,1228,2021-01-19 19:42:06
1244,929,2,598,77,675,1229,2021-01-19 19:05:41
1245,115,2,329,42,371,1230,2021-01-19 13:07:03
1246,400,2,498,64,562,1231,2021-01-19 12:36:51
1247,173,1,499,64,563,1232,2021-01-19 05:38:20
1248,960,2,748,97,845,1233,2021-01-19 01:19:57
1249,254,2,498,64,562,1234,2021-01-19 09:18:21
1250,89,2,659,85,744,1235,2021-01-20 10:34:05
1251,813,4,957,124,1081,1236,2021-01-20 10:18:18
1252,348,2,698,90,788,1237,2021-01-20 10:27:52
1253,47,3,747,97,844,1238,2021-01-20 11:23:02
1254,998,3,747,97,844,1239,2021-01-20 11:56:11
1255,940,3,927,120,1047,1240,2021-01-20 11:30:43
1256,124,2,659,85,744,1241,2021-01-20 09:21:10
1257,516,3,827,107,934,1242,2021-01-20 07:20:19
1258,17,3,747,97,844,1243,2021-01-19 17:36:21
1259,649,2,598,77,675,1244,2021-01-20 01:27:36
1260,528,5,1126,146,1272,1245,2021-01-19 21:17:55
1261,73,2,548,71,619,1246,2021-01-19 21:14:43
1262,369,3,597,77,674,1247,2021-01-19 15:43:28
1263,156,3,808,105,913,1248,2021-01-19 14:43:05
1264,235,6,1216,158,1374,1249,2021-01-19 07:31:04
1265,582,3,847,110,957,1250,2021-01-19 01:27:08
1266,67,3,697,90,787,1251,2021-01-19 09:35:30
1267,449,2,498,64,562,1252,2021-01-20 11:12:55
1268,469,5,1725,224,1949,1253,2021-01-20 12:16:37
1269,431,3,1027,133,1160,1254,2021-01-20 13:10:25
1270,921,3,747,97,844,1255,2021-01-20 13:19:51
1271,850,3,697,90,787,1256,2021-01-20 13:49:14
1272,376,2,659,85,744,1257,2021-01-20 13:18:01
1273,217,3,927,120,1047,1258,2021-01-20 10:20:05
1274,1,3,797,103,900,1259,2021-01-20 08:43:34
1275,340,4,877,114,991,1260,2021-01-19 19:47:15
1276,425,2,798,103,901,1261,2021-01-20 02:29:59
1277,853,3,1197,155,1352,1262,2021-01-19 22:35:31
1278,671,5,1436,186,1622,1263,2021-01-19 23:48:20
1279,657,3,608,79,687,1264,2021-01-19 17:35:45
1280,994,3,428,55,483,1265,2021-01-19 16:35:14
1281,406,2,659,85,744,1266,2021-01-19 08:55:48
1282,883,3,1027,133,1160,1267,2021-01-19 02:27:32
1283,822,2,528,68,596,1268,2021-01-19 10:51:11
1284,809,3,478,62,540,1269,2021-01-20 11:13:27
1285,80,1,699,90,789,1270,2021-01-20 13:56:05
1286,424,3,697,90,787,1271,2021-01-20 13:49:58
1287,15,4,1587,206,1793,1272,2021-01-20 13:53:39
1288,260,3,658,85,743,1273,2021-01-20 14:34:43
1289,125,3,558,72,630,1274,2021-01-20 15:05:41
1290,724,2,598,77,675,1275,2021-01-20 12:04:02
1291,540,3,1247,162,1409,1276,2021-01-20 10:10:40
1292,689,3,658,85,743,1277,2021-01-19 19:49:25
1293,339,2,459,59,518,1278,2021-01-20 04:56:19
1294,706,2,798,103,901,1279,2021-01-20 00:52:52
1295,317,2,498,64,562,1280,2021-01-20 00:49:07
1296,23,2,698,90,788,1281,2021-01-19 18:20:19
1297,391,6,1624,211,1835,1282,2021-01-19 19:03:53
1298,345,2,798,103,901,1283,2021-01-19 10:31:25
1299,24,2,898,116,1014,1284,2021-01-19 04:26:18
1300,474,5,1925,250,2175,1285,2021-01-19 12:53:45
1301,492,3,847,110,957,1286,2021-01-20 13:41:09
1302,917,2,1098,142,1240,1287,2021-01-20 15:43:12
1303,836,2,329,42,371,1288,2021-01-20 14:31:32
1304,85,2,1098,142,1240,1289,2021-01-20 15:17:00
1305,137,2,598,77,675,1290,2021-01-20 16:36:01
1306,148,3,1047,136,1183,1291,2021-01-20 17:42:38
1307,120,6,1544,200,1744,1292,2021-01-20 14:39:32
1308,471,3,1197,155,1352,1293,2021-01-20 10:49:12
1309,716,3,1027,133,1160,1294,2021-01-19 20:55:30
1310,436,2,898,116,1014,1295,2021-01-20 05:06:09
1311,476,2,698,90,788,1296,2021-01-20 03:36:18
1312,671,3,727,94,821,1297,2021-01-20 03:30:23
1313,611,4,1246,161,1407,1298,2021-01-19 18:24:21
1314,135,4,1496,194,1690,1299,2021-01-19 20:12:28
1315,399,6,1874,243,2117,1300,2021-01-19 12:00:10
1316,216,2,429,55,484,1301,2021-01-19 04:41:17
1317,487,3,647,84,731,1302,2021-01-19 13:32:47
1318,639,3,747,97,844,1303,2021-01-20 15:04:03
1319,963,3,927,120,1047,1304,2021-01-20 17:22:21
1320,302,2,798,103,901,1305,2021-01-20 16:01:37
1321,951,3,558,72,630,1306,2021-01-20 16:16:21
1322,895,3,688,89,777,1307,2021-01-20 18:31:01
1323,375,3,847,110,957,1308,2021-01-20 20:11:37
1324,434,1,599,77,676,1309,2021-01-20 16:02:40
1325,917,2,898,116,1014,1310,2021-01-20 11:59:04
1326,161,2,598,77,675,1311,2021-01-19 22:39:57
1327,340,3,658,85,743,1312,2021-01-20 07:07:34
1328,6,3,578,75,653,1313,2021-01-20 04:19:55
1329,964,1,399,51,450,1314,2021-01-20 05:43:18
1330,404,2,459,59,518,1315,2021-01-19 18:53:44
1331,387,3,747,97,844,1316,2021-01-19 21:06:39
1332,349,2,898,116,1014,1317,2021-01-19 12:43:56
1333,391,3,608,79,687,1318,2021-01-19 07:22:02
1334,558,3,1027,133,1160,1319,2021-01-19 14:53:42
1335,529,5,1786,232,2018,1320,2021-01-20 15:23:13
1336,470,2,329,42,371,1321,2021-01-20 17:50:53
1337,420,2,429,55,484,1322,2021-01-20 16:09:33
1338,262,3,1197,155,1352,1323,2021-01-20 17:01:40
1339,585,3,947,123,1070,1324,2021-01-20 20:35:37
1340,555,2,698,90,788,1325,2021-01-20 22:09:24
1341,442,5,1225,159,1384,1326,2021-01-20 17:51:27
1342,876,2,598,77,675,1327,2021-01-20 13:55:52
1343,725,3,827,107,934,1328,2021-01-20 00:53:14
1344,24,2,498,64,562,1329,2021-01-20 08:43:44
1345,935,3,578,75,653,1330,2021-01-20 06:07:58
1346,434,3,697,90,787,1331,2021-01-20 05:57:22
1347,449,2,498,64,562,1332,2021-01-19 18:56:53
1348,29,2,329,42,371,1333,2021-01-19 21:13:42
1349,673,2,828,107,935,1334,2021-01-19 13:20:47
1350,731,3,827,107,934,1335,2021-01-19 08:31:36
1351,760,3,808,105,913,1336,2021-01-19 16:13:26
1352,505,2,628,81,709,1337,2021-01-20 16:27:00
1353,726,3,478,62,540,1338,2021-01-20 20:14:08
1354,327,2,1098,142,1240,1339,2021-01-20 17:34:33
1355,707,3,1197,155,1352,1340,2021-01-20 18:01:27
1356,397,2,598,77,675,1341,2021-01-20 22:17:28
1357,946,3,758,98,856,1342,2021-01-21 00:46:00
1358,363,3,528,68,596,1343,2021-01-20 19:06:16
1359,911,1,99,12,111,1344,2021-01-20 16:37:53
1360,618,3,558,72,630,1345,2021-01-20 01:43:02
1361,897,2,459,59,518,1346,2021-01-20 10:53:19
1362,877,3,1027,133,1160,1347,2021-01-20 07:14:14
1363,197,3,947,123,1070,1348,2021-01-20 07:58:19
1364,666,3,1127,146,1273,1349,2021-01-19 20:59:41
1365,412,2,429,55,484,1350,2021-01-19 23:54:09
1366,892,3,1247,162,1409,1351,2021-01-19 15:00:20
1367,923,2,798,103,901,1352,2021-01-19 08:43:24
1368,847,3,827,107,934,1353,2021-01-19 18:08:30
1369,265,3,1247,162,1409,1354,2021-01-20 18:22:35
1370,667,5,1206,156,1362,1355,2021-01-20 21:10:18
1371,808,1,399,51,450,1356,2021-01-20 18:49:44
1372,349,4,796,103,899,1357,2021-01-20 18:14:33
1373,120,5,1456,189,1645,1358,2021-01-20 23:57:58
1374,184,5,1295,168,1463,1359,2021-01-21 01:52:03
1375,204,2,798,103,901,1360,2021-01-20 20:06:06
1376,463,2,648,84,732,1361,2021-01-20 17:59:46
1377,689,3,697,90,787,1362,2021-01-20 02:59:34
1378,904,3,847,110,957,1363,2021-01-20 12:25:51
1379,321,3,1047,136,1183,1364,2021-01-20 07:20:47
1380,326,3,758,98,856,1365,2021-01-20 09:02:26
1381,253,4,1207,156,1363,1366,2021-01-19 21:48:25
1382,514,3,558,72,630,1367,2021-01-20 00:34:06
1383,470,2,898,116,1014,1368,2021-01-19 15:19:14
1384,581,3,688,89,777,1369,2021-01-19 11:00:52
1385,43,3,727,94,821,1370,2021-01-19 18:53:39
1386,163,3,1197,155,1352,1371,2021-01-20 20:26:31
1387,188,2,548,71,619,1372,2021-01-20 23:35:55
1388,353,2,698,90,788,1373,2021-01-20 18:59:06
1389,572,2,459,59,518,1374,2021-01-20 20:31:03
1390,790,3,747,97,844,1375,2021-01-21 01:21:00
1391,286,2,459,59,518,1376,2021-01-21 02:19:18
1392,778,3,528,68,596,1377,2021-01-20 22:14:11
1393,508,2,898,116,1014,1378,2021-01-20 19:15:09
1394,692,3,997,129,1126,1379,2021-01-20 03:27:47
1395,305,2,329,42,371,1380,2021-01-20 13:32:10
1396,221,4,1426,185,1611,1381,2021-01-20 08:33:03
1397,331,2,1098,142,1240,1382,2021-01-20 10:38:04
1398,434,2,898,116,1014,1383,2021-01-20 00:04:39
1399,73,3,1197,155,1352,1384,2021-01-20 02:31:42
1400,992,2,548,71,619,1385,2021-01-19 17:56:23
1401,450,4,1096,142,1238,1386,2021-01-19 11:02:24
1402,716,3,827,107,934,1387,2021-01-19 21:37:46
1403,773,3,1127,146,1273,1388,2021-01-20 21:06:41
1404,6,2,329,42,371,1389,2021-01-21 01:25:49
1405,32,3,688,89,777,1390,2021-01-20 20:31:36
1406,150,3,797,103,900,1391,2021-01-20 23:16:25
1407,671,4,1307,169,1476,1392,2021-01-21 02:47:32
1408,358,2,498,64,562,1393,2021-01-21 03:23:59
1409,25,2,329,42,371,1394,2021-01-20 23:39:41
1410,170,3,888,115,1003,1395,2021-01-20 21:13:52
1411,401,2,898,116,1014,1396,2021-01-20 03:44:54
1412,831,2,598,77,675,1397,2021-01-20 15:05:07
1413,720,1,229,29,258,1398,2021-01-20 08:56:07
1414,55,4,1296,168,1464,1399,2021-01-20 12:52:44
1415,832,3,997,129,1126,1400,2021-01-20 02:05:47
1416,845,3,1047,136,1183,1401,2021-01-20 03:10:16
1417,404,3,697,90,787,1402,2021-01-19 19:57:47
1418,644,2,498,64,562,1403,2021-01-19 12:19:15
1419,133,2,748,97,845,1404,2021-01-19 22:07:56
1420,729,2,898,116,1014,1405,2021-01-20 23:48:12
1421,443,3,558,72,630,1406,2021-01-21 03:03:42
1422,456,2,429,55,484,1407,2021-01-20 22:51:04
1423,273,2,1098,142,1240,1408,2021-01-21 00:02:06
1424,377,3,1047,136,1183,1409,2021-01-21 04:18:18
1425,874,1,99,12,111,1410,2021-01-21 05:28:42
1426,483,3,947,123,1070,1411,2021-01-21 00:35:22
1427,722,3,688,89,777,1412,2021-01-20 23:22:24
1428,300,3,847,110,957,1413,2021-01-20 05:15:25
1429,535,3,647,84,731,1414,2021-01-20 17:03:41
1430,807,3,1127,146,1273,1415,2021-01-20 09:58:07
1431,766,2,898,116,1014,1416,2021-01-20 13:45:47
1432,842,2,398,51,449,1417,2021-01-20 02:25:50
1433,243,2,598,77,675,1418,2021-01-20 04:55:41
1434,889,2,548,71,619,1419,2021-01-19 20:30:49
1435,956,2,659,85,744,1420,2021-01-19 14:15:15
1436,73,2,728,94,822,1421,2021-01-19 22:44:34
1437,860,2,598,77,675,1422,2021-01-21 00:31:54
1438,371,5,1495,194,1689,1423,2021-01-21 05:29:11
1439,187,2,459,59,518,1424,2021-01-20 23:24:46
1440,652,3,558,72,630,1425,2021-01-21 02:15:48
1441,961,3,897,116,1013,1426,2021-01-21 06:35:02
1442,599,3,697,90,787,1427,2021-01-21 05:59:11
1443,564,1,399,51,450,1428,2021-01-21 00:43:14
1444,670,2,459,59,518,1429,2021-01-21 00:58:38
1445,974,5,1176,152,1328,1430,2021-01-20 07:43:05
1446,484,3,1047,136,1183,1431,2021-01-20 18:38:47
1447,560,2,429,55,484,1432,2021-01-20 10:18:47
1448,946,3,1127,146,1273,1433,2021-01-20 16:08:06
1449,245,2,459,59,518,1434,2021-01-20 04:38:43
1450,25,2,698,90,788,1435,2021-01-20 06:33:44
1451,218,2,1098,142,1240,1436,2021-01-19 21:47:23
1452,218,2,1098,142,1240,1436,2021-01-19 21:47:23
1453,705,3,428,55,483,1437,2021-01-19 15:19:13
1454,352,3,997,129,1126,1438,2021-01-19 23:30:13
1455,327,5,1325,172,1497,1439,2021-01-21 02:14:16
1456,818,3,647,84,731,1440,2021-01-21 06:59:03
1457,999,3,597,77,674,1441,2021-01-21 02:10:51
1458,325,3,608,79,687,1442,2021-01-21 03:15:40
1459,989,2,598,77,675,1443,2021-01-21 07:49:28
1460,805,3,897,116,1013,1444,2021-01-21 08:37:32
1461,909,1,149,19,168,1445,2021-01-21 02:21:26
1462,26,2,798,103,901,1446,2021-01-21 03:34:01
1463,997,3,1127,146,1273,1447,2021-01-20 08:30:42
1464,955,2,598,77,675,1448,2021-01-20 19:53:05
1465,695,3,478,62,540,1449,2021-01-20 10:58:31
1466,714,3,897,116,1013,1450,2021-01-20 16:55:53
1467,115,5,1356,176,1532,1451,2021-01-20 07:08:50
1468,499,2,329,42,371,1452,2021-01-20 08:18:05
1469,731,4,1027,133,1160,1453,2021-01-19 22:13:53
1470,792,1,699,90,789,1454,2021-01-19 23:46:01
1471,154,6,1694,220,1914,1455,2021-01-19 15:43:05
1472,576,3,747,97,844,1456,2021-01-20 00:39:19
1473,15,5,1395,181,1576,1457,2021-01-21 04:37:36
1474,861,6,1794,233,2027,1458,2021-01-21 08:25:35
1475,553,5,1525,198,1723,1459,2021-01-21 03:09:30
1476,864,5,2125,276,2401,1460,2021-01-21 05:35:40
1477,840,2,528,68,596,1461,2021-01-21 10:09:23
1478,148,3,997,129,1126,1462,2021-01-21 08:55:44
1479,815,3,688,89,777,1463,2021-01-21 02:31:35
1480,202,3,1127,146,1273,1464,2021-01-21 03:58:09
1481,868,3,1127,146,1273,1465,2021-01-20 11:10:36
1482,63,2,498,64,562,1466,2021-01-20 21:00:50
1483,780,5,1056,137,1193,1467,2021-01-20 11:13:33
1484,716,6,1575,204,1779,1468,2021-01-20 18:51:44
1485,895,5,1725,224,1949,1469,2021-01-20 07:33:28
1486,407,5,1595,207,1802,1470,2021-01-20 08:23:19
1487,971,3,1047,136,1183,1471,2021-01-19 23:09:04
1488,238,2,698,90,788,1472,2021-01-19 23:56:18
1489,87,3,797,103,900,1473,2021-01-19 18:03:13
1490,130,3,758,98,856,1474,2021-01-20 01:38:44
1491,985,2,598,77,675,1475,2021-01-21 05:53:40
1492,556,3,578,75,653,1476,2021-01-21 10:10:01
1493,445,3,897,116,1013,1477,2021-01-21 03:32:51
1494,467,3,847,110,957,1478,2021-01-21 07:23:19
1495,364,3,897,116,1013,1479,2021-01-21 12:32:26
1496,982,3,927,120,1047,1480,2021-01-21 09:28:43
1497,686,2,448,58,506,1481,2021-01-21 02:49:44
1498,368,3,747,97,844,1482,2021-01-21 04:38:43
1499,427,3,758,98,856,1483,2021-01-20 13:39:40
1500,856,3,827,107,934,1484,2021-01-20 23:31:45
1501,134,3,1247,162,1409,1485,2021-01-20 12:30:58
1502,381,3,647,84,731,1486,2021-01-20 19:08:22
1503,168,2,329,42,371,1487,2021-01-20 08:17:34
1504,74,2,329,42,371,1488,2021-01-20 08:53:56
1505,326,5,1645,213,1858,1489,2021-01-20 01:27:34
1506,913,2,659,85,744,1490,2021-01-20 01:45:23
1507,173,4,727,94,821,1491,2021-01-19 20:14:27
1508,439,3,697,90,787,1492,2021-01-20 03:13:45
1509,487,3,947,123,1070,1493,2021-01-21 08:35:54
1510,567,2,329,42,371,1494,2021-01-21 12:25:31
1511,779,2,329,42,371,1495,2021-01-21 04:48:00
1512,288,3,697,90,787,1496,2021-01-21 08:49:49
1513,631,3,947,123,1070,1497,2021-01-21 13:40:07
1514,740,3,1127,146,1273,1498,2021-01-21 11:48:29
1515,180,2,459,59,518,1499,2021-01-21 04:12:37
1516,574,4,1357,176,1533,1500,2021-01-21 06:44:37
1517,861,2,1098,142,1240,1501,2021-01-20 15:33:07
1518,572,3,997,129,1126,1502,2021-01-21 01:01:24
1519,475,3,608,79,687,1503,2021-01-20 15:03:26
1520,662,5,1345,174,1519,1504,2021-01-20 20:56:41
1521,776,3,597,77,674,1505,2021-01-20 09:09:57
1522,845,3,1327,172,1499,1506,2021-01-20 09:32:17
1523,15,3,1047,136,1183,1507,2021-01-20 02:49:55
1524,557,2,498,64,562,1508,2021-01-20 03:09:25
1525,334,3,997,129,1126,1509,2021-01-19 21:45:31
1526,145,2,548,71,619,1510,2021-01-20 04:10:57
1527,775,3,847,110,957,1511,2021-01-21 09:08:40
1528,678,4,627,81,708,1512,2021-01-21 14:53:24
1529,783,3,528,68,596,1513,2021-01-21 05:35:37
1530,849,3,758,98,856,1514,2021-01-21 10:25:01
1531,424,3,758,98,856,1515,2021-01-21 14:23:41
1532,650,5,1645,213,1858,1516,2021-01-21 12:37:02
1533,992,2,459,59,518,1517,2021-01-21 04:20:03
1534,902,2,459,59,518,1518,2021-01-21 07:43:58
1535,681,3,1047,136,1183,1519,2021-01-20 17:21:28
1536,241,3,808,105,913,1520,2021-01-21 01:32:10
1537,612,2,598,77,675,1521,2021-01-20 15:56:43
1538,815,2,698,90,788,1522,2021-01-20 22:25:34
1539,689,3,1127,146,1273,1523,2021-01-20 11:32:26
1540,117,3,897,116,1013,1524,2021-01-20 09:51:22
1541,467,3,1127,146,1273,1525,2021-01-20 04:12:25
1542,368,3,927,120,1047,1526,2021-01-20 04:55:49
1543,894,3,827,107,934,1527,2021-01-20 00:31:44
1544,651,5,1425,185,1610,1528,2021-01-20 06:56:52
1545,854,3,558,72,630,1529,2021-01-21 10:16:54
1546,195,3,558,72,630,1530,2021-01-21 16:43:56
1547,154,3,1027,133,1160,1531,2021-01-21 07:00:36
1548,793,3,1197,155,1352,1532,2021-01-21 12:06:08
1549,532,2,898,116,1014,1533,2021-01-21 16:22:11
1550,985,4,1296,168,1464,1534,2021-01-21 13:09:22
1551,393,3,897,116,1013,1535,2021-01-21 05:43:50
1552,986,3,997,129,1126,1536,2021-01-21 08:16:52
1553,82,4,857,111,968,1537,2021-01-20 17:49:25
1554,384,3,688,89,777,1538,2021-01-21 02:35:38
1555,910,3,1327,172,1499,1539,2021-01-20 17:27:31
1556,368,5,1475,191,1666,1540,2021-01-20 22:43:56
1557,617,3,1027,133,1160,1541,2021-01-20 12:52:48
1558,946,3,1247,162,1409,1542,2021-01-20 11:46:57
1559,321,3,927,120,1047,1543,2021-01-20 05:58:30
1560,740,1,299,38,337,1544,2021-01-20 05:56:47
1561,177,3,997,129,1126,1545,2021-01-20 01:59:24
1562,827,4,1196,155,1351,1546,2021-01-20 09:14:43
1563,641,5,1545,200,1745,1547,2021-01-21 12:30:51
1564,247,3,528,68,596,1548,2021-01-21 17:17:27
1565,437,2,329,42,371,1549,2021-01-21 08:49:39
1566,737,4,1207,156,1363,1550,2021-01-21 14:34:19
1567,535,3,647,84,731,1551,2021-01-21 16:50:41
1568,395,6,2015,261,2276,1552,2021-01-21 14:08:43
1569,188,3,558,72,630,1553,2021-01-21 07:06:16
1570,155,2,598,77,675,1554,2021-01-21 10:25:58
1571,457,2,329,42,371,1555,2021-01-20 20:32:30
1572,388,3,428,55,483,1556,2021-01-21 03:09:41
1573,907,2,698,90,788,1557,2021-01-20 19:48:51
1574,123,3,1027,133,1160,1558,2021-01-21 00:25:00
1575,416,2,598,77,675,1559,2021-01-20 15:32:39
1576,233,3,658,85,743,1560,2021-01-20 13:46:07
1577,90,5,1395,181,1576,1561,2021-01-20 06:31:12
1578,363,2,329,42,371,1562,2021-01-20 06:35:32
1579,295,2,1098,142,1240,1563,2021-01-20 02:38:45
1580,979,2,598,77,675,1564,2021-01-20 11:11:25
1581,199,3,808,105,913,1565,2021-01-21 14:08:56
1582,664,3,808,105,913,1566,2021-01-21 18:11:07
1583,319,3,1247,162,1409,1567,2021-01-21 10:20:05
1584,435,2,848,110,958,1568,2021-01-21 16:03:31
1585,538,2,429,55,484,1569,2021-01-21 19:32:47
1586,239,3,697,90,787,1570,2021-01-21 16:47:00
1587,350,3,597,77,674,1571,2021-01-21 08:23:28
1588,754,2,828,107,935,1572,2021-01-21 13:05:06
1589,799,3,1047,136,1183,1573,2021-01-20 21:26:07
1590,2,3,428,55,483,1574,2021-01-21 03:33:34
1591,313,3,758,98,856,1575,2021-01-20 21:10:07
1592,781,2,598,77,675,1576,2021-01-21 02:14:08
1593,535,3,597,77,674,1577,2021-01-20 16:38:04
1594,924,3,997,129,1126,1578,2021-01-20 15:01:17
1595,953,3,558,72,630,1579,2021-01-20 06:50:23
1596,744,3,1197,155,1352,1580,2021-01-20 08:26:03
1597,212,1,499,64,563,1581,2021-01-20 03:34:28
1598,185,3,758,98,856,1582,2021-01-20 11:45:48
1599,560,3,797,103,900,1583,2021-01-21 15:40:00
1600,190,5,1226,159,1385,1584,2021-01-21 19:36:13
1601,370,4,887,115,1002,1585,2021-01-21 11:11:51
1602,304,3,1027,133,1160,1586,2021-01-21 17:42:23
1603,740,2,659,85,744,1587,2021-01-21 20:48:15
1604,108,2,798,103,901,1588,2021-01-21 18:25:58
1605,723,6,1494,194,1688,1589,2021-01-21 10:32:48
1606,579,3,528,68,596,1590,2021-01-21 13:27:39
1607,617,5,1625,211,1836,1591,2021-01-20 23:11:08
1608,207,2,459,59,518,1592,2021-01-21 04:38:51
1609,103,3,847,110,957,1593,2021-01-20 21:18:38
1610,729,3,688,89,777,1594,2021-01-21 02:36:06
1611,729,3,688,89,777,1594,2021-01-21 02:36:06
1612,585,4,1396,181,1577,1595,2021-01-20 18:41:57
1613,235,2,698,90,788,1596,2021-01-20 17:38:50
1614,436,2,459,59,518,1597,2021-01-20 06:56:59
1615,572,3,747,97,844,1598,2021-01-20 10:13:56
1616,931,3,1197,155,1352,1599,2021-01-20 05:59:48
1617,315,3,897,116,1013,1600,2021-01-20 13:30:03
1618,702,6,1854,241,2095,1601,2021-01-21 15:56:36
1619,454,3,688,89,777,1602,2021-01-21 21:35:44
1620,688,3,528,68,596,1603,2021-01-21 11:41:53
1621,176,1,499,64,563,1604,2021-01-21 18:46:04
1622,519,1,399,51,450,1605,2021-01-21 21:48:12
1623,583,2,898,116,1014,1606,2021-01-21 18:58:31
1624,818,3,827,107,934,1607,2021-01-21 11:09:51
1625,816,3,997,129,1126,1608,2021-01-21 16:01:47
1626,318,2,659,85,744,1609,2021-01-20 23:54:16
1627,64,3,827,107,934,1610,2021-01-21 04:40:29
1628,103,3,558,72,630,1611,2021-01-20 22:51:31
1629,714,3,847,110,957,1612,2021-01-21 05:13:29
1630,4,3,1027,133,1160,1613,2021-01-21 04:57:56
1631,63,5,1436,186,1622,1614,2021-01-20 19:17:18
1632,458,3,428,55,483,1615,2021-01-20 19:01:40
1633,685,3,797,103,900,1616,2021-01-20 06:59:42
1634,439,3,697,90,787,1617,2021-01-20 10:48:57
1635,222,3,888,115,1003,1618,2021-01-20 07:53:18
1636,22,3,747,97,844,1619,2021-01-20 15:37:05
1637,955,5,1295,168,1463,1620,2021-01-21 16:01:29
1638,199,2,498,64,562,1621,2021-01-21 23:33:59
1639,83,3,1047,136,1183,1622,2021-01-21 13:07:10
1640,274,3,1197,155,1352,1623,2021-01-21 19:17:01
1641,782,2,598,77,675,1624,2021-01-21 23:54:59
1642,313,2,928,120,1048,1625,2021-01-21 20:14:21
1643,770,3,608,79,687,1626,2021-01-21 11:29:15
1644,88,2,828,107,935,1627,2021-01-21 16:20:41
1645,998,2,429,55,484,1628,2021-01-21 01:34:58
1646,520,3,1197,155,1352,1629,2021-01-21 04:50:46
1647,164,2,898,116,1014,1630,2021-01-20 23:19:48
1648,33,2,1098,142,1240,1631,2021-01-21 05:37:27
1649,833,5,1736,225,1961,1632,2021-01-21 05:29:35
1650,122,1,149,19,168,1633,2021-01-20 21:01:42
1651,808,2,498,64,562,1634,2021-01-20 19:41:12
1652,568,2,898,116,1014,1635,2021-01-20 09:33:48
1653,565,2,798,103,901,1636,2021-01-20 10:53:57
1654,492,5,1725,224,1949,1637,2021-01-20 08:35:36
1655,860,3,947,123,1070,1638,2021-01-20 17:37:18
1656,388,3,747,97,844,1639,2021-01-21 16:36:01
1657,505,3,1197,155,1352,1640,2021-01-21 23:49:36
1658,355,3,747,97,844,1641,2021-01-21 14:33:33
1659,68,3,1027,133,1160,1642,2021-01-21 20:27:33
1660,462,3,797,103,900,1643,2021-01-22 01:18:31
1661,740,2,329,42,371,1644,2021-01-21 20:26:36
1662,554,3,1247,162,1409,1645,2021-01-21 12:25:09
1663,968,5,1256,163,1419,1646,2021-01-21 16:56:26
1664,818,5,1345,174,1519,1647,2021-01-21 03:30:25
1665,794,3,827,107,934,1648,2021-01-21 04:54:27
1666,647,1,229,29,258,1649,2021-01-21 00:08:15
1667,483,3,1047,136,1183,1650,2021-01-21 05:58:27
1668,24,6,1644,213,1857,1651,2021-01-21 07:28:46
1669,975,3,997,129,1126,1652,2021-01-20 23:43:26
1670,648,3,697,90,787,1653,2021-01-20 21:54:24
1671,827,3,1047,136,1183,1654,2021-01-20 12:09:50
1672,69,3,827,107,934,1655,2021-01-20 13:02:07
1673,915,3,528,68,596,1656,2021-01-20 10:08:37
1674,27,2,898,116,1014,1657,2021-01-20 18:18:03
1675,166,2,398,51,449,1658,2021-01-21 17:10:20
1676,165,2,898,116,1014,1659,2021-01-22 00:19:31
1677,854,2,698,90,788,1660,2021-01-21 17:17:20
1678,257,3,1127,146,1273,1661,2021-01-21 23:11:20
1679,158,2,429,55,484,1662,2021-01-22 02:22:25
1680,638,3,558,72,630,1663,2021-01-21 20:31:52
1681,527,3,597,77,674,1664,2021-01-21 14:46:46
1682,638,5,1395,181,1576,1665,2021-01-21 19:27:58
1683,733,2,648,84,732,1666,2021-01-21 03:57:44
1684,222,3,428,55,483,1667,2021-01-21 05:57:42
1685,56,2,598,77,675,1668,2021-01-21 00:24:49
1686,652,1,399,51,450,1669,2021-01-21 08:38:07
1687,150,3,688,89,777,1670,2021-01-21 09:09:04
1688,893,3,478,62,540,1671,2021-01-20 23:56:21
1689,364,3,797,103,900,1672,2021-01-20 23:23:15
1690,88,2,898,116,1014,1673,2021-01-20 13:37:14
1691,338,2,898,116,1014,1674,2021-01-20 14:53:37
1692,396,3,897,116,1013,1675,2021-01-20 12:12:38
1693,170,3,808,105,913,1676,2021-01-20 19:35:39
1694,816,2,798,103,901,1677,2021-01-21 18:07:41
1695,761,3,947,123,1070,1678,2021-01-22 02:58:09
1696,710,3,608,79,687,1679,2021-01-21 19:00:59
1697,972,2,429,55,484,1680,2021-01-21 23:27:25
1698,594,2,1098,142,1240,1681,2021-01-22 03:42:57
1699,763,4,1046,135,1181,1682,2021-01-21 22:19:03
1700,663,3,597,77,674,1683,2021-01-21 17:09:16
1701,608,2,498,64,562,1684,2021-01-21 20:53:36
1702,895,3,888,115,1003,1685,2021-01-21 06:24:15
1703,33,3,608,79,687,1686,2021-01-21 06:59:28
1704,919,2,598,77,675,1687,2021-01-21 01:18:53
1705,919,2,598,77,675,1687,2021-01-21 01:18:53
1706,292,2,1098,142,1240,1688,2021-01-21 11:00:28
1707,980,2,898,116,1014,1689,2021-01-21 11:08:22
1708,409,1,299,38,337,1690,2021-01-21 02:04:50
1709,40,2,528,68,596,1691,2021-01-21 00:17:27
1710,545,5,1786,232,2018,1692,2021-01-20 14:26:36
1711,502,2,698,90,788,1693,2021-01-20 15:28:57
1712,629,5,1555,202,1757,1694,2021-01-20 12:24:05
1713,786,3,847,110,957,1695,2021-01-20 20:42:51
1714,847,5,1545,200,1745,1696,2021-01-21 19:14:08
1715,297,3,1247,162,1409,1697,2021-01-22 03:57:03
1716,2,6,1175,152,1327,1698,2021-01-21 20:39:03
1717,578,5,1206,156,1362,1699,2021-01-21 23:33:12
1718,875,3,1127,146,1273,1700,2021-01-22 06:09:20
1719,651,2,598,77,675,1701,2021-01-22 00:22:32
1720,136,3,697,90,787,1702,2021-01-21 18:38:11
1721,510,2,429,55,484,1703,2021-01-21 23:00:48
1722,408,3,608,79,687,1704,2021-01-21 06:31:52
1723,472,2,898,116,1014,1705,2021-01-21 08:21:29
1724,637,3,1027,133,1160,1706,2021-01-21 02:24:22
1725,992,3,558,72,630,1707,2021-01-21 03:25:57
1726,793,5,1375,178,1553,1708,2021-01-21 12:12:40
1727,954,3,558,72,630,1709,2021-01-21 11:12:28
1728,450,6,1685,219,1904,1710,2021-01-21 02:29:56
1729,305,2,459,59,518,1711,2021-01-21 01:24:19
1730,106,5,1786,232,2018,1712,2021-01-20 16:23:47
1731,738,2,659,85,744,1713,2021-01-20 17:58:08
1732,928,3,558,72,630,1714,2021-01-20 14:52:34
1733,570,3,697,90,787,1715,2021-01-20 22:19:30
1734,827,2,329,42,371,1716,2021-01-21 21:20:02
1735,135,2,498,64,562,1717,2021-01-22 05:29:21
1736,32,1,149,19,168,1718,2021-01-21 22:27:31
1737,383,2,898,116,1014,1719,2021-01-22 01:53:29
1738,780,4,1226,159,1385,1720,2021-01-22 06:32:54
1739,410,2,459,59,518,1721,2021-01-22 02:20:28
1740,934,3,997,129,1126,1722,2021-01-21 20:05:27
1741,535,3,997,129,1126,1723,2021-01-22 00:28:49
1742,182,3,697,90,787,1724,2021-01-21 08:39:29
1743,86,2,928,120,1048,1725,2021-01-21 10:36:10
1744,586,3,1047,136,1183,1726,2021-01-21 04:32:15
1745,970,2,528,68,596,1727,2021-01-21 05:16:10
1746,12,3,758,98,856,1728,2021-01-21 14:44:57
1747,519,3,847,110,957,1729,2021-01-21 13:02:08
1748,304,3,847,110,957,1730,2021-01-21 04:35:39
1749,192,3,688,89,777,1731,2021-01-21 02:10:08
1750,481,3,888,115,1003,1732,2021-01-20 17:04:56
1751,177,3,827,107,934,1733,2021-01-20 20:27:17
1752,945,2,598,77,675,1734,2021-01-20 16:29:34
1753,839,2,398,51,449,1735,2021-01-20 23:37:29
1754,538,3,827,107,934,1736,2021-01-21 23:47:05
1755,581,3,688,89,777,1737,2021-01-22 07:52:11
1756,543,3,1247,162,1409,1738,2021-01-21 23:16:09
1757,726,2,798,103,901,1739,2021-01-22 02:58:03
1758,669,3,808,105,913,1740,2021-01-22 07:45:12
1759,384,3,558,72,630,1741,2021-01-22 03:36:31
1760,799,3,827,107,934,1742,2021-01-21 21:05:42
1761,127,2,898,116,1014,1743,2021-01-22 02:27:20
1762,466,3,1247,162,1409,1744,2021-01-21 09:03:33
1763,855,6,1424,185,1609,1745,2021-01-21 10:50:36
1764,22,3,1127,146,1273,1746,2021-01-21 06:25:27
1765,876,2,598,77,675,1747,2021-01-21 07:28:52
1766,338,3,558,72,630,1748,2021-01-21 15:42:43
1767,666,2,928,120,1048,1749,2021-01-21 13:10:34
1768,75,6,1715,222,1937,1750,2021-01-21 04:47:40
1769,294,2,698,90,788,1751,2021-01-21 03:55:34
1770,715,5,1906,247,2153,1752,2021-01-20 17:06:29
1771,949,3,747,97,844,1753,2021-01-20 21:11:38
1772,308,3,1327,172,1499,1754,2021-01-20 18:41:36
1773,206,3,808,105,913,1755,2021-01-21 00:51:57
1774,72,2,598,77,675,1756,2021-01-22 02:00:00
1775,847,5,1745,226,1971,1757,2021-01-22 10:15:17
1776,247,3,558,72,630,1758,2021-01-22 01:38:22
1777,26,2,798,103,901,1759,2021-01-22 05:27:11
1778,863,3,997,129,1126,1760,2021-01-22 10:22:38
1779,988,3,578,75,653,1761,2021-01-22 05:54:30
1780,913,3,797,103,900,1762,2021-01-21 21:50:58
1781,768,3,597,77,674,1763,2021-01-22 04:40:49
1782,625,3,897,116,1013,1764,2021-01-21 11:08:24
1783,670,2,698,90,788,1765,2021-01-21 10:53:49
1784,49,3,558,72,630,1766,2021-01-21 07:18:16
1785,796,3,1327,172,1499,1767,2021-01-21 09:46:52
1786,971,2,598,77,675,1768,2021-01-21 18:16:26
1787,149,3,897,116,1013,1769,2021-01-21 15:06:56
1788,415,2,429,55,484,1770,2021-01-21 05:47:23
1789,518,5,1256,163,1419,1771,2021-01-21 05:40:38
1790,953,3,697,90,787,1772,2021-01-20 17:58:52
1791,376,5,1556,202,1758,1773,2021-01-20 21:57:35
1792,294,1,399,51,450,1774,2021-01-20 20:28:12
1793,209,3,808,105,913,1775,2021-01-21 00:52:20
1794,907,3,797,103,900,1776,2021-01-22 04:36:04
1795,627,3,797,103,900,1777,2021-01-22 10:46:59
1796,872,3,578,75,653,1778,2021-01-22 01:45:18
1797,939,2,898,116,1014,1779,2021-01-22 06:32:15
1798,377,5,1745,226,1971,1780,2021-01-22 11:09:51
1799,78,2,598,77,675,1781,2021-01-22 08:04:16
1800,675,2,429,55,484,1782,2021-01-21 22:38:38
1801,398,3,808,105,913,1783,2021-01-22 04:42:56
1802,902,3,1127,146,1273,1784,2021-01-21 13:43:00
1803,120,3,1047,136,1183,1785,2021-01-21 10:54:43
1804,48,2,598,77,675,1786,2021-01-21 08:23:44
1805,13,2,598,77,675,1787,2021-01-21 10:47:47
1806,15,2,848,110,958,1788,2021-01-21 20:17:36
1807,349,2,898,116,1014,1789,2021-01-21 16:38:25
1808,677,3,1327,172,1499,1790,2021-01-21 08:22:32
1809,492,3,827,107,934,1791,2021-01-21 08:02:43
1810,468,2,1098,142,1240,1792,2021-01-20 19:41:32
1811,380,2,728,94,822,1793,2021-01-20 22:29:37
1812,832,3,478,62,540,1794,2021-01-20 20:57:16
1813,7,3,1127,146,1273,1795,2021-01-21 02:18:51
1814,936,3,658,85,743,1796,2021-01-22 06:24:10
1815,407,3,1127,146,1273,1797,2021-01-22 11:17:58
1816,174,2,498,64,562,1798,2021-01-22 02:40:49
1817,734,1,229,29,258,1799,2021-01-22 08:18:49
1818,538,2,329,42,371,1800,2021-01-22 13:23:51
1819,398,4,1196,155,1351,1801,2021-01-22 08:15:57
1820,863,2,928,120,1048,1802,2021-01-21 23:41:02
1821,176,1,499,64,563,1803,2021-01-22 07:02:59
1822,762,3,888,115,1003,1804,2021-01-21 15:45:50
1823,587,3,608,79,687,1805,2021-01-21 13:35:46
1824,475,3,528,68,596,1806,2021-01-21 10:57:21
1825,22,3,528,68,596,1807,2021-01-21 13:03:49
1826,3,4,1246,161,1407,1808,2021-01-21 21:34:50
1827,532,3,808,105,913,1809,2021-01-21 17:31:47
1828,896,3,558,72,630,1810,2021-01-21 10:54:04
1829,795,3,897,116,1013,1811,2021-01-21 10:16:16
1830,768,6,1255,163,1418,1812,2021-01-20 20:19:25
1831,531,3,747,97,844,1813,2021-01-21 00:35:00
1832,526,3,897,116,1013,1814,2021-01-20 23:08:38
1833,726,6,2174,282,2456,1815,2021-01-21 04:54:12
1834,92,4,1027,133,1160,1816,2021-01-22 06:40:04
1835,521,2,598,77,675,1817,2021-01-22 12:53:35
1836,979,3,997,129,1126,1818,2021-01-22 04:52:13
1837,197,2,329,42,371,1819,2021-01-22 10:55:13
1838,143,3,758,98,856,1820,2021-01-22 14:35:59
1839,237,2,598,77,675,1821,2021-01-22 10:11:36
1840,645,2,459,59,518,1822,2021-01-22 00:11:26
1841,807,4,1526,198,1724,1823,2021-01-22 08:22:18
1842,811,3,758,98,856,1824,2021-01-21 17:09:42
1843,771,3,558,72,630,1825,2021-01-21 14:34:38
1844,475,2,898,116,1014,1826,2021-01-21 11:42:42
1845,327,2,429,55,484,1827,2021-01-21 15:04:08
1846,370,3,1197,155,1352,1828,2021-01-22 00:16:35
1847,93,2,698,90,788,1829,2021-01-21 18:07:17
1848,765,3,688,89,777,1830,2021-01-21 13:00:33
1849,664,1,99,12,111,1831,2021-01-21 10:39:00
1850,645,3,758,98,856,1832,2021-01-20 21:25:59
1851,167,3,758,98,856,1833,2021-01-21 01:29:02
1852,878,3,827,107,934,1834,2021-01-21 01:23:19
1853,228,3,888,115,1003,1835,2021-01-21 06:41:45
1854,309,5,1456,189,1645,1836,2021-01-22 08:20:17
1855,764,3,727,94,821,1837,2021-01-22 14:14:51
1856,707,5,1556,202,1758,1838,2021-01-22 06:42:46
1857,326,3,1247,162,1409,1839,2021-01-22 11:35:47
1858,149,2,1098,142,1240,1840,2021-01-22 15:56:06
1859,675,3,888,115,1003,1841,2021-01-22 12:33:13
1860,991,2,698,90,788,1842,2021-01-22 02:47:29
1861,589,3,688,89,777,1843,2021-01-22 10:52:12
1862,328,3,688,89,777,1844,2021-01-21 19:22:52
1863,494,2,898,116,1014,1845,2021-01-21 14:37:52
1864,976,2,598,77,675,1846,2021-01-21 13:59:25
1865,66,2,329,42,371,1847,2021-01-21 15:48:25
1866,315,3,727,94,821,1848,2021-01-22 02:09:26
1867,919,3,888,115,1003,1849,2021-01-21 18:20:53
1868,526,2,748,97,845,1850,2021-01-21 14:36:25
1869,347,2,329,42,371,1851,2021-01-21 12:46:02
1870,739,3,697,90,787,1852,2021-01-21 00:08:05
1871,647,3,688,89,777,1853,2021-01-21 01:32:08
1872,849,2,548,71,619,1854,2021-01-21 01:31:00
1873,935,3,688,89,777,1855,2021-01-21 07:25:37
1874,606,3,528,68,596,1856,2021-01-22 08:57:18
1875,109,6,1255,163,1418,1857,2021-01-22 16:20:05
1876,96,3,428,55,483,1858,2021-01-22 07:40:42
1877,611,3,947,123,1070,1859,2021-01-22 14:13:14
1878,878,2,698,90,788,1860,2021-01-22 17:59:54
1879,85,3,727,94,821,1861,2021-01-22 14:50:42
1880,828,2,628,81,709,1862,2021-01-22 05:28:22
1881,795,5,1026,133,1159,1863,2021-01-22 12:23:37
1882,157,3,747,97,844,1864,2021-01-21 20:40:26
1883,336,3,1047,136,1183,1865,2021-01-21 14:59:56
1884,713,3,558,72,630,1866,2021-01-21 14:14:52
1885,954,4,1196,155,1351,1867,2021-01-21 17:11:49
1886,701,2,848,110,958,1868,2021-01-22 04:52:49
1887,983,3,428,55,483,1869,2021-01-21 20:38:16
1888,445,2,329,42,371,1870,2021-01-21 15:23:10
1889,895,2,598,77,675,1871,2021-01-21 15:11:29
1890,671,2,798,103,901,1872,2021-01-21 00:26:13
1891,671,2,798,103,901,1872,2021-01-21 00:26:13
1892,687,3,747,97,844,1873,2021-01-21 02:25:10
1893,76,3,658,85,743,1874,2021-01-21 03:52:46
1894,664,2,898,116,1014,1875,2021-01-21 09:11:39
1895,489,1,599,77,676,1876,2021-01-22 11:00:19
1896,772,2,459,59,518,1877,2021-01-22 18:33:22
1897,903,3,1247,162,1409,1878,2021-01-22 09:18:07
1898,270,3,1047,136,1183,1879,2021-01-22 14:21:48
1899,332,3,608,79,687,1880,2021-01-22 19:39:08
1900,209,2,898,116,1014,1881,2021-01-22 16:40:35
1901,824,2,659,85,744,1882,2021-01-22 07:06:39
1902,930,2,329,42,371,1883,2021-01-22 14:22:43
1903,196,2,329,42,371,1884,2021-01-21 21:25:00
1904,680,2,798,103,901,1885,2021-01-21 16:50:59
1905,740,3,1247,162,1409,1886,2021-01-21 14:50:31
1906,476,3,647,84,731,1887,2021-01-21 19:16:54
1907,110,1,399,51,450,1888,2021-01-22 07:09:35
1908,461,5,1555,202,1757,1889,2021-01-21 23:10:16
1909,432,5,1326,172,1498,1890,2021-01-21 17:01:18
1910,994,3,1327,172,1499,1891,2021-01-21 16:51:35
1911,54,3,997,129,1126,1892,2021-01-21 01:49:32
1912,162,3,758,98,856,1893,2021-01-21 01:01:27
1913,604,3,647,84,731,1894,2021-01-21 04:17:23
1914,963,3,897,116,1013,1895,2021-01-21 03:55:40
1915,209,2,898,116,1014,1896,2021-01-21 11:08:32
1916,272,2,659,85,744,1897,2021-01-22 11:47:56
1917,624,2,598,77,675,1898,2021-01-22 19:07:03
1918,843,3,747,97,844,1899,2021-01-22 11:45:43
1919,405,3,428,55,483,1900,2021-01-22 14:55:33
1920,291,4,1426,185,1611,1901,2021-01-22 20:41:34
1921,180,3,1047,136,1183,1902,2021-01-22 18:07:46
1922,205,3,528,68,596,1903,2021-01-22 08:11:26
1923,517,3,827,107,934,1904,2021-01-22 16:21:43
1924,273,1,99,12,111,1905,2021-01-21 22:56:25
1925,559,3,608,79,687,1906,2021-01-21 18:01:20
1926,281,6,1644,213,1857,1907,2021-01-21 17:23:26
1927,696,3,927,120,1047,1908,2021-01-21 21:34:09
1928,147,2,798,103,901,1909,2021-01-22 08:49:37
1929,874,2,698,90,788,1910,2021-01-22 00:01:24
1930,238,2,498,64,562,1911,2021-01-21 18:05:44
1931,128,2,448,58,506,1912,2021-01-21 18:36:06
1932,636,2,659,85,744,1913,2021-01-21 02:51:46
1933,575,3,827,107,934,1914,2021-01-21 01:10:26
1934,853,3,947,123,1070,1915,2021-01-21 04:24:29
1935,260,2,429,55,484,1916,2021-01-21 04:58:15
1936,148,3,888,115,1003,1917,2021-01-21 13:26:45
1937,787,3,688,89,777,1918,2021-01-22 13:47:16
1938,141,2,698,90,788,1919,2021-01-22 21:26:05
1939,817,3,1127,146,1273,1920,2021-01-22 14:06:17
1940,295,2,898,116,1014,1921,2021-01-22 16:34:53
1941,260,5,1486,193,1679,1922,2021-01-22 21:21:24
1942,33,6,1305,169,1474,1923,2021-01-22 18:52:16
1943,156,6,1475,191,1666,1924,2021-01-22 10:26:12
1944,17,2,848,110,958,1925,2021-01-22 17:06:34
1945,652,5,1495,194,1689,1926,2021-01-22 01:36:32
1946,237,2,898,116,1014,1927,2021-01-21 19:15:06
1947,404,3,997,129,1126,1928,2021-01-21 17:41:14
1948,815,3,597,77,674,1929,2021-01-21 23:42:18
1949,425,2,798,103,901,1930,2021-01-22 10:36:53
1950,201,3,827,107,934,1931,2021-01-22 01:16:08
1951,856,6,1275,165,1440,1932,2021-01-21 20:22:48
1952,501,2,598,77,675,1933,2021-01-21 19:01:38
1953,77,2,459,59,518,1934,2021-01-21 05:29:19
1954,545,2,798,103,901,1935,2021-01-21 01:33:11
1955,950,3,688,89,777,1936,2021-01-21 05:03:47
1956,920,3,1247,162,1409,1937,2021-01-21 06:14:26
1957,371,2,598,77,675,1938,2021-01-21 14:48:11
1958,804,2,528,68,596,1939,2021-01-22 15:59:55
1959,604,4,977,127,1104,1940,2021-01-22 21:56:34
1960,180,3,947,123,1070,1941,2021-01-22 14:10:53
1961,52,2,628,81,709,1942,2021-01-22 19:02:08
1962,751,6,1905,247,2152,1943,2021-01-22 22:11:09
1963,509,2,329,42,371,1944,2021-01-22 19:08:12
1964,122,4,1196,155,1351,1945,2021-01-22 12:23:48
1965,399,2,798,103,901,1946,2021-01-22 19:24:52
1966,931,3,1247,162,1409,1947,2021-01-22 02:31:17
1967,49,3,897,116,1013,1948,2021-01-21 20:10:28
1968,175,5,1245,161,1406,1949,2021-01-21 19:41:58
1969,421,2,748,97,845,1950,2021-01-22 02:26:25
1970,507,3,658,85,743,1951,2021-01-22 11:27:16
1971,83,3,1197,155,1352,1952,2021-01-22 03:13:37
1972,1000,2,1098,142,1240,1953,2021-01-21 21:44:28
1973,509,2,498,64,562,1954,2021-01-21 20:46:29
1974,427,5,1555,202,1757,1955,2021-01-21 06:04:53
1975,733,3,1047,136,1183,1956,2021-01-21 02:51:36
1976,628,3,428,55,483,1957,2021-01-21 06:28:29
1977,235,6,1535,199,1734,1958,2021-01-21 08:43:25
1978,455,5,1495,194,1689,1959,2021-01-21 14:59:51
1979,310,2,459,59,518,1960,2021-01-22 18:10:50
1980,999,2,898,116,1014,1961,2021-01-23 00:14:20
1981,202,3,1247,162,1409,1962,2021-01-22 16:47:03
1982,331,3,1027,133,1160,1963,2021-01-22 20:08:13
1983,893,6,2074,269,2343,1964,2021-01-23 00:56:45
1984,768,3,478,62,540,1965,2021-01-22 21:43:39
1985,280,2,598,77,675,1966,2021-01-22 13:56:37
1986,711,2,848,110,958,1967,2021-01-22 21:18:18
1987,521,2,659,85,744,1968,2021-01-22 03:26:43
1988,417,2,498,64,562,1969,2021-01-21 21:40:42
1989,7,4,1846,239,2085,1970,2021-01-21 22:28:09
1990,708,6,1505,195,1700,1971,2021-01-22 03:27:25
1991,567,3,428,55,483,1972,2021-01-22 13:52:49
1992,672,3,697,90,787,1973,2021-01-22 04:07:03
1993,609,2,459,59,518,1974,2021-01-21 21:48:03
1994,39,4,1176,152,1328,1975,2021-01-21 22:53:37
1995,924,3,847,110,957,1976,2021-01-21 08:11:20
1996,62,2,898,116,1014,1977,2021-01-21 05:10:12
1997,988,2,598,77,675,1978,2021-01-21 08:17:50
1998,672,5,1656,215,1871,1979,2021-01-21 08:46:09
1999,697,5,1625,211,1836,1980,2021-01-21 16:33:12
2000,114,2,498,64,562,1981,2021-01-22 19:18:55
2001,671,3,697,90,787,1982,2021-01-23 00:16:27
2002,807,3,758,98,856,1983,2021-01-22 18:01:13
2003,473,3,558,72,630,1984,2021-01-22 21:15:29
2004,142,2,598,77,675,1985,2021-01-23 02:48:37
2005,679,3,1247,162,1409,1986,2021-01-22 23:13:16
2006,566,3,927,120,1047,1987,2021-01-22 15:28:32
2007,421,2,498,64,562,1988,2021-01-22 22:59:10
2008,168,2,598,77,675,1989,2021-01-22 04:50:16
2009,398,3,1327,172,1499,1990,2021-01-21 22:53:14
2010,746,3,528,68,596,1991,2021-01-21 23:59:18
2011,427,5,1445,187,1632,1992,2021-01-22 05:18:53
2012,62,2,659,85,744,1993,2021-01-22 14:52:56
2013,544,2,548,71,619,1994,2021-01-22 05:15:36
2014,15,3,558,72,630,1995,2021-01-21 23:02:41
2015,325,4,1946,252,2198,1996,2021-01-22 00:47:46
2016,680,3,1027,133,1160,1997,2021-01-21 10:18:43
2017,436,2,498,64,562,1998,2021-01-21 06:30:30
2018,562,3,758,98,856,1999,2021-01-21 10:09:55
2019,219,3,1027,133,1160,2000,2021-01-21 10:16:26
2020,436,3,1047,136,1183,2001,2021-01-21 17:55:43
2021,734,3,897,116,1013,2002,2021-01-22 20:54:07
2022,76,3,697,90,787,2003,2021-01-23 02:38:05
2023,946,5,1056,137,1193,2004,2021-01-22 19:52:26
2024,884,3,947,123,1070,2005,2021-01-22 22:38:35
2025,160,3,697,90,787,2006,2021-01-23 04:03:11
2026,873,2,498,64,562,2007,2021-01-23 01:03:14
2027,620,3,688,89,777,2008,2021-01-22 15:45:03
2028,82,5,926,120,1046,2009,2021-01-22 23:20:21
2029,362,3,697,90,787,2010,2021-01-22 05:37:52
2030,961,3,827,107,934,2011,2021-01-21 23:13:59
2031,158,3,428,55,483,2012,2021-01-22 01:06:23
2032,170,3,797,103,900,2013,2021-01-22 06:15:11
2033,304,3,578,75,653,2014,2021-01-22 15:18:23
2034,811,3,478,62,540,2015,2021-01-22 05:45:13
2035,221,3,558,72,630,2016,2021-01-21 23:24:42
2036,903,1,399,51,450,2017,2021-01-22 02:01:53
2037,408,3,558,72,630,2018,2021-01-21 10:46:05
2038,344,3,597,77,674,2019,2021-01-21 09:13:40
2039,404,3,927,120,1047,2020,2021-01-21 10:20:50
2040,305,3,888,115,1003,2021,2021-01-21 11:51:17
2041,399,6,1605,208,1813,2022,2021-01-21 20:04:48
2042,927,3,1247,162,1409,2023,2021-01-22 22:51:39
2043,34,3,797,103,900,2024,2021-01-23 03:42:22
2044,265,5,1045,135,1180,2025,2021-01-22 20:03:42
2045,667,3,797,103,900,2026,2021-01-23 00:00:33
2046,982,3,558,72,630,2027,2021-01-23 05:53:15
2047,520,3,847,110,957,2028,2021-01-23 03:47:02
2048,788,2,798,103,901,2029,2021-01-22 18:08:15
2049,608,3,827,107,934,2030,2021-01-23 02:05:36
2050,565,2,329,42,371,2031,2021-01-22 08:12:27
2051,62,2,498,64,562,2032,2021-01-22 01:40:05
2052,958,2,598,77,675,2033,2021-01-22 03:42:35
2053,977,5,1195,155,1350,2034,2021-01-22 08:14:49
2054,37,2,329,42,371,2035,2021-01-22 18:00:12
2055,396,2,1098,142,1240,2036,2021-01-22 06:50:58
2056,958,3,1047,136,1183,2037,2021-01-21 23:56:57
2057,635,2,329,42,371,2038,2021-01-22 04:40:49
2058,823,5,1525,198,1723,2039,2021-01-21 12:25:46
2059,877,3,827,107,934,2040,2021-01-21 11:43:17
2060,550,5,1345,174,1519,2041,2021-01-21 12:12:23
2061,432,3,758,98,856,2042,2021-01-21 12:57:21
2062,881,5,1825,237,2062,2043,2021-01-21 22:41:27
2063,283,2,459,59,518,2044,2021-01-23 01:17:55
2064,499,1,699,90,789,2045,2021-01-23 04:45:09
2065,265,3,1027,133,1160,2046,2021-01-22 22:09:57
2066,419,5,1975,256,2231,2047,2021-01-23 01:39:44
2067,958,5,1195,155,1350,2048,2021-01-23 08:15:24
2068,258,3,688,89,777,2049,2021-01-23 04:58:55
2069,159,3,1047,136,1183,2050,2021-01-22 20:51:52
2070,551,5,1686,219,1905,2051,2021-01-23 03:52:18
2071,73,3,528,68,596,2052,2021-01-22 09:41:00
2072,685,2,598,77,675,2053,2021-01-22 02:28:10
2073,919,3,947,123,1070,2054,2021-01-22 04:13:03
2074,266,2,648,84,732,2055,2021-01-22 09:28:44
2075,854,3,727,94,821,2056,2021-01-22 20:40:18
2076,468,3,608,79,687,2057,2021-01-22 08:09:14
2077,196,3,1127,146,1273,2058,2021-01-22 00:20:56
2078,327,5,1456,189,1645,2059,2021-01-22 05:37:49
2079,807,2,598,77,675,2060,2021-01-21 13:44:24
2080,455,3,428,55,483,2061,2021-01-21 12:24:33
2081,156,3,847,110,957,2062,2021-01-21 14:24:40
2082,674,3,747,97,844,2063,2021-01-21 14:50:05
2083,603,3,558,72,630,2064,2021-01-21 23:27:12
2084,603,3,558,72,630,2064,2021-01-21 23:27:12
2085,470,3,927,120,1047,2065,2021-01-23 03:51:27
2086,436,3,558,72,630,2066,2021-01-23 04:46:18
2087,716,3,827,107,934,2067,2021-01-22 23:04:37
2088,475,3,658,85,743,2068,2021-01-23 02:26:25
2089,501,3,478,62,540,2069,2021-01-23 08:45:55
2090,292,3,727,94,821,2070,2021-01-23 07:36:14
2091,443,3,697,90,787,2071,2021-01-22 21:29:09
2092,919,5,1725,224,1949,2072,2021-01-23 06:04:05
2093,541,5,1576,204,1780,2073,2021-01-22 12:14:20
2094,372,3,997,129,1126,2074,2021-01-22 04:24:35
2095,389,5,1395,181,1576,2075,2021-01-22 06:53:13
2096,115,3,897,116,1013,2076,2021-01-22 10:38:31
2097,747,3,827,107,934,2077,2021-01-22 22:00:54
2098,895,3,747,97,844,2078,2021-01-22 10:17:37
2099,122,3,558,72,630,2079,2021-01-22 01:05:05
2100,566,2,698,90,788,2080,2021-01-22 08:04:43
2101,858,2,459,59,518,2081,2021-01-21 16:13:05
2102,984,3,927,120,1047,2082,2021-01-21 12:43:04
2103,35,2,429,55,484,2083,2021-01-21 16:11:25
2104,900,3,558,72,630,2084,2021-01-21 17:09:20
2105,814,2,459,59,518,2085,2021-01-22 00:15:07
2106,124,3,578,75,653,2086,2021-01-21 23:56:30
2107,418,3,528,68,596,2087,2021-01-23 06:20:07
2108,331,5,1206,156,1362,2088,2021-01-23 04:47:38
2109,501,3,558,72,630,2089,2021-01-23 01:35:30
2110,711,3,1327,172,1499,2090,2021-01-23 03:18:05
2111,484,3,428,55,483,2091,2021-01-23 09:14:20
2112,765,3,997,129,1126,2092,2021-01-23 08:51:53
2113,454,3,697,90,787,2093,2021-01-22 21:32:19
2114,741,3,597,77,674,2094,2021-01-23 08:47:59
2115,921,2,429,55,484,2095,2021-01-22 13:09:08
2116,445,3,647,84,731,2096,2021-01-22 06:47:49
2117,980,3,478,62,540,2097,2021-01-22 08:20:06
2118,767,3,997,129,1126,2098,2021-01-22 11:09:42
2119,729,2,498,64,562,2099,2021-01-22 22:48:45
2120,892,2,459,59,518,2100,2021-01-22 10:21:28
2121,620,3,658,85,743,2101,2021-01-22 01:13:25
2122,62,5,1425,185,1610,2102,2021-01-22 08:35:02
2123,168,5,956,124,1080,2103,2021-01-21 17:56:11
2124,207,2,598,77,675,2104,2021-01-21 15:13:12
2125,464,3,1127,146,1273,2105,2021-01-21 16:17:15
2126,842,3,747,97,844,2106,2021-01-21 18:53:26
2127,714,2,429,55,484,2107,2021-01-22 01:21:40
2128,8,5,1595,207,1802,2108,2021-01-22 01:24:29
2129,710,6,1605,208,1813,2109,2021-01-23 08:46:43
2130,249,2,698,90,788,2110,2021-01-23 05:24:20
2131,546,3,727,94,821,2111,2021-01-23 04:07:43
2132,790,2,329,42,371,2112,2021-01-23 03:44:41
2133,361,6,2294,298,2592,2113,2021-01-23 10:39:54
2134,36,3,697,90,787,2114,2021-01-23 10:56:09
2135,565,2,798,103,901,2115,2021-01-22 23:00:53
2136,84,1,99,12,111,2116,2021-01-23 09:20:30
2137,809,3,997,129,1126,2117,2021-01-22 15:26:35
2138,428,2,459,59,518,2118,2021-01-22 07:09:50
2139,330,3,747,97,844,2119,2021-01-22 10:38:15
2140,389,3,658,85,743,2120,2021-01-22 13:29:12
2141,389,3,658,85,743,2120,2021-01-22 13:29:12
2142,675,4,1356,176,1532,2121,2021-01-23 00:05:11
2143,697,4,1626,211,1837,2122,2021-01-22 11:37:59
2144,518,3,647,84,731,2123,2021-01-22 02:58:03
2145,559,3,1127,146,1273,2124,2021-01-22 09:15:09
2146,682,6,1446,187,1633,2125,2021-01-21 19:24:35
2147,667,4,1326,172,1498,2126,2021-01-21 15:55:35
2148,495,2,459,59,518,2127,2021-01-21 16:17:44
2149,181,3,697,90,787,2128,2021-01-21 20:41:53
2150,948,2,429,55,484,2129,2021-01-22 04:02:27
2151,407,3,1047,136,1183,2130,2021-01-22 02:50:57
2152,954,3,797,103,900,2131,2021-01-23 10:52:38
2153,687,1,399,51,450,2132,2021-01-23 06:21:48
2154,45,5,1445,187,1632,2133,2021-01-23 04:15:37
2155,406,3,997,129,1126,2134,2021-01-23 04:05:24
2156,988,2,748,97,845,2135,2021-01-23 11:05:15
2157,51,3,797,103,900,2136,2021-01-23 13:08:22
2158,416,3,997,129,1126,2137,2021-01-23 00:22:07
2159,280,5,1645,213,1858,2138,2021-01-23 09:45:58
2160,287,3,947,123,1070,2139,2021-01-22 16:31:18
2161,772,3,927,120,1047,2140,2021-01-22 07:42:26
2162,159,3,747,97,844,2141,2021-01-22 11:53:53
2163,186,3,808,105,913,2142,2021-01-22 14:29:24
2164,690,3,827,107,934,2143,2021-01-22 15:02:18
2165,46,3,758,98,856,2144,2021-01-23 00:42:04
2166,550,3,428,55,483,2145,2021-01-22 12:47:59
2167,851,3,697,90,787,2146,2021-01-22 03:45:18
2168,800,3,747,97,844,2147,2021-01-22 10:19:49
2169,463,2,498,64,562,2148,2021-01-21 21:33:37
2170,11,2,598,77,675,2149,2021-01-21 18:38:33
2171,883,2,898,116,1014,2150,2021-01-21 17:51:14
2172,329,4,1596,207,1803,2151,2021-01-21 22:14:46
2173,992,3,888,115,1003,2152,2021-01-22 05:31:43
2174,652,3,1047,136,1183,2153,2021-01-22 02:59:19
2175,224,3,947,123,1070,2154,2021-01-23 12:11:36
2176,816,3,478,62,540,2155,2021-01-23 07:33:19
2177,717,3,697,90,787,2156,2021-01-23 04:27:32
2178,967,3,1327,172,1499,2157,2021-01-23 04:27:45
2179,121,3,1127,146,1273,2158,2021-01-23 11:54:45
2180,377,3,727,94,821,2159,2021-01-23 15:45:55
2181,586,2,898,116,1014,2160,2021-01-23 02:22:39
2182,100,3,827,107,934,2161,2021-01-23 10:03:50
2183,105,4,1746,226,1972,2162,2021-01-22 17:18:50
2184,709,2,329,42,371,2163,2021-01-22 10:18:30
2185,333,3,697,90,787,2164,2021-01-22 12:06:54
2186,303,3,478,62,540,2165,2021-01-22 15:58:31
2187,98,3,647,84,731,2166,2021-01-22 16:10:45
2188,680,3,747,97,844,2167,2021-01-23 02:33:52
2189,986,2,1098,142,1240,2168,2021-01-22 15:30:56
2190,173,3,808,105,913,2169,2021-01-22 06:25:21
2191,531,3,897,116,1013,2170,2021-01-22 12:01:40
2192,368,3,558,72,630,2171,2021-01-21 22:42:29
2193,194,3,827,107,934,2172,2021-01-21 19:23:11
2194,499,3,697,90,787,2173,2021-01-21 19:21:34
2195,117,3,658,85,743,2174,2021-01-21 23:20:02
2196,390,2,659,85,744,2175,2021-01-22 08:09:10
2197,106,2,798,103,901,2176,2021-01-22 05:38:28
2198,842,3,808,105,913,2177,2021-01-23 12:36:47
2199,746,5,1575,204,1779,2178,2021-01-23 07:43:38
2200,686,3,1027,133,1160,2179,2021-01-23 05:47:53
2201,831,2,898,116,1014,2180,2021-01-23 07:03:46
2202,621,3,897,116,1013,2181,2021-01-23 13:14:54
2203,800,3,558,72,630,2182,2021-01-23 17:33:55
2204,609,3,827,107,934,2183,2021-01-23 03:53:59
2205,288,3,747,97,844,2184,2021-01-23 10:52:08
2206,257,3,658,85,743,2185,2021-01-22 19:22:54
2207,191,5,1506,195,1701,2186,2021-01-22 12:28:37
2208,458,3,697,90,787,2187,2021-01-22 13:16:06
2209,957,3,1327,172,1499,2188,2021-01-22 18:00:47
2210,995,2,798,103,901,2189,2021-01-22 17:50:03
2211,938,2,728,94,822,2190,2021-01-23 03:55:51
2212,447,2,498,64,562,2191,2021-01-22 16:38:48
2213,379,3,1127,146,1273,2192,2021-01-22 06:54:25
2214,725,3,747,97,844,2193,2021-01-22 12:47:43
2215,175,3,478,62,540,2194,2021-01-21 23:06:19
2216,890,2,1098,142,1240,2195,2021-01-21 20:03:35
2217,345,4,876,113,989,2196,2021-01-21 20:25:28
2218,763,6,2174,282,2456,2197,2021-01-22 01:35:50
2219,891,3,1247,162,1409,2198,2021-01-22 10:44:04
2220,866,3,997,129,1126,2199,2021-01-22 06:29:54
2221,635,3,697,90,787,2200,2021-01-23 12:55:28
2222,465,2,698,90,788,2201,2021-01-23 08:55:16
2223,498,1,299,38,337,2202,2021-01-23 08:11:26
2224,64,3,997,129,1126,2203,2021-01-23 08:43:52
2225,392,6,1755,228,1983,2204,2021-01-23 15:09:18
2226,560,3,888,115,1003,2205,2021-01-23 18:24:17
2227,707,2,598,77,675,2206,2021-01-23 05:40:04
2228,389,3,927,120,1047,2207,2021-01-23 12:00:54
2229,560,6,1944,252,2196,2208,2021-01-22 21:52:18
2230,726,3,697,90,787,2209,2021-01-22 14:21:51
2231,704,3,727,94,821,2210,2021-01-22 13:58:53
2232,253,4,1496,194,1690,2211,2021-01-22 20:20:27
2233,835,2,698,90,788,2212,2021-01-22 19:25:35
2234,513,3,1047,136,1183,2213,2021-01-23 05:29:53
2235,905,3,847,110,957,2214,2021-01-22 18:33:52
2236,701,2,898,116,1014,2215,2021-01-22 08:44:44
2237,980,3,578,75,653,2216,2021-01-22 13:33:35
2238,118,5,1395,181,1576,2217,2021-01-21 23:51:29
2239,300,2,798,103,901,2218,2021-01-21 22:19:46
2240,423,2,628,81,709,2219,2021-01-21 21:51:21
2241,456,3,688,89,777,2220,2021-01-22 03:48:37
2242,772,3,697,90,787,2221,2021-01-22 12:30:49
2243,783,6,1855,241,2096,2222,2021-01-22 09:04:14
2244,277,2,659,85,744,2223,2021-01-23 14:44:16
2245,350,5,1245,161,1406,2224,2021-01-23 09:15:42
2246,970,2,898,116,1014,2225,2021-01-23 08:24:52
2247,584,3,927,120,1047,2226,2021-01-23 11:09:45
2248,603,3,827,107,934,2227,2021-01-23 16:56:15
2249,364,3,578,75,653,2228,2021-01-23 19:44:47
2250,276,3,428,55,483,2229,2021-01-23 07:22:42
2251,929,3,558,72,630,2230,2021-01-23 12:32:34
2252,630,3,1327,172,1499,2231,2021-01-22 23:32:08
2253,630,3,1327,172,1499,2231,2021-01-22 23:32:08
2254,507,2,659,85,744,2232,2021-01-22 15:39:40
2255,708,3,1127,146,1273,2233,2021-01-22 14:46:59
2256,765,2,329,42,371,2234,2021-01-22 21:12:39
2257,542,2,659,85,744,2235,2021-01-22 21:26:23
2258,705,3,558,72,630,2236,2021-01-23 05:42:02
2259,862,3,428,55,483,2237,2021-01-22 19:04:41
2260,176,3,428,55,483,2238,2021-01-22 09:34:40
2261,325,3,927,120,1047,2239,2021-01-22 15:05:17
2262,465,2,329,42,371,2240,2021-01-22 02:16:59
2263,770,2,598,77,675,2241,2021-01-21 23:47:58
2264,954,3,827,107,934,2242,2021-01-21 23:06:24
2265,399,2,459,59,518,2243,2021-01-22 04:33:52
2266,143,1,99,12,111,2244,2021-01-22 14:58:32
2267,960,2,429,55,484,2245,2021-01-22 09:07:03
2268,484,3,1047,136,1183,2246,2021-01-23 16:08:36
2269,391,2,498,64,562,2247,2021-01-23 09:20:28
2270,938,3,1027,133,1160,2248,2021-01-23 10:36:13
2271,163,1,229,29,258,2249,2021-01-23 13:32:52
2272,96,2,798,103,901,2250,2021-01-23 19:39:31
2273,362,3,697,90,787,2251,2021-01-23 22:26:11
2274,916,3,727,94,821,2252,2021-01-23 08:13:15
2275,439,2,728,94,822,2253,2021-01-23 14:53:50
2276,438,5,1645,213,1858,2254,2021-01-23 00:44:32
2277,381,2,598,77,675,2255,2021-01-23 00:36:07
2278,969,3,797,103,900,2256,2021-01-22 17:48:33
2279,354,2,498,64,562,2257,2021-01-22 16:05:55
2280,475,1,229,29,258,2258,2021-01-22 21:30:13
2281,771,3,1127,146,1273,2259,2021-01-22 22:34:23
2282,113,2,598,77,675,2260,2021-01-23 06:04:43
2283,957,3,658,85,743,2261,2021-01-22 20:58:00
2284,327,1,149,19,168,2262,2021-01-22 10:34:22
2285,83,3,478,62,540,2263,2021-01-22 17:31:34
2286,525,3,747,97,844,2264,2021-01-22 04:26:25
2287,322,3,827,107,934,2265,2021-01-22 00:04:59
2288,956,3,997,129,1126,2266,2021-01-22 00:55:33
2289,30,3,428,55,483,2267,2021-01-22 07:19:42
2290,421,3,697,90,787,2268,2021-01-22 16:17:38
2291,887,3,758,98,856,2269,2021-01-22 09:38:46
2292,843,3,747,97,844,2270,2021-01-23 18:51:35
2293,272,3,558,72,630,2271,2021-01-23 11:36:02
2294,353,2,498,64,562,2272,2021-01-23 10:41:45
2295,869,2,459,59,518,2273,2021-01-23 14:06:40
2296,806,3,1027,133,1160,2274,2021-01-23 20:10:24
2297,738,6,2254,293,2547,2275,2021-01-23 23:06:38
2298,454,3,1027,133,1160,2276,2021-01-23 10:34:40
2299,354,3,1127,146,1273,2277,2021-01-23 15:38:35
2300,230,5,1506,195,1701,2278,2021-01-23 02:52:22
2301,887,3,847,110,957,2279,2021-01-23 01:29:28
2302,560,1,599,77,676,2280,2021-01-22 17:49:43
2303,262,2,798,103,901,2281,2021-01-22 18:41:14
2304,736,3,847,110,957,2282,2021-01-22 23:58:35
2305,714,3,1047,136,1183,2283,2021-01-22 23:17:14
2306,379,3,528,68,596,2284,2021-01-23 07:07:36
2307,198,1,699,90,789,2285,2021-01-22 22:47:43
2308,837,3,1047,136,1183,2286,2021-01-22 12:55:33
2309,990,3,947,123,1070,2287,2021-01-22 20:02:52
2310,634,4,957,124,1081,2288,2021-01-22 04:35:00
2311,778,3,1047,136,1183,2289,2021-01-22 00:48:41
2312,105,3,727,94,821,2290,2021-01-22 00:57:12
2313,346,3,927,120,1047,2291,2021-01-22 09:57:47
2314,569,6,1855,241,2096,2292,2021-01-22 18:47:20
2315,897,2,429,55,484,2293,2021-01-22 11:01:02
2316,636,1,149,19,168,2294,2021-01-23 20:52:06
2317,932,2,848,110,958,2295,2021-01-23 11:44:59
2318,73,4,1276,165,1441,2296,2021-01-23 13:26:51
2319,164,3,847,110,957,2297,2021-01-23 15:42:07
2320,167,2,429,55,484,2298,2021-01-23 21:31:53
2321,777,2,598,77,675,2299,2021-01-24 01:20:44
2322,808,2,728,94,822,2300,2021-01-23 11:20:27
2323,663,3,747,97,844,2301,2021-01-23 17:41:30
2324,735,6,2024,263,2287,2302,2021-01-23 04:23:00
2325,376,3,1327,172,1499,2303,2021-01-23 03:20:48
2326,185,3,888,115,1003,2304,2021-01-22 18:02:26
2327,617,2,659,85,744,2305,2021-01-22 19:51:17
2328,702,3,758,98,856,2306,2021-01-23 01:52:14
2329,101,2,329,42,371,2307,2021-01-23 00:52:49
2330,163,6,1455,189,1644,2308,2021-01-23 08:37:03
2331,859,3,847,110,957,2309,2021-01-23 01:19:05
2332,671,2,1098,142,1240,2310,2021-01-22 14:49:39
2333,459,3,578,75,653,2311,2021-01-22 22:15:02
2334,831,4,1346,174,1520,2312,2021-01-22 05:30:20
2335,514,3,797,103,900,2313,2021-01-22 02:50:41
2336,503,3,888,115,1003,2314,2021-01-22 02:16:44
2337,845,3,827,107,934,2315,2021-01-22 10:51:31
2338,343,3,697,90,787,2316,2021-01-22 21:14:14
2339,557,3,827,107,934,2317,2021-01-22 11:36:02
2340,772,3,808,105,913,2318,2021-01-23 22:31:25
2341,213,4,1396,181,1577,2319,2021-01-23 11:53:57
2342,213,4,1396,181,1577,2319,2021-01-23 11:53:57
2343,11,2,548,71,619,2320,2021-01-23 15:31:07
2344,423,2,398,51,449,2321,2021-01-23 17:08:22
2345,651,3,558,72,630,2322,2021-01-23 22:47:02
2346,760,2,898,116,1014,2323,2021-01-24 02:49:47
2347,197,3,578,75,653,2324,2021-01-23 13:27:45
2348,575,2,459,59,518,2325,2021-01-23 18:24:57
2349,335,3,927,120,1047,2326,2021-01-23 06:52:21
2350,240,3,697,90,787,2327,2021-01-23 05:31:45
2351,949,3,697,90,787,2328,2021-01-22 18:51:04
2352,949,3,697,90,787,2328,2021-01-22 18:51:04
2353,921,3,847,110,957,2329,2021-01-22 21:01:35
2354,804,3,647,84,731,2330,2021-01-23 03:48:20
2355,247,6,1576,204,1780,2331,2021-01-23 01:16:15
2356,263,3,897,116,1013,2332,2021-01-23 10:11:20
2357,250,3,888,115,1003,2333,2021-01-23 03:25:05
2358,373,3,827,107,934,2334,2021-01-22 17:19:49
2359,600,2,898,116,1014,2335,2021-01-22 22:31:20
2360,577,3,808,105,913,2336,2021-01-22 08:06:21
2361,764,3,558,72,630,2337,2021-01-22 03:05:55
2362,946,3,478,62,540,2338,2021-01-22 04:36:22
2363,707,4,1296,168,1464,2339,2021-01-22 12:41:38
2364,147,2,598,77,675,2340,2021-01-22 23:14:41
2365,749,4,1526,198,1724,2341,2021-01-22 11:48:09
2366,749,4,1526,198,1724,2341,2021-01-22 11:48:09
2367,190,3,428,55,483,2342,2021-01-24 00:41:38
2368,876,3,727,94,821,2343,2021-01-23 12:37:57
2369,486,3,997,129,1126,2344,2021-01-23 13:20:32
2370,883,6,1405,182,1587,2345,2021-01-23 17:01:08
2371,683,3,658,85,743,2346,2021-01-23 17:26:39
2372,132,6,1544,200,1744,2347,2021-01-24 00:26:02
2373,286,3,1027,133,1160,2348,2021-01-24 04:12:38
2374,649,3,697,90,787,2349,2021-01-23 15:56:23
2375,785,3,747,97,844,2350,2021-01-23 21:02:43
2376,658,6,1885,245,2130,2351,2021-01-23 09:22:59
2377,810,2,459,59,518,2352,2021-01-23 05:35:04
2378,870,3,827,107,934,2353,2021-01-22 20:38:58
2379,461,3,658,85,743,2354,2021-01-22 19:09:20
2380,435,3,1327,172,1499,2355,2021-01-22 22:17:36
2381,110,6,1275,165,1440,2356,2021-01-23 05:38:35
2382,79,3,827,107,934,2357,2021-01-23 02:58:35
2383,165,3,688,89,777,2358,2021-01-23 11:17:10
2384,764,3,428,55,483,2359,2021-01-23 05:28:03
2385,778,2,898,116,1014,2360,2021-01-22 19:27:59
2386,720,4,837,108,945,2361,2021-01-23 00:52:10
2387,216,3,927,120,1047,2362,2021-01-22 08:44:40
2388,62,3,1197,155,1352,2363,2021-01-22 03:32:37
2389,848,3,647,84,731,2364,2021-01-22 06:16:53
2390,191,3,808,105,913,2365,2021-01-22 12:48:37
2391,400,4,857,111,968,2366,2021-01-23 01:13:34
2392,47,2,659,85,744,2367,2021-01-22 13:27:44
2393,960,3,1027,133,1160,2368,2021-01-22 14:00:19
2394,634,3,428,55,483,2369,2021-01-24 00:55:42
2395,241,3,1047,136,1183,2370,2021-01-23 15:07:31
2396,858,3,647,84,731,2371,2021-01-23 15:15:34
2397,668,1,299,38,337,2372,2021-01-23 19:40:00
2398,780,3,747,97,844,2373,2021-01-23 19:15:14
2399,924,3,747,97,844,2374,2021-01-24 01:24:56
2400,75,3,428,55,483,2375,2021-01-24 04:29:21
2401,331,2,459,59,518,2376,2021-01-23 17:13:01
2402,857,3,558,72,630,2377,2021-01-23 21:13:06
2403,341,3,997,129,1126,2378,2021-01-23 11:06:34
2404,957,3,1047,136,1183,2379,2021-01-23 07:04:55
2405,713,3,1027,133,1160,2380,2021-01-22 23:20:31
2406,845,3,747,97,844,2381,2021-01-22 20:36:12
2407,356,3,897,116,1013,2382,2021-01-22 23:21:01
2408,832,3,897,116,1013,2383,2021-01-23 07:08:43
2409,753,3,747,97,844,2384,2021-01-23 03:41:00
2410,750,2,598,77,675,2385,2021-01-23 11:54:15
2411,233,3,558,72,630,2386,2021-01-23 06:43:06
2412,281,2,498,64,562,2387,2021-01-22 19:47:57
2413,339,3,647,84,731,2388,2021-01-23 02:31:53
2414,217,3,428,55,483,2389,2021-01-22 11:11:56
2415,646,1,599,77,676,2390,2021-01-22 03:46:21
2416,673,3,847,110,957,2391,2021-01-22 06:28:22
2417,33,5,1356,176,1532,2392,2021-01-22 13:18:55
2418,461,3,558,72,630,2393,2021-01-23 02:10:31
2419,829,3,558,72,630,2394,2021-01-22 15:11:07
2420,606,3,597,77,674,2395,2021-01-22 14:39:36
2421,576,1,599,77,676,2396,2021-01-24 02:50:16
2422,343,3,558,72,630,2397,2021-01-23 15:31:40
2423,179,3,827,107,934,2398,2021-01-23 17:52:56
2424,342,3,1047,136,1183,2399,2021-01-23 21:55:38
2425,101,2,659,85,744,2400,2021-01-23 21:56:15
2426,871,2,898,116,1014,2401,2021-01-24 03:54:19
2427,941,3,428,55,483,2402,2021-01-24 05:26:29
2428,353,3,747,97,844,2403,2021-01-23 19:10:21
2429,924,3,647,84,731,2404,2021-01-23 22:01:16
2430,770,2,429,55,484,2405,2021-01-23 11:36:44
2431,399,2,548,71,619,2406,2021-01-23 08:20:03
2432,741,3,927,120,1047,2407,2021-01-23 01:46:19
2433,952,3,758,98,856,2408,2021-01-22 20:46:34
2434,127,3,847,110,957,2409,2021-01-22 23:31:47
2435,89,1,599,77,676,2410,2021-01-23 09:55:03
2436,48,2,898,116,1014,2411,2021-01-23 04:37:13
2437,131,2,698,90,788,2412,2021-01-23 13:37:55
2438,397,3,927,120,1047,2413,2021-01-23 07:00:04
2439,669,3,578,75,653,2414,2021-01-22 20:33:57
2440,613,3,1247,162,1409,2415,2021-01-23 03:08:58
2441,817,3,947,123,1070,2416,2021-01-22 12:01:03
2442,705,3,528,68,596,2417,2021-01-22 04:56:11
2443,93,3,578,75,653,2418,2021-01-22 08:26:35
2444,718,3,827,107,934,2419,2021-01-22 14:30:38
2445,543,3,697,90,787,2420,2021-01-23 04:13:32
2446,420,2,498,64,562,2421,2021-01-22 15:22:34
2447,2,2,598,77,675,2422,2021-01-22 16:15:30
2448,946,2,659,85,744,2423,2021-01-24 03:25:45
2449,720,5,1486,193,1679,2424,2021-01-23 18:16:06
2450,710,2,498,64,562,2425,2021-01-23 19:24:28
2451,588,2,798,103,901,2426,2021-01-23 23:04:58
2452,835,3,847,110,957,2427,2021-01-23 22:10:20
2453,926,3,528,68,596,2428,2021-01-24 06:25:43
2454,328,3,847,110,957,2429,2021-01-24 06:24:12
2455,1,3,647,84,731,2430,2021-01-23 19:20:13
2456,232,2,698,90,788,2431,2021-01-23 22:04:57
2457,684,5,1245,161,1406,2432,2021-01-23 12:43:16
2458,639,1,699,90,789,2433,2021-01-23 09:29:24
2459,662,3,808,105,913,2434,2021-01-23 03:15:03
2460,959,5,1395,181,1576,2435,2021-01-22 21:01:33
2461,51,2,329,42,371,2436,2021-01-23 00:43:43
2462,308,3,608,79,687,2437,2021-01-23 10:40:06
2463,698,3,1127,146,1273,2438,2021-01-23 05:31:12
2464,5,2,798,103,901,2439,2021-01-23 13:40:43
2465,220,5,1745,226,1971,2440,2021-01-23 07:26:38
2466,71,3,658,85,743,2441,2021-01-22 21:51:48
2467,172,1,149,19,168,2442,2021-01-23 05:22:06
2468,988,3,927,120,1047,2443,2021-01-22 14:27:45
2469,838,1,699,90,789,2444,2021-01-22 07:15:44
2470,705,2,548,71,619,2445,2021-01-22 09:41:31
2471,488,3,597,77,674,2446,2021-01-22 14:42:17
2472,352,4,746,96,842,2447,2021-01-23 04:53:38
2473,408,4,1257,163,1420,2448,2021-01-22 16:15:48
2474,758,2,528,68,596,2449,2021-01-22 16:35:04
2475,653,3,528,68,596,2450,2021-01-24 05:57:48
2476,625,1,149,19,168,2451,2021-01-23 18:53:13
2477,256,4,1396,181,1577,2452,2021-01-23 20:16:35
2478,976,3,847,110,957,2453,2021-01-24 00:22:10
2479,341,2,828,107,935,2454,2021-01-23 23:06:26
2480,795,2,728,94,822,2455,2021-01-24 06:34:05
2481,189,2,498,64,562,2456,2021-01-24 08:20:19
2482,189,2,498,64,562,2456,2021-01-24 08:20:19
2483,899,2,659,85,744,2457,2021-01-23 21:08:33
2484,465,5,1895,246,2141,2458,2021-01-23 22:31:34
2485,831,6,1475,191,1666,2459,2021-01-23 13:36:34
2486,244,5,1856,241,2097,2460,2021-01-23 12:00:01
2487,524,2,329,42,371,2461,2021-01-23 03:47:32
2488,720,3,1127,146,1273,2462,2021-01-22 21:16:16
2489,173,3,1197,155,1352,2463,2021-01-23 01:55:57
2490,296,2,898,116,1014,2464,2021-01-23 11:16:58
2491,642,3,697,90,787,2465,2021-01-23 06:21:10
2492,958,2,898,116,1014,2466,2021-01-23 15:36:10
2493,685,2,598,77,675,2467,2021-01-23 07:44:38
2494,175,1,229,29,258,2468,2021-01-22 22:42:52
2495,175,1,229,29,258,2468,2021-01-22 22:42:52
2496,409,2,598,77,675,2469,2021-01-23 06:16:29
2497,740,2,429,55,484,2470,2021-01-22 16:09:38
2498,957,6,2244,291,2535,2471,2021-01-22 09:04:35
2499,43,2,698,90,788,2472,2021-01-22 12:09:37
2500,43,2,698,90,788,2472,2021-01-22 12:09:37
2501,279,6,1744,226,1970,2473,2021-01-22 17:03:28
2502,105,3,1047,136,1183,2474,2021-01-23 05:14:21
2503,651,3,747,97,844,2475,2021-01-22 17:39:24
2504,532,2,898,116,1014,2476,2021-01-22 17:06:35
2505,546,2,698,90,788,2477,2021-01-24 06:00:04
2506,689,2,898,116,1014,2478,2021-01-23 20:54:11
2507,145,4,1426,185,1611,2479,2021-01-23 22:26:32
2508,257,3,688,89,777,2480,2021-01-24 02:34:57
2509,508,2,1098,142,1240,2481,2021-01-24 00:35:11
2510,688,3,927,120,1047,2482,2021-01-24 06:41:36
2511,179,6,1385,180,1565,2483,2021-01-24 10:57:18
2512,533,2,498,64,562,2484,2021-01-24 08:42:43
2513,587,3,1047,136,1183,2485,2021-01-23 22:40:46
2514,767,3,1127,146,1273,2486,2021-01-23 22:57:50
2515,950,3,578,75,653,2487,2021-01-23 15:23:08
2516,868,2,798,103,901,2488,2021-01-23 12:07:01
2517,84,2,498,64,562,2489,2021-01-23 05:02:03
2518,736,2,1098,142,1240,2490,2021-01-22 21:53:43
2519,160,3,697,90,787,2491,2021-01-23 03:18:53
2520,920,2,1098,142,1240,2492,2021-01-23 13:47:38
2521,250,5,1136,147,1283,2493,2021-01-23 06:36:23
2522,606,2,659,85,744,2494,2021-01-23 17:01:44
2523,591,1,699,90,789,2495,2021-01-23 08:38:25
2524,728,2,798,103,901,2496,2021-01-23 01:18:22
2525,156,5,1525,198,1723,2497,2021-01-23 00:04:26
2526,27,3,727,94,821,2498,2021-01-23 08:04:50
2527,534,1,149,19,168,2499,2021-01-22 16:39:10
2528,959,3,1047,136,1183,2500,2021-01-22 09:36:50
2529,924,3,647,84,731,2501,2021-01-22 13:18:06
2530,736,2,898,116,1014,2502,2021-01-22 14:24:37
2531,728,2,698,90,788,2503,2021-01-22 18:48:12
2532,393,2,1098,142,1240,2504,2021-01-23 06:45:32
2533,856,3,927,120,1047,2505,2021-01-22 20:21:24
2534,739,2,898,116,1014,2506,2021-01-22 17:51:03
2535,62,1,499,64,563,2507,2021-01-24 06:14:54
2536,917,3,697,90,787,2508,2021-01-23 22:11:34
2537,59,3,608,79,687,2509,2021-01-23 22:50:06
2538,493,3,797,103,900,2510,2021-01-24 04:35:45
2539,251,2,429,55,484,2511,2021-01-24 01:23:48
2540,308,6,1624,211,1835,2512,2021-01-24 08:47:48
2541,429,2,498,64,562,2513,2021-01-24 13:11:15
2542,617,3,1027,133,1160,2514,2021-01-24 11:11:07
2543,246,3,888,115,1003,2515,2021-01-23 22:52:39
2544,568,6,2094,272,2366,2516,2021-01-24 00:23:02
2545,386,4,977,127,1104,2517,2021-01-23 16:02:37
2546,804,4,837,108,945,2518,2021-01-23 12:08:47
2547,848,3,727,94,821,2519,2021-01-23 07:38:22
2548,848,3,727,94,821,2519,2021-01-23 07:38:22
2549,15,2,628,81,709,2520,2021-01-22 22:50:02
2550,363,2,548,71,619,2521,2021-01-23 05:08:08
2551,209,3,1327,172,1499,2522,2021-01-23 13:48:14
2552,565,3,658,85,743,2523,2021-01-23 08:18:25
2553,32,5,1925,250,2175,2524,2021-01-23 19:04:54
2554,27,5,1486,193,1679,2525,2021-01-23 09:55:21
2555,944,3,808,105,913,2526,2021-01-23 02:21:57
2556,847,2,598,77,675,2527,2021-01-23 01:03:20
2557,330,3,658,85,743,2528,2021-01-23 08:31:17
2558,574,1,399,51,450,2529,2021-01-22 19:23:59
2559,501,1,99,12,111,2530,2021-01-22 10:42:03
2560,831,3,947,123,1070,2531,2021-01-22 14:32:18
2561,900,1,599,77,676,2532,2021-01-22 16:54:00
2562,141,2,598,77,675,2533,2021-01-22 21:02:13
2563,53,5,1425,185,1610,2534,2021-01-23 08:33:50
2564,173,3,658,85,743,2535,2021-01-22 21:32:03
2565,857,2,459,59,518,2536,2021-01-22 20:24:33
2566,563,3,428,55,483,2537,2021-01-24 08:16:59
2567,274,2,1098,142,1240,2538,2021-01-23 22:20:55
2568,11,3,1197,155,1352,2539,2021-01-23 23:13:50
2569,455,3,608,79,687,2540,2021-01-24 05:27:54
2570,540,5,1695,220,1915,2541,2021-01-24 02:17:07
2571,420,3,697,90,787,2542,2021-01-24 10:09:51
2572,387,3,658,85,743,2543,2021-01-24 13:24:53
2573,239,3,947,123,1070,2544,2021-01-24 11:39:20
2574,798,3,1047,136,1183,2545,2021-01-23 23:09:24
2575,496,2,429,55,484,2546,2021-01-24 01:07:29
2576,495,3,697,90,787,2547,2021-01-23 18:28:10
2577,169,2,659,85,744,2548,2021-01-23 13:33:57
2578,498,1,99,12,111,2549,2021-01-23 09:12:30
2579,139,3,827,107,934,2550,2021-01-23 08:29:43
2580,122,3,747,97,844,2551,2021-01-23 01:08:58
2581,79,2,659,85,744,2552,2021-01-23 06:40:17
2582,307,3,597,77,674,2553,2021-01-23 15:05:38
2583,488,3,478,62,540,2554,2021-01-23 09:09:11
2584,930,3,997,129,1126,2555,2021-01-23 20:06:20
2585,940,1,499,64,563,2556,2021-01-23 11:43:53
2586,91,2,498,64,562,2557,2021-01-23 03:22:21
2587,697,3,1127,146,1273,2558,2021-01-23 03:03:57
2588,979,2,1098,142,1240,2559,2021-01-23 09:31:31
2589,190,2,598,77,675,2560,2021-01-22 21:23:54
2590,295,6,1246,161,1407,2561,2021-01-22 12:43:12
2591,773,3,608,79,687,2562,2021-01-22 14:54:22
2592,860,3,1047,136,1183,2563,2021-01-22 17:16:57
2593,821,3,1197,155,1352,2564,2021-01-22 21:46:45
2594,263,3,827,107,934,2565,2021-01-23 08:59:39
2595,560,3,1027,133,1160,2566,2021-01-22 22:48:41
2596,702,3,947,123,1070,2567,2021-01-22 22:42:01
2597,18,2,1098,142,1240,2568,2021-01-24 10:10:51
2598,143,2,898,116,1014,2569,2021-01-23 22:44:19
2599,430,1,699,90,789,2570,2021-01-23 23:32:55
2600,110,3,647,84,731,2571,2021-01-24 05:30:13
2601,585,3,597,77,674,2572,2021-01-24 03:39:08
2602,728,6,1644,213,1857,2573,2021-01-24 11:08:48
2603,149,2,898,116,1014,2574,2021-01-24 13:40:58
2604,970,3,1027,133,1160,2575,2021-01-24 13:03:53
2605,905,3,1247,162,1409,2576,2021-01-24 00:50:25
2606,991,3,1247,162,1409,2577,2021-01-24 03:21:49
2607,743,3,558,72,630,2578,2021-01-23 18:45:41
2608,402,3,688,89,777,2579,2021-01-23 16:11:55
2609,138,3,597,77,674,2580,2021-01-23 10:21:35
2610,638,5,1345,174,1519,2581,2021-01-23 09:57:26
2611,640,5,1306,169,1475,2582,2021-01-23 02:19:14
2612,388,2,628,81,709,2583,2021-01-23 08:13:48
2613,359,3,697,90,787,2584,2021-01-23 16:09:12
2614,189,5,1745,226,1971,2585,2021-01-23 10:22:59
2615,94,4,1396,181,1577,2586,2021-01-23 20:40:35
2616,982,3,747,97,844,2587,2021-01-23 13:22:52
2617,789,5,1376,178,1554,2588,2021-01-23 03:54:04
2618,817,2,659,85,744,2589,2021-01-23 03:26:57
2619,610,4,1596,207,1803,2590,2021-01-23 10:16:58
2620,865,3,1047,136,1183,2591,2021-01-22 23:23:27
2621,441,5,1986,258,2244,2592,2021-01-22 12:53:32
2622,945,3,558,72,630,2593,2021-01-22 17:19:45
2623,154,3,897,116,1013,2594,2021-01-22 19:44:35
2624,788,3,997,129,1126,2595,2021-01-23 00:27:37
2625,161,3,758,98,856,2596,2021-01-23 11:27:36
2626,155,2,1098,142,1240,2597,2021-01-22 23:11:24
2627,289,6,2124,276,2400,2598,2021-01-22 23:56:09
2628,525,3,1047,136,1183,2599,2021-01-24 10:19:29
2629,330,6,1344,174,1518,2600,2021-01-24 00:08:47
2630,373,4,1646,213,1859,2601,2021-01-24 00:42:04
2631,950,6,1355,176,1531,2602,2021-01-24 06:37:26
2632,893,3,597,77,674,2603,2021-01-24 04:46:18
2633,676,4,946,122,1068,2604,2021-01-24 11:12:29
2634,55,3,697,90,787,2605,2021-01-24 13:57:08
2635,959,3,997,129,1126,2606,2021-01-24 13:59:35
2636,745,3,747,97,844,2607,2021-01-24 03:20:08
2637,26,3,1127,146,1273,2608,2021-01-24 04:12:00
2638,248,3,947,123,1070,2609,2021-01-23 21:20:17
2639,157,3,647,84,731,2610,2021-01-23 18:43:38
2640,47,3,1027,133,1160,2611,2021-01-23 11:33:33
2641,131,2,798,103,901,2612,2021-01-23 12:40:56
2642,555,2,329,42,371,2613,2021-01-23 04:47:17
2643,86,2,429,55,484,2614,2021-01-23 10:55:02
2644,94,3,1127,146,1273,2615,2021-01-23 18:05:06
2645,361,3,578,75,653,2616,2021-01-23 11:28:08
2646,499,3,1247,162,1409,2617,2021-01-23 21:34:10
2647,284,2,898,116,1014,2618,2021-01-23 13:58:59
2648,924,2,698,90,788,2619,2021-01-23 05:18:52
2649,425,3,1127,146,1273,2620,2021-01-23 05:41:06
2650,648,2,598,77,675,2621,2021-01-23 12:47:31
2651,918,4,657,85,742,2622,2021-01-23 01:35:27
2652,44,2,548,71,619,2623,2021-01-22 13:51:15
2653,159,3,697,90,787,2624,2021-01-22 17:42:33
2654,938,3,558,72,630,2625,2021-01-22 20:18:09
2655,293,1,99,12,111,2626,2021-01-23 02:58:48
2656,4,6,1574,204,1778,2627,2021-01-23 11:27:50
2657,615,2,898,116,1014,2628,2021-01-23 00:44:13
2658,665,2,498,64,562,2629,2021-01-23 01:31:54
2659,604,2,798,103,901,2630,2021-01-24 12:00:29
2660,252,2,429,55,484,2631,2021-01-24 00:33:12
2661,82,3,478,62,540,2632,2021-01-24 02:34:54
2662,657,2,498,64,562,2633,2021-01-24 07:01:09
2663,277,3,597,77,674,2634,2021-01-24 05:35:41
2664,619,3,727,94,821,2635,2021-01-24 12:03:20
2665,552,3,997,129,1126,2636,2021-01-24 14:24:11
2666,121,6,1575,204,1779,2637,2021-01-24 16:14:44
2667,633,4,996,129,1125,2638,2021-01-24 06:06:44
2668,722,2,459,59,518,2639,2021-01-24 05:56:01
2669,923,3,1327,172,1499,2640,2021-01-24 00:00:09
2670,699,3,827,107,934,2641,2021-01-23 21:15:33
2671,896,3,608,79,687,2642,2021-01-23 12:56:23
2672,622,3,578,75,653,2643,2021-01-23 13:26:18
2673,341,3,808,105,913,2644,2021-01-23 07:18:56
2674,135,1,499,64,563,2645,2021-01-23 10:56:56
2675,874,3,888,115,1003,2646,2021-01-23 20:48:13
2676,6,3,608,79,687,2647,2021-01-23 13:05:36
2677,417,2,698,90,788,2648,2021-01-23 23:16:05
2678,416,3,997,129,1126,2649,2021-01-23 14:11:45
2679,324,3,528,68,596,2650,2021-01-23 06:19:41
2680,292,3,528,68,596,2651,2021-01-23 07:08:57
2681,100,2,398,51,449,2652,2021-01-23 14:33:21
2682,562,3,558,72,630,2653,2021-01-23 02:10:44
2683,695,2,798,103,901,2654,2021-01-22 14:43:41
2684,773,3,1327,172,1499,2655,2021-01-22 18:03:42
2685,579,2,898,116,1014,2656,2021-01-22 20:39:11
2686,527,1,299,38,337,2657,2021-01-23 04:43:34
2687,527,1,299,38,337,2657,2021-01-23 04:43:34
2688,991,3,658,85,743,2658,2021-01-23 12:37:35
2689,4,3,1127,146,1273,2659,2021-01-23 00:45:56
2690,464,3,1047,136,1183,2660,2021-01-23 02:31:35
2691,904,3,578,75,653,2661,2021-01-24 14:04:34
2692,972,3,747,97,844,2662,2021-01-24 03:07:38
2693,801,2,598,77,675,2663,2021-01-24 03:05:57
2694,808,3,528,68,596,2664,2021-01-24 07:03:04
2695,781,3,1127,146,1273,2665,2021-01-24 06:57:13
2696,613,3,1047,136,1183,2666,2021-01-24 14:25:27
2697,120,3,578,75,653,2667,2021-01-24 14:32:52
2698,615,2,628,81,709,2668,2021-01-24 17:37:17
2699,221,2,329,42,371,2669,2021-01-24 07:48:37
2700,28,3,847,110,957,2670,2021-01-24 05:57:20
2701,922,3,1127,146,1273,2671,2021-01-24 01:19:28
2702,167,3,647,84,731,2672,2021-01-23 21:37:03
2703,570,3,727,94,821,2673,2021-01-23 14:08:04
2704,322,2,698,90,788,2674,2021-01-23 14:34:43
2705,991,3,888,115,1003,2675,2021-01-23 09:19:09
2706,873,2,659,85,744,2676,2021-01-23 11:06:05
2707,121,2,928,120,1048,2677,2021-01-23 23:34:31
2708,19,2,498,64,562,2678,2021-01-23 13:25:17
2709,25,2,848,110,958,2679,2021-01-24 01:54:55
2710,394,2,598,77,675,2680,2021-01-23 15:48:08
2711,722,2,498,64,562,2681,2021-01-23 07:18:52
2712,989,2,898,116,1014,2682,2021-01-23 08:13:09
2713,803,4,1546,200,1746,2683,2021-01-23 16:20:11
2714,545,6,1205,156,1361,2684,2021-01-23 03:57:46
2715,187,3,827,107,934,2685,2021-01-22 15:19:21
2716,981,5,1156,150,1306,2686,2021-01-22 18:27:38
2717,326,2,898,116,1014,2687,2021-01-22 23:18:38
2718,483,1,499,64,563,2688,2021-01-23 05:45:00
2719,144,3,827,107,934,2689,2021-01-23 06:40:05
2720,485,3,1047,136,1183,2690,2021-01-23 14:27:00
2721,977,3,1327,172,1499,2691,2021-01-23 02:09:10
2722,187,3,947,123,1070,2692,2021-01-23 04:39:26
2723,408,3,697,90,787,2693,2021-01-24 15:45:13
2724,657,2,398,51,449,2694,2021-01-24 04:03:48
2725,919,3,1197,155,1352,2695,2021-01-24 04:42:12
2726,430,3,578,75,653,2696,2021-01-24 08:54:45
2727,455,3,1027,133,1160,2697,2021-01-24 06:58:54
2728,723,4,1946,252,2198,2698,2021-01-24 15:46:29
2729,834,3,1327,172,1499,2699,2021-01-24 16:24:30
2730,955,3,558,72,630,2700,2021-01-24 18:28:54
2731,254,5,1286,167,1453,2701,2021-01-24 09:46:04
2732,708,3,727,94,821,2702,2021-01-24 08:29:07
2733,561,6,1344,174,1518,2703,2021-01-24 03:32:50
2734,286,3,1027,133,1160,2704,2021-01-23 23:19:49
2735,99,2,659,85,744,2705,2021-01-23 14:36:00
2736,383,6,1275,165,1440,2706,2021-01-23 15:53:32
2737,301,2,598,77,675,2707,2021-01-23 10:52:42
2738,5,3,428,55,483,2708,2021-01-23 13:46:37
2739,897,2,1098,142,1240,2709,2021-01-23 23:36:06
2740,173,3,608,79,687,2710,2021-01-23 15:31:17
2741,270,5,1486,193,1679,2711,2021-01-24 03:39:41
2742,257,3,927,120,1047,2712,2021-01-23 18:19:31
2743,385,5,987,128,1115,2713,2021-01-23 09:09:37
2744,808,5,1825,237,2062,2714,2021-01-23 08:45:33
2745,323,3,647,84,731,2715,2021-01-23 17:55:28
2746,268,3,658,85,743,2716,2021-01-23 06:12:31
2747,46,2,459,59,518,2717,2021-01-22 16:53:26
2748,272,2,648,84,732,2718,2021-01-22 19:45:50
2749,78,3,1327,172,1499,2719,2021-01-23 00:40:05
2750,500,3,1027,133,1160,2720,2021-01-23 06:05:56
2751,580,3,558,72,630,2721,2021-01-23 06:48:03
2752,521,2,459,59,518,2722,2021-01-23 15:32:09
2753,45,3,808,105,913,2723,2021-01-23 02:34:57
2754,1,3,997,129,1126,2724,2021-01-23 05:12:11
2755,18,1,499,64,563,2725,2021-01-24 17:13:33
2756,920,3,727,94,821,2726,2021-01-24 05:33:43
2757,663,5,1675,217,1892,2727,2021-01-24 06:02:12
2758,783,3,847,110,957,2728,2021-01-24 10:29:02
2759,428,3,428,55,483,2729,2021-01-24 09:36:49
2760,32,3,827,107,934,2730,2021-01-24 16:58:21
2761,566,2,598,77,675,2731,2021-01-24 19:06:15
2762,107,1,399,51,450,2732,2021-01-24 19:49:45
2763,812,3,758,98,856,2733,2021-01-24 12:29:37
2764,40,2,898,116,1014,2734,2021-01-24 10:41:32
2765,365,1,299,38,337,2735,2021-01-24 04:58:21
2766,237,5,1406,182,1588,2736,2021-01-23 23:23:04
2767,2,3,1047,136,1183,2737,2021-01-23 15:14:42
2768,845,2,429,55,484,2738,2021-01-23 17:06:40
2769,200,4,1346,174,1520,2739,2021-01-23 11:59:48
2770,627,6,1574,204,1778,2740,2021-01-23 14:42:02
2771,265,3,997,129,1126,2741,2021-01-23 23:52:45
2772,722,3,647,84,731,2742,2021-01-23 17:29:05
2773,167,4,1246,161,1407,2743,2021-01-24 05:57:49
2774,277,3,528,68,596,2744,2021-01-23 19:32:06
2775,94,2,429,55,484,2745,2021-01-23 11:03:16
2776,421,3,1047,136,1183,2746,2021-01-23 11:30:18
2777,950,2,429,55,484,2747,2021-01-23 20:27:14
2778,136,2,698,90,788,2748,2021-01-23 06:22:00
2779,247,2,498,64,562,2749,2021-01-22 17:54:53
2780,763,2,659,85,744,2750,2021-01-22 22:04:59
2781,89,2,498,64,562,2751,2021-01-23 01:06:16
2782,786,2,898,116,1014,2752,2021-01-23 07:19:16
2783,155,3,658,85,743,2753,2021-01-23 08:26:04
2784,58,3,578,75,653,2754,2021-01-23 16:56:52
2785,167,3,647,84,731,2755,2021-01-23 03:07:50
2786,758,2,898,116,1014,2756,2021-01-23 05:40:53
2787,668,2,598,77,675,2757,2021-01-24 17:53:58
2788,580,2,898,116,1014,2758,2021-01-24 05:51:17
2789,9,2,429,55,484,2759,2021-01-24 08:39:25
2790,174,3,927,120,1047,2760,2021-01-24 11:34:37
2791,174,3,927,120,1047,2760,2021-01-24 11:34:37
2792,567,3,658,85,743,2761,2021-01-24 10:15:26
2793,954,3,997,129,1126,2762,2021-01-24 18:01:33
2794,789,3,997,129,1126,2763,2021-01-24 21:24:38
2795,429,2,898,116,1014,2764,2021-01-24 22:32:31
2796,746,5,1495,194,1689,2765,2021-01-24 13:18:57
2797,841,6,1355,176,1531,2766,2021-01-24 13:17:07
2798,71,2,798,103,901,2767,2021-01-24 05:43:16
2799,172,5,1145,148,1293,2768,2021-01-24 01:22:37
2800,274,3,558,72,630,2769,2021-01-23 15:37:57
2801,872,3,428,55,483,2770,2021-01-23 17:31:48
2802,307,3,528,68,596,2771,2021-01-23 14:05:57
2803,82,2,898,116,1014,2772,2021-01-23 16:11:12
2804,528,2,898,116,1014,2773,2021-01-24 01:44:25
2805,739,3,947,123,1070,2774,2021-01-23 19:40:32
2806,564,3,647,84,731,2775,2021-01-24 08:22:08
2807,673,2,628,81,709,2776,2021-01-23 20:24:25
2808,919,3,747,97,844,2777,2021-01-23 12:07:45
2809,414,5,2145,278,2423,2778,2021-01-23 12:18:40
2810,948,3,608,79,687,2779,2021-01-23 20:57:48
2811,468,1,599,77,676,2780,2021-01-23 07:33:20
2812,27,4,577,75,652,2781,2021-01-22 18:22:34
2813,514,2,898,116,1014,2782,2021-01-23 00:05:13
2814,811,3,1127,146,1273,2783,2021-01-23 02:07:33
2815,334,2,928,120,1048,2784,2021-01-23 08:46:33
2816,518,3,658,85,743,2785,2021-01-23 10:00:27
2817,674,3,797,103,900,2786,2021-01-23 17:24:42
2818,909,3,847,110,957,2787,2021-01-23 04:51:34
2819,107,3,927,120,1047,2788,2021-01-23 05:58:25
2820,247,3,827,107,934,2789,2021-01-24 20:27:27
2821,250,2,548,71,619,2790,2021-01-24 07:18:25
2822,830,3,428,55,483,2791,2021-01-24 08:57:54
2823,952,3,997,129,1126,2792,2021-01-24 13:33:38
2824,952,3,997,129,1126,2792,2021-01-24 13:33:38
2825,45,3,827,107,934,2793,2021-01-24 13:20:05
2826,119,3,688,89,777,2794,2021-01-24 11:04:32
2827,214,1,229,29,258,2795,2021-01-24 19:50:13
2828,284,2,748,97,845,2796,2021-01-24 21:42:04
2829,558,3,727,94,821,2797,2021-01-24 23:58:08
2830,404,2,898,116,1014,2798,2021-01-24 14:17:49
2831,208,2,329,42,371,2799,2021-01-24 15:58:35
2832,401,2,798,103,901,2800,2021-01-24 06:17:28
2833,424,4,1346,174,1520,2801,2021-01-24 02:21:56
2834,622,3,747,97,844,2802,2021-01-23 17:30:45
2835,388,3,1327,172,1499,2803,2021-01-23 18:29:19
2836,981,3,747,97,844,2804,2021-01-23 16:35:16
2837,611,3,558,72,630,2805,2021-01-23 17:36:39
2838,296,3,1047,136,1183,2806,2021-01-24 02:32:13
2839,506,3,747,97,844,2807,2021-01-23 21:51:23
2840,499,2,848,110,958,2808,2021-01-24 08:43:05
2841,979,3,697,90,787,2809,2021-01-23 21:08:00
2842,147,5,1656,215,1871,2810,2021-01-23 14:37:20
2843,330,3,758,98,856,2811,2021-01-23 12:24:39
2844,286,3,647,84,731,2812,2021-01-23 21:56:29
2845,318,5,1745,226,1971,2813,2021-01-23 07:38:30
2846,545,3,647,84,731,2814,2021-01-22 20:43:56
2847,944,1,399,51,450,2815,2021-01-23 02:27:58
2848,313,2,1098,142,1240,2816,2021-01-23 03:01:41
2849,40,1,229,29,258,2817,2021-01-23 09:06:42
2850,120,2,548,71,619,2818,2021-01-23 12:14:28
2851,584,4,1346,174,1520,2819,2021-01-23 17:59:54
2852,336,3,1047,136,1183,2820,2021-01-23 05:21:20
2853,306,3,647,84,731,2821,2021-01-23 08:03:40
2854,529,6,2254,293,2547,2822,2021-01-24 21:02:48
2855,327,3,997,129,1126,2823,2021-01-24 07:58:32
2856,558,2,1098,142,1240,2824,2021-01-24 10:05:51
2857,45,4,1396,181,1577,2825,2021-01-24 14:44:42
2858,218,2,498,64,562,2826,2021-01-24 15:55:53
2859,520,6,1475,191,1666,2827,2021-01-24 14:24:04
2860,359,3,747,97,844,2828,2021-01-24 11:21:19
2861,884,5,1945,252,2197,2829,2021-01-24 21:31:34
2862,161,3,697,90,787,2830,2021-01-24 22:39:37
2863,88,3,608,79,687,2831,2021-01-25 00:42:03
2864,499,3,528,68,596,2832,2021-01-24 16:31:09
2865,851,3,927,120,1047,2833,2021-01-24 17:26:37
2866,909,3,1247,162,1409,2834,2021-01-24 06:21:46
2867,661,2,848,110,958,2835,2021-01-24 02:31:10
2868,608,2,659,85,744,2836,2021-01-23 19:47:29
2869,97,1,229,29,258,2837,2021-01-23 18:46:59
2870,654,2,598,77,675,2838,2021-01-23 17:17:25
2871,176,3,697,90,787,2839,2021-01-23 19:06:10
2872,856,3,1027,133,1160,2840,2021-01-24 04:24:14
2873,527,2,1098,142,1240,2841,2021-01-23 23:35:05
2874,193,6,1824,237,2061,2842,2021-01-24 09:35:29
2875,280,5,1595,207,1802,2843,2021-01-23 21:52:55
2876,690,3,1197,155,1352,2844,2021-01-23 16:22:05
2877,48,2,498,64,562,2845,2021-01-23 14:49:39
2878,621,6,2244,291,2535,2846,2021-01-23 22:04:17
2879,561,3,847,110,957,2847,2021-01-23 09:06:08
2880,965,3,797,103,900,2848,2021-01-22 22:10:06
2881,788,3,747,97,844,2849,2021-01-23 05:10:34
2882,598,6,1954,254,2208,2850,2021-01-23 03:02:11
2883,834,2,728,94,822,2851,2021-01-23 09:40:45
2884,244,3,478,62,540,2852,2021-01-23 14:06:20
2885,824,5,1545,200,1745,2853,2021-01-23 19:12:52
2886,948,2,329,42,371,2854,2021-01-23 06:47:46
2887,118,3,578,75,653,2855,2021-01-23 10:27:37
2888,597,2,329,42,371,2856,2021-01-24 22:01:03
2889,967,2,798,103,901,2857,2021-01-24 08:54:05
2890,998,2,459,59,518,2858,2021-01-24 11:14:54
2891,329,3,428,55,483,2859,2021-01-24 16:32:49
2892,869,2,598,77,675,2860,2021-01-24 16:29:21
2893,250,3,808,105,913,2861,2021-01-24 16:53:05
2894,130,3,888,115,1003,2862,2021-01-24 12:31:49
2895,699,3,997,129,1126,2863,2021-01-24 23:29:12
2896,189,6,1535,199,1734,2864,2021-01-25 00:34:05
2897,173,3,827,107,934,2865,2021-01-25 01:25:13
2898,333,3,888,115,1003,2866,2021-01-24 17:50:16
2899,437,3,808,105,913,2867,2021-01-24 19:57:18
2900,46,6,1744,226,1970,2868,2021-01-24 08:30:58
2901,459,2,798,103,901,2869,2021-01-24 04:17:27
2902,175,3,528,68,596,2870,2021-01-23 22:14:52
2903,689,3,658,85,743,2871,2021-01-23 20:38:53
2904,182,3,597,77,674,2872,2021-01-23 19:56:53
2905,273,3,647,84,731,2873,2021-01-23 19:32:26
2906,92,3,1127,146,1273,2874,2021-01-24 07:06:31
2907,444,2,748,97,845,2875,2021-01-24 01:22:05
2908,919,3,558,72,630,2876,2021-01-24 12:09:54
2909,965,3,997,129,1126,2877,2021-01-24 00:03:04
2910,778,2,898,116,1014,2878,2021-01-23 18:46:43
2911,257,2,898,116,1014,2879,2021-01-23 17:00:49
2912,859,2,628,81,709,2880,2021-01-24 00:14:59
2913,177,3,1127,146,1273,2881,2021-01-23 09:47:16
2914,224,4,1256,163,1419,2882,2021-01-22 23:39:30
2915,558,3,697,90,787,2883,2021-01-23 05:50:28
2916,729,3,528,68,596,2884,2021-01-23 03:09:49
2917,285,4,1307,169,1476,2885,2021-01-23 12:26:39
2918,889,3,1327,172,1499,2886,2021-01-23 15:45:02
2919,230,6,1225,159,1384,2887,2021-01-23 19:45:01
2920,785,3,758,98,856,2888,2021-01-23 08:53:50
2921,32,2,628,81,709,2889,2021-01-23 12:35:35
2922,46,2,598,77,675,2890,2021-01-25 00:02:10
2923,142,3,608,79,687,2891,2021-01-24 10:29:36
2924,384,2,698,90,788,2892,2021-01-24 12:16:14
2925,674,3,997,129,1126,2893,2021-01-24 18:37:13
2926,630,6,1935,251,2186,2894,2021-01-24 17:21:49
2927,728,2,429,55,484,2895,2021-01-24 18:54:25
2928,999,3,827,107,934,2896,2021-01-24 14:44:54
2929,380,3,827,107,934,2897,2021-01-24 23:29:48
2930,286,3,658,85,743,2898,2021-01-25 03:14:24
2931,373,3,1047,136,1183,2899,2021-01-25 02:02:06
2932,219,3,1027,133,1160,2900,2021-01-24 20:27:45
2933,129,3,997,129,1126,2901,2021-01-24 22:04:14
2934,821,3,1047,136,1183,2902,2021-01-24 10:57:34
2935,752,1,699,90,789,2903,2021-01-24 05:50:25
2936,433,2,329,42,371,2904,2021-01-23 22:23:50
2937,285,5,1376,178,1554,2905,2021-01-23 21:56:59
2938,395,2,698,90,788,2906,2021-01-23 22:20:03
2939,271,3,758,98,856,2907,2021-01-23 22:09:56
2940,816,2,698,90,788,2908,2021-01-24 08:13:11
2941,137,1,599,77,676,2909,2021-01-24 03:30:09
2942,935,3,727,94,821,2910,2021-01-24 12:27:16
2943,991,2,898,116,1014,2911,2021-01-24 02:41:22
2944,488,1,399,51,450,2912,2021-01-23 21:04:40
2945,891,3,608,79,687,2913,2021-01-23 18:45:06
2946,642,3,827,107,934,2914,2021-01-24 02:54:21
2947,912,3,647,84,731,2915,2021-01-23 12:13:59
2948,591,3,1197,155,1352,2916,2021-01-23 01:02:12
2949,57,3,888,115,1003,2917,2021-01-23 06:35:34
2950,57,3,888,115,1003,2917,2021-01-23 06:35:34
2951,246,3,1327,172,1499,2918,2021-01-23 05:02:04
2952,689,2,798,103,901,2919,2021-01-23 13:52:25
2953,322,3,1247,162,1409,2920,2021-01-23 17:24:54
2954,899,5,1845,239,2084,2921,2021-01-23 22:04:34
2955,729,1,229,29,258,2922,2021-01-23 09:00:36
2956,973,3,897,116,1013,2923,2021-01-23 14:49:30
2957,830,5,1256,163,1419,2924,2021-01-25 01:11:33
2958,413,1,229,29,258,2925,2021-01-24 11:09:06
2959,564,3,888,115,1003,2926,2021-01-24 13:33:02
2960,560,3,578,75,653,2927,2021-01-24 18:44:40
2961,715,2,898,116,1014,2928,2021-01-24 19:43:14
2962,573,3,847,110,957,2929,2021-01-24 19:04:06
2963,738,3,1327,172,1499,2930,2021-01-24 15:27:04
2964,326,3,1047,136,1183,2931,2021-01-24 23:33:57
2965,569,3,528,68,596,2932,2021-01-25 04:41:09
2966,522,3,947,123,1070,2933,2021-01-25 03:11:05
2967,656,3,727,94,821,2934,2021-01-24 21:44:03
2968,729,2,598,77,675,2935,2021-01-25 00:29:41
2969,415,5,1195,155,1350,2936,2021-01-24 13:12:57
2970,617,3,1027,133,1160,2937,2021-01-24 07:41:11
2971,39,3,528,68,596,2938,2021-01-23 23:27:03
2972,282,2,898,116,1014,2939,2021-01-24 00:40:36
2973,155,2,498,64,562,2940,2021-01-23 23:47:36
2974,795,3,1027,133,1160,2941,2021-01-24 00:27:17
2975,206,3,688,89,777,2942,2021-01-24 09:06:24
2976,59,3,927,120,1047,2943,2021-01-24 04:11:57
2977,18,6,1525,198,1723,2944,2021-01-24 13:44:29
2978,232,3,697,90,787,2945,2021-01-24 03:23:36
2979,905,3,847,110,957,2946,2021-01-23 22:13:13
2980,559,3,428,55,483,2947,2021-01-23 20:15:27
2981,630,2,898,116,1014,2948,2021-01-24 04:39:22
2982,259,3,1127,146,1273,2949,2021-01-23 13:29:51
2983,944,3,697,90,787,2950,2021-01-23 02:02:05
2984,366,2,898,116,1014,2951,2021-01-23 06:55:54
2985,789,5,1725,224,1949,2952,2021-01-23 07:46:03
2986,22,5,1575,204,1779,2953,2021-01-23 06:29:26
2987,803,5,1626,211,1837,2954,2021-01-23 14:26:53
2988,624,2,448,58,506,2955,2021-01-23 19:03:48
2989,761,3,1047,136,1183,2956,2021-01-23 23:57:55
2990,830,3,808,105,913,2957,2021-01-23 10:54:49
2991,418,3,927,120,1047,2958,2021-01-23 17:28:07
2992,829,2,548,71,619,2959,2021-01-25 02:24:38
2993,789,2,898,116,1014,2960,2021-01-24 11:59:17
2994,477,3,1127,146,1273,2961,2021-01-24 15:31:00
2995,33,1,499,64,563,2962,2021-01-24 19:01:34
2996,977,2,798,103,901,2963,2021-01-24 21:42:27
2997,538,3,808,105,913,2964,2021-01-24 21:18:28
2998,208,2,1098,142,1240,2965,2021-01-24 15:43:20
2999,383,3,927,120,1047,2966,2021-01-25 00:55:33
3000,834,2,598,77,675,2967,2021-01-25 05:34:57
3001,885,3,658,85,743,2968,2021-01-25 04:36:52
3002,622,2,628,81,709,2969,2021-01-24 21:44:32
3003,196,3,647,84,731,2970,2021-01-25 00:56:27
3004,177,4,1596,207,1803,2971,2021-01-24 15:02:57
3005,856,3,797,103,900,2972,2021-01-24 08:23:42
3006,961,2,848,110,958,2973,2021-01-24 02:12:00
3007,630,3,888,115,1003,2974,2021-01-24 01:34:32
3008,796,2,898,116,1014,2975,2021-01-24 00:05:08
3009,277,5,1556,202,1758,2976,2021-01-24 01:01:20
3010,745,2,459,59,518,2977,2021-01-24 09:13:48
3011,895,2,698,90,788,2978,2021-01-24 04:24:37
3012,675,3,558,72,630,2979,2021-01-24 14:08:07
3013,165,2,698,90,788,2980,2021-01-24 04:13:15
3014,411,3,558,72,630,2981,2021-01-23 23:59:55
3015,363,6,2074,269,2343,2982,2021-01-23 22:20:35
3016,313,3,827,107,934,2983,2021-01-24 06:30:11
3017,90,5,1456,189,1645,2984,2021-01-23 15:21:50
3018,90,3,647,84,731,2985,2021-01-23 02:32:41
3019,246,2,498,64,562,2986,2021-01-23 08:02:43
3020,948,2,498,64,562,2987,2021-01-23 08:42:26
3021,606,2,798,103,901,2988,2021-01-23 08:34:24
3022,7,3,558,72,630,2989,2021-01-23 14:29:39
3023,710,2,1098,142,1240,2990,2021-01-23 20:32:42
3024,634,2,598,77,675,2991,2021-01-24 01:30:34
3025,511,3,808,105,913,2992,2021-01-23 12:46:25
3026,357,3,1327,172,1499,2993,2021-01-23 18:31:22
3027,883,2,329,42,371,2994,2021-01-25 04:50:24
3028,249,3,478,62,540,2995,2021-01-24 14:42:33
3029,580,3,827,107,934,2996,2021-01-24 17:26:57
3030,271,3,1047,136,1183,2997,2021-01-24 21:24:51
3031,799,3,658,85,743,2998,2021-01-25 00:07:24
3032,660,3,997,129,1126,2999,2021-01-25 00:03:19
3033,475,2,329,42,371,3000,2021-01-24 17:04:50
3034,504,3,1127,146,1273,3001,2021-01-25 01:02:35
3035,693,3,797,103,900,3002,2021-01-25 08:13:31
3036,858,2,898,116,1014,3003,2021-01-25 06:22:29
3037,792,3,758,98,856,3004,2021-01-24 23:22:29
3038,967,6,1624,211,1835,3005,2021-01-25 02:44:30
3039,428,4,1496,194,1690,3006,2021-01-24 16:24:37
3040,970,3,747,97,844,3007,2021-01-24 10:52:25
3041,640,1,599,77,676,3008,2021-01-24 03:54:09
3042,413,4,1446,187,1633,3009,2021-01-24 01:35:19
3043,667,3,647,84,731,3010,2021-01-24 00:29:30
3044,317,3,827,107,934,3011,2021-01-24 02:04:41
3045,98,2,898,116,1014,3012,2021-01-24 09:43:56
3046,464,2,528,68,596,3013,2021-01-24 06:19:21
3047,2,2,898,116,1014,3014,2021-01-24 15:52:22
3048,93,2,598,77,675,3015,2021-01-24 05:01:56
3049,940,4,1446,187,1633,3016,2021-01-24 02:05:53
3050,598,1,399,51,450,3017,2021-01-23 22:35:09
3051,163,4,896,116,1012,3018,2021-01-24 07:55:29
3052,729,2,798,103,901,3019,2021-01-23 16:59:39
3053,235,2,498,64,562,3020,2021-01-23 02:45:06
3054,267,2,828,107,935,3021,2021-01-23 09:56:01
3055,545,3,727,94,821,3022,2021-01-23 10:58:04
3056,35,3,808,105,913,3023,2021-01-23 11:01:11
3057,473,2,459,59,518,3024,2021-01-23 16:27:08
3058,150,3,658,85,743,3025,2021-01-23 22:17:43
3059,781,2,928,120,1048,3026,2021-01-24 03:35:51
3060,821,3,847,110,957,3027,2021-01-23 14:05:43
3061,982,2,698,90,788,3028,2021-01-23 20:45:26
3062,953,2,898,116,1014,3029,2021-01-25 05:59:38
3063,617,2,898,116,1014,3030,2021-01-24 16:33:28
3064,390,1,499,64,563,3031,2021-01-24 18:37:13
3065,846,3,1127,146,1273,3032,2021-01-24 22:19:36
3066,381,1,99,12,111,3033,2021-01-25 00:52:06
3067,265,5,1286,167,1453,3034,2021-01-25 00:55:37
3068,520,3,428,55,483,3035,2021-01-24 19:18:59
3069,338,3,888,115,1003,3036,2021-01-25 03:21:40
3070,29,2,329,42,371,3037,2021-01-25 10:23:48
3071,878,2,429,55,484,3038,2021-01-25 08:10:56
3072,609,3,697,90,787,3039,2021-01-24 23:31:41
3073,51,2,429,55,484,3040,2021-01-25 03:55:47
3074,801,3,1127,146,1273,3041,2021-01-24 17:13:57
3075,805,3,1247,162,1409,3042,2021-01-24 13:16:12
3076,867,3,827,107,934,3043,2021-01-24 05:09:34
3077,239,1,299,38,337,3044,2021-01-24 03:59:08
3078,21,2,898,116,1014,3045,2021-01-24 02:52:30
3079,30,3,528,68,596,3046,2021-01-24 04:45:06
3080,536,2,659,85,744,3047,2021-01-24 11:23:03
3081,543,4,1177,153,1330,3048,2021-01-24 08:45:34
3082,732,3,747,97,844,3049,2021-01-24 15:54:15
3083,472,2,659,85,744,3050,2021-01-24 07:09:03
3084,62,3,997,129,1126,3051,2021-01-24 04:27:01
3085,787,2,698,90,788,3052,2021-01-23 22:58:16
3086,692,3,697,90,787,3053,2021-01-24 10:04:52
3087,243,3,658,85,743,3054,2021-01-23 19:05:22
3088,317,2,898,116,1014,3055,2021-01-23 05:31:13
3089,646,2,398,51,449,3056,2021-01-23 10:17:42
3090,366,2,1098,142,1240,3057,2021-01-23 13:00:26
3091,280,3,597,77,674,3058,2021-01-23 11:20:33
3092,488,3,1047,136,1183,3059,2021-01-23 19:03:45
3093,488,2,598,77,675,3060,2021-01-23 23:07:56
3094,992,3,688,89,777,3061,2021-01-24 05:12:05
3095,94,2,928,120,1048,3062,2021-01-23 14:53:03
3096,877,2,898,116,1014,3063,2021-01-23 21:08:45
3097,121,3,1127,146,1273,3064,2021-01-25 07:06:52
3098,684,3,897,116,1013,3065,2021-01-24 17:53:32
3099,876,1,399,51,450,3066,2021-01-24 19:21:05
3100,224,5,1745,226,1971,3067,2021-01-24 23:47:03
3101,218,3,697,90,787,3068,2021-01-25 02:43:33
3102,849,6,1544,200,1744,3069,2021-01-25 01:51:38
3103,868,3,1027,133,1160,3070,2021-01-24 20:42:36
3104,276,5,1406,182,1588,3071,2021-01-25 04:43:45
3105,960,3,1247,162,1409,3072,2021-01-25 10:46:27
3106,612,3,1027,133,1160,3073,2021-01-25 09:46:58
3107,906,3,797,103,900,3074,2021-01-25 02:05:47
3108,452,3,1127,146,1273,3075,2021-01-25 04:51:11
3109,648,2,1098,142,1240,3076,2021-01-24 19:18:48
3110,441,3,658,85,743,3077,2021-01-24 14:31:51
3111,492,3,658,85,743,3078,2021-01-24 06:16:39
3112,755,2,898,116,1014,3079,2021-01-24 05:25:31
3113,549,2,598,77,675,3080,2021-01-24 05:22:42
3114,770,3,558,72,630,3081,2021-01-24 05:59:44
3115,462,1,149,19,168,3082,2021-01-24 12:03:39
3116,586,2,598,77,675,3083,2021-01-24 09:12:00
3117,725,2,598,77,675,3084,2021-01-24 16:44:40
3118,874,3,608,79,687,3085,2021-01-24 08:54:58
3119,691,2,1098,142,1240,3086,2021-01-24 04:40:13
3120,527,3,927,120,1047,3087,2021-01-24 00:34:30
3121,959,2,329,42,371,3088,2021-01-24 12:11:21
3122,120,3,697,90,787,3089,2021-01-23 19:06:45
3123,244,3,647,84,731,3090,2021-01-23 08:17:37
3124,451,3,608,79,687,3091,2021-01-23 11:36:02
3125,187,2,659,85,744,3092,2021-01-23 15:41:32
3126,375,3,897,116,1013,3093,2021-01-23 11:46:05
3127,849,3,747,97,844,3094,2021-01-23 20:56:02
3128,926,3,658,85,743,3095,2021-01-24 01:04:14
3129,667,2,329,42,371,3096,2021-01-24 06:48:29
3130,472,2,398,51,449,3097,2021-01-23 16:45:00
3131,472,2,398,51,449,3097,2021-01-23 16:45:00
3132,409,5,1406,182,1588,3098,2021-01-23 22:16:17
3133,840,5,1356,176,1532,3099,2021-01-25 07:13:39
3134,711,3,428,55,483,3100,2021-01-24 18:21:31
3135,352,3,1097,142,1239,3101,2021-01-24 20:48:54
3136,222,2,659,85,744,3102,2021-01-25 02:24:38
3137,204,3,558,72,630,3103,2021-01-25 03:52:01
3138,693,3,758,98,856,3104,2021-01-25 02:31:19
3139,240,4,1426,185,1611,3105,2021-01-24 22:46:02
3140,184,3,1327,172,1499,3106,2021-01-25 07:21:52
3141,519,2,898,116,1014,3107,2021-01-25 13:18:36
3142,315,2,628,81,709,3108,2021-01-25 11:00:24
3143,380,3,1047,136,1183,3109,2021-01-25 02:39:17
3144,634,3,658,85,743,3110,2021-01-25 07:23:36
3145,289,5,1425,185,1610,3111,2021-01-24 20:39:06
3146,515,3,897,116,1013,3112,2021-01-24 14:47:17
3147,214,3,747,97,844,3113,2021-01-24 07:18:53
3148,492,3,558,72,630,3114,2021-01-24 06:04:19
3149,100,2,598,77,675,3115,2021-01-24 07:42:32
3150,567,3,1197,155,1352,3116,2021-01-24 06:48:32
3151,759,3,897,116,1013,3117,2021-01-24 12:04:22
3152,797,2,448,58,506,3118,2021-01-24 09:58:50
3153,125,3,897,116,1013,3119,2021-01-24 16:47:39
3154,885,3,747,97,844,3120,2021-01-24 11:35:33
3155,148,3,997,129,1126,3121,2021-01-24 07:17:43
3156,800,3,647,84,731,3122,2021-01-24 02:15:41
3157,503,3,558,72,630,3123,2021-01-24 14:17:26
3158,574,3,997,129,1126,3124,2021-01-23 21:03:47
3159,43,2,598,77,675,3125,2021-01-23 08:26:19
3160,86,5,1556,202,1758,3126,2021-01-23 13:43:12
3161,564,1,229,29,258,3127,2021-01-23 18:14:49
3162,234,3,597,77,674,3128,2021-01-23 14:10:39
3163,354,3,688,89,777,3129,2021-01-23 21:17:33
3164,144,3,888,115,1003,3130,2021-01-24 01:35:24
3165,120,3,658,85,743,3131,2021-01-24 09:17:42
3166,896,3,847,110,957,3132,2021-01-23 17:23:33
3167,117,6,2015,261,2276,3133,2021-01-23 19:01:46
3168,264,2,459,59,518,3134,2021-01-23 22:54:23
3169,422,3,697,90,787,3135,2021-01-25 09:21:40
3170,567,3,808,105,913,3136,2021-01-24 19:11:40
3171,912,3,808,105,913,3137,2021-01-24 23:34:09
3172,656,3,747,97,844,3138,2021-01-25 03:25:22
3173,506,4,1196,155,1351,3139,2021-01-25 05:58:35
3174,114,2,698,90,788,3140,2021-01-25 04:25:37
3175,972,3,927,120,1047,3141,2021-01-25 01:08:43
3176,298,2,898,116,1014,3142,2021-01-25 08:39:02
3177,914,2,898,116,1014,3143,2021-01-25 15:00:50
3178,61,3,997,129,1126,3144,2021-01-25 13:21:51
3179,645,6,1594,207,1801,3145,2021-01-25 03:05:52
3180,899,5,1406,182,1588,3146,2021-01-25 08:28:26
3181,645,1,599,77,676,3147,2021-01-24 22:37:10
3182,5,2,798,103,901,3148,2021-01-24 16:46:03
3183,245,3,578,75,653,3149,2021-01-24 08:51:48
3184,515,2,329,42,371,3150,2021-01-24 07:56:05
3185,843,4,1246,161,1407,3151,2021-01-24 09:59:02
3186,267,3,1327,172,1499,3152,2021-01-24 07:34:18
3187,841,2,598,77,675,3153,2021-01-24 14:16:14
3188,970,3,997,129,1126,3154,2021-01-24 12:26:15
3189,970,3,597,77,674,3155,2021-01-24 17:43:20
3190,428,3,827,107,934,3156,2021-01-24 12:41:29
3191,734,3,647,84,731,3157,2021-01-24 08:21:29
3192,17,3,608,79,687,3158,2021-01-24 02:55:47
3193,186,2,698,90,788,3159,2021-01-24 16:58:59
3194,414,2,898,116,1014,3160,2021-01-23 22:43:46
3195,833,3,727,94,821,3161,2021-01-23 10:46:40
3196,665,3,947,123,1070,3162,2021-01-23 16:21:50
3197,303,3,758,98,856,3163,2021-01-23 18:42:34
3198,152,3,1027,133,1160,3164,2021-01-23 16:20:11
3199,740,2,848,110,958,3165,2021-01-23 21:26:39
3200,999,2,848,110,958,3166,2021-01-24 02:48:04
3201,272,2,898,116,1014,3167,2021-01-24 10:21:24
3202,559,2,498,64,562,3168,2021-01-23 19:31:57
3203,872,4,1096,142,1238,3169,2021-01-23 21:16:38
3204,941,2,498,64,562,3170,2021-01-24 00:30:56
3205,512,5,1276,165,1441,3171,2021-01-25 10:31:55
3206,966,3,478,62,540,3172,2021-01-24 19:28:11
3207,66,3,1197,155,1352,3173,2021-01-25 01:02:20
3208,148,5,1745,226,1971,3174,2021-01-25 03:37:09
3209,533,3,847,110,957,3175,2021-01-25 06:46:34
3210,417,4,1496,194,1690,3176,2021-01-25 05:50:57
3211,178,4,1796,233,2029,3177,2021-01-25 02:25:04
3212,827,2,798,103,901,3178,2021-01-25 09:45:35
3213,833,1,99,12,111,3179,2021-01-25 17:35:08
3214,449,3,927,120,1047,3180,2021-01-25 13:38:44
3215,310,3,478,62,540,3181,2021-01-25 03:29:11
3216,747,2,728,94,822,3182,2021-01-25 09:20:55
3217,191,5,1345,174,1519,3183,2021-01-25 00:58:53
3218,65,3,608,79,687,3184,2021-01-24 18:24:29
3219,362,3,808,105,913,3185,2021-01-24 09:17:51
3220,131,3,558,72,630,3186,2021-01-24 09:19:10
3221,410,3,528,68,596,3187,2021-01-24 12:45:01
3222,242,3,927,120,1047,3188,2021-01-24 07:51:00
3223,575,3,558,72,630,3189,2021-01-24 15:11:37
3224,575,3,558,72,630,3189,2021-01-24 15:11:37
3225,472,6,1924,250,2174,3190,2021-01-24 13:32:29
3226,207,5,1955,254,2209,3191,2021-01-24 18:26:58
3227,8,5,1725,224,1949,3192,2021-01-24 15:09:04
3228,162,2,598,77,675,3193,2021-01-24 10:58:20
3229,690,3,827,107,934,3194,2021-01-24 05:37:58
3230,655,3,558,72,630,3195,2021-01-24 17:17:21
3231,251,5,1275,165,1440,3196,2021-01-23 23:13:58
3232,572,6,2324,302,2626,3197,2021-01-23 11:38:50
3233,319,3,608,79,687,3198,2021-01-23 18:18:24
3234,959,3,608,79,687,3199,2021-01-23 19:23:26
3235,575,3,688,89,777,3200,2021-01-23 16:22:22
3236,925,3,827,107,934,3201,2021-01-23 21:57:44
3237,427,2,698,90,788,3202,2021-01-24 04:07:17
3238,400,3,1047,136,1183,3203,2021-01-24 12:17:24
3239,739,3,747,97,844,3204,2021-01-23 20:20:32
3240,404,6,1605,208,1813,3205,2021-01-23 21:23:14
3241,319,2,898,116,1014,3206,2021-01-24 02:08:52
3242,156,2,698,90,788,3207,2021-01-25 11:01:47
3243,552,3,688,89,777,3208,2021-01-24 21:50:14
3244,533,6,1424,185,1609,3209,2021-01-25 02:04:22
3245,935,2,898,116,1014,3210,2021-01-25 03:50:53
3246,995,3,947,123,1070,3211,2021-01-25 08:15:53
3247,281,3,1197,155,1352,3212,2021-01-25 05:51:06
3248,35,2,659,85,744,3213,2021-01-25 04:27:01
3249,305,4,1127,146,1273,3214,2021-01-25 12:29:20
3250,799,3,808,105,913,3215,2021-01-25 17:43:39
3251,861,3,658,85,743,3216,2021-01-25 15:12:33
3252,595,3,578,75,653,3217,2021-01-25 04:12:32
3253,201,3,428,55,483,3218,2021-01-25 11:57:08
3254,917,2,598,77,675,3219,2021-01-25 02:43:48
3255,230,2,1098,142,1240,3220,2021-01-24 20:52:36
3256,341,3,1047,136,1183,3221,2021-01-24 10:58:01
3257,833,2,459,59,518,3222,2021-01-24 10:06:46
3258,23,3,758,98,856,3223,2021-01-24 13:00:25
3259,907,3,578,75,653,3224,2021-01-24 10:28:06
3260,837,3,927,120,1047,3225,2021-01-24 17:29:37
3261,604,2,459,59,518,3226,2021-01-24 17:49:38
3262,739,3,827,107,934,3227,2021-01-24 14:58:10
3263,953,3,688,89,777,3228,2021-01-24 19:48:44
3264,207,2,498,64,562,3229,2021-01-24 16:31:09
3265,238,2,698,90,788,3230,2021-01-24 11:21:21
3266,741,2,728,94,822,3231,2021-01-24 06:20:02
3267,418,5,1056,137,1193,3232,2021-01-24 19:35:33
3268,697,3,528,68,596,3233,2021-01-24 01:24:15
3269,537,3,1047,136,1183,3234,2021-01-23 13:03:04
3270,125,2,1098,142,1240,3235,2021-01-23 20:54:03
3271,225,3,888,115,1003,3236,2021-01-23 21:11:38
3272,436,5,1645,213,1858,3237,2021-01-23 16:32:14
3273,930,3,1047,136,1183,3238,2021-01-23 22:28:34
3274,930,3,1047,136,1183,3238,2021-01-23 22:28:34
3275,630,2,498,64,562,3239,2021-01-24 06:01:48
3276,51,3,997,129,1126,3240,2021-01-24 14:31:07
3277,566,2,659,85,744,3241,2021-01-23 22:16:43
3278,754,5,1386,180,1566,3242,2021-01-24 00:09:08
3279,100,2,598,77,675,3243,2021-01-24 03:37:31
3280,199,3,808,105,913,3244,2021-01-25 12:04:01
3281,739,3,1327,172,1499,3245,2021-01-24 22:02:19
3282,246,3,578,75,653,3246,2021-01-25 02:38:20
3283,79,5,1506,195,1701,3247,2021-01-25 05:57:54
3284,664,2,928,120,1048,3248,2021-01-25 08:58:02
3285,929,3,897,116,1013,3249,2021-01-25 06:05:42
3286,844,3,1327,172,1499,3250,2021-01-25 05:05:59
3287,962,3,558,72,630,3251,2021-01-25 14:55:15
3288,950,3,608,79,687,3252,2021-01-25 19:31:52
3289,942,3,1027,133,1160,3253,2021-01-25 17:44:52
3290,117,3,478,62,540,3254,2021-01-25 05:31:51
3291,467,3,888,115,1003,3255,2021-01-25 14:39:51
3292,794,4,1207,156,1363,3256,2021-01-25 04:31:32
3293,119,2,429,55,484,3257,2021-01-24 22:00:29
3294,71,3,808,105,913,3258,2021-01-24 11:30:31
3295,861,2,429,55,484,3259,2021-01-24 10:55:15
3296,92,3,927,120,1047,3260,2021-01-24 15:45:56
3297,882,2,329,42,371,3261,2021-01-24 12:36:38
3298,187,2,329,42,371,3262,2021-01-24 20:13:33
3299,187,2,329,42,371,3262,2021-01-24 20:13:33
3300,323,3,758,98,856,3263,2021-01-24 17:54:52
3301,386,3,1327,172,1499,3264,2021-01-24 17:04:51
3302,735,3,797,103,900,3265,2021-01-24 22:10:30
3303,507,3,747,97,844,3266,2021-01-24 18:46:58
3304,222,3,727,94,821,3267,2021-01-24 12:04:13
3305,764,3,1327,172,1499,3268,2021-01-24 09:04:57
3306,597,3,688,89,777,3269,2021-01-24 20:00:49
3307,597,3,688,89,777,3269,2021-01-24 20:00:49
3308,875,3,827,107,934,3270,2021-01-24 03:45:11
3309,676,3,747,97,844,3271,2021-01-23 13:40:43
3310,316,2,329,42,371,3272,2021-01-23 23:33:13
3311,469,2,429,55,484,3273,2021-01-23 22:42:10
3312,898,3,1027,133,1160,3274,2021-01-23 16:49:18
3313,187,2,898,116,1014,3275,2021-01-23 23:42:12
3314,987,2,598,77,675,3276,2021-01-23 23:03:56
3315,980,3,747,97,844,3277,2021-01-24 06:43:47
3316,991,3,478,62,540,3278,2021-01-24 16:53:33
3317,555,2,1098,142,1240,3279,2021-01-23 23:49:19
3318,657,3,797,103,900,3280,2021-01-24 00:36:12
3319,254,3,478,62,540,3281,2021-01-24 04:37:31
3320,679,1,229,29,258,3282,2021-01-25 14:33:56
3321,776,2,898,116,1014,3283,2021-01-24 23:44:00
3322,531,2,698,90,788,3284,2021-01-25 03:20:15
3323,170,3,747,97,844,3285,2021-01-25 08:24:26
3324,259,1,499,64,563,3286,2021-01-25 09:07:19
3325,176,3,808,105,913,3287,2021-01-25 06:50:08
3326,478,3,1197,155,1352,3288,2021-01-25 07:04:07
3327,859,2,659,85,744,3289,2021-01-25 17:28:30
3328,969,2,659,85,744,3290,2021-01-25 20:54:18
3329,478,3,1247,162,1409,3291,2021-01-25 19:47:21
3330,49,3,927,120,1047,3292,2021-01-25 06:03:52
3331,930,2,498,64,562,3293,2021-01-25 16:17:10
3332,487,3,747,97,844,3294,2021-01-25 06:48:01
3333,759,3,1247,162,1409,3295,2021-01-24 23:08:57
3334,806,2,548,71,619,3296,2021-01-24 12:20:08
3335,366,3,528,68,596,3297,2021-01-24 13:13:20
3336,334,2,528,68,596,3298,2021-01-24 18:29:56
3337,380,3,1047,136,1183,3299,2021-01-24 13:25:46
3338,555,6,1974,256,2230,3300,2021-01-24 22:37:55
3339,974,3,747,97,844,3301,2021-01-24 21:08:21
3340,560,2,429,55,484,3302,2021-01-24 19:10:16
3341,45,2,498,64,562,3303,2021-01-24 17:33:56
3342,48,3,847,110,957,3304,2021-01-24 23:12:55
3343,764,3,428,55,483,3305,2021-01-24 21:17:07
3344,878,2,798,103,901,3306,2021-01-24 13:39:00
3345,676,3,747,97,844,3307,2021-01-24 09:38:19
3346,13,3,478,62,540,3308,2021-01-24 21:06:48
3347,539,3,1047,136,1183,3309,2021-01-24 21:35:49
3348,509,2,1098,142,1240,3310,2021-01-24 04:33:57
3349,257,3,1047,136,1183,3311,2021-01-23 13:53:50
3350,889,2,498,64,562,3312,2021-01-24 01:25:52
3351,875,3,1027,133,1160,3313,2021-01-23 23:02:55
3352,969,5,1895,246,2141,3314,2021-01-23 16:57:13
3353,49,3,528,68,596,3315,2021-01-24 02:05:29
3354,688,3,528,68,596,3316,2021-01-24 00:02:15
3355,713,3,747,97,844,3317,2021-01-24 08:49:03
3356,713,3,747,97,844,3317,2021-01-24 08:49:03
3357,77,2,898,116,1014,3318,2021-01-24 18:42:36
3358,62,3,558,72,630,3319,2021-01-24 00:45:47
3359,955,3,947,123,1070,3320,2021-01-24 01:43:53
3360,781,3,1047,136,1183,3321,2021-01-24 06:00:39
3361,780,2,848,110,958,3322,2021-01-25 15:24:19
3362,818,2,459,59,518,3323,2021-01-25 01:28:46
3363,818,2,459,59,518,3323,2021-01-25 01:28:46
3364,361,3,727,94,821,3324,2021-01-25 03:22:15
3365,414,5,1267,164,1431,3325,2021-01-25 11:05:56
3366,240,3,558,72,630,3326,2021-01-25 09:16:44
3367,718,2,728,94,822,3327,2021-01-25 07:08:10
3368,283,2,728,94,822,3328,2021-01-25 08:04:11
3369,844,2,598,77,675,3329,2021-01-25 18:35:59
3370,422,3,688,89,777,3330,2021-01-25 21:47:00
3371,36,3,1247,162,1409,3331,2021-01-25 22:29:49
3372,299,5,1276,165,1441,3332,2021-01-25 06:43:42
3373,31,5,1326,172,1498,3333,2021-01-25 17:58:41
3374,75,3,1327,172,1499,3334,2021-01-25 09:14:45
3375,106,3,1047,136,1183,3335,2021-01-25 00:12:22
3376,330,6,1425,185,1610,3336,2021-01-24 14:17:41
3377,330,6,1425,185,1610,3336,2021-01-24 14:17:41
3378,923,2,898,116,1014,3337,2021-01-24 14:47:25
3379,336,5,1725,224,1949,3338,2021-01-24 19:22:30
3380,15,2,628,81,709,3339,2021-01-24 15:43:08
3381,788,2,848,110,958,3340,2021-01-25 01:05:39
3382,565,3,888,115,1003,3341,2021-01-24 23:06:04
3383,221,1,99,12,111,3342,2021-01-24 20:11:58
3384,989,3,827,107,934,3343,2021-01-24 18:57:40
3385,611,2,598,77,675,3344,2021-01-25 00:17:26
3386,897,5,1575,204,1779,3345,2021-01-24 22:53:01
3387,106,3,688,89,777,3346,2021-01-24 13:40:13
3388,767,3,747,97,844,3347,2021-01-24 10:42:45
3389,732,3,658,85,743,3348,2021-01-24 22:23:53
3390,209,3,888,115,1003,3349,2021-01-24 22:47:51
3391,209,3,478,62,540,3350,2021-01-24 05:01:14
3392,943,3,747,97,844,3351,2021-01-23 14:33:40
3393,93,2,1098,142,1240,3352,2021-01-24 03:08:41
3394,705,3,997,129,1126,3353,2021-01-24 00:20:52
3395,576,1,229,29,258,3354,2021-01-23 18:41:40
3396,477,2,598,77,675,3355,2021-01-24 04:18:50
3397,358,2,498,64,562,3356,2021-01-24 00:48:05
3398,276,3,1047,136,1183,3357,2021-01-24 10:58:23
3399,334,1,99,12,111,3358,2021-01-24 10:24:18
3400,762,3,578,75,653,3359,2021-01-24 18:54:27
3401,324,3,528,68,596,3360,2021-01-24 03:20:20
3402,26,3,558,72,630,3361,2021-01-24 02:59:12
3403,936,3,597,77,674,3362,2021-01-24 08:25:15
3404,519,6,1744,226,1970,3363,2021-01-25 16:15:10
3405,227,3,808,105,913,3364,2021-01-25 02:43:20
3406,451,2,898,116,1014,3365,2021-01-25 02:19:28
3407,292,4,1356,176,1532,3366,2021-01-25 06:01:45
3408,730,2,459,59,518,3367,2021-01-25 12:56:24
3409,955,3,847,110,957,3368,2021-01-25 10:09:33
3410,548,3,897,116,1013,3369,2021-01-25 09:02:44
3411,144,3,897,116,1013,3370,2021-01-25 08:59:16
3412,709,3,927,120,1047,3371,2021-01-25 21:02:19
3413,415,3,697,90,787,3372,2021-01-25 22:25:47
3414,675,3,1047,136,1183,3373,2021-01-26 00:06:59
3415,679,3,1247,162,1409,3374,2021-01-25 08:13:15
3416,6,3,478,62,540,3375,2021-01-25 20:32:16
3417,8,3,747,97,844,3376,2021-01-25 11:12:55
3418,682,6,1655,215,1870,3377,2021-01-25 02:48:39
3419,819,3,727,94,821,3378,2021-01-24 16:22:26
3420,14,3,647,84,731,3379,2021-01-24 16:01:54
3421,372,5,1475,191,1666,3380,2021-01-24 16:46:10
3422,375,2,598,77,675,3381,2021-01-24 21:40:35
3423,460,2,928,120,1048,3382,2021-01-24 17:42:11
3424,570,3,747,97,844,3383,2021-01-25 03:25:29
3425,765,2,798,103,901,3384,2021-01-25 00:54:01
3426,353,1,599,77,676,3385,2021-01-24 20:40:58
3427,192,3,658,85,743,3386,2021-01-24 21:09:41
3428,527,6,1635,212,1847,3387,2021-01-25 01:15:52
3429,919,2,329,42,371,3388,2021-01-25 01:02:09
3430,401,2,429,55,484,3389,2021-01-24 14:48:50
3431,323,2,498,64,562,3390,2021-01-24 11:59:16
3432,512,1,229,29,258,3391,2021-01-24 23:08:06
3433,377,3,758,98,856,3392,2021-01-24 23:07:10
3434,847,2,698,90,788,3393,2021-01-24 07:21:52
3435,315,2,598,77,675,3394,2021-01-23 15:19:03
3436,162,2,498,64,562,3395,2021-01-24 05:28:10
3437,981,2,598,77,675,3396,2021-01-24 00:51:40
3438,233,3,747,97,844,3397,2021-01-23 20:08:55
3439,434,2,459,59,518,3398,2021-01-24 05:12:50
3440,668,2,398,51,449,3399,2021-01-24 02:28:34
3441,706,2,498,64,562,3400,2021-01-24 13:25:28
3442,921,3,747,97,844,3401,2021-01-24 11:42:28
3443,95,2,598,77,675,3402,2021-01-24 19:58:05
3444,191,3,697,90,787,3403,2021-01-24 04:52:33
3445,997,4,1246,161,1407,3404,2021-01-24 03:07:29
3446,310,2,329,42,371,3405,2021-01-24 10:33:01
3447,968,3,997,129,1126,3406,2021-01-25 17:44:14
3448,311,3,947,123,1070,3407,2021-01-25 03:41:17
3449,742,3,1197,155,1352,3408,2021-01-25 03:20:43
3450,313,3,747,97,844,3409,2021-01-25 08:07:36
3451,956,3,1127,146,1273,3410,2021-01-25 14:34:07
3452,807,3,478,62,540,3411,2021-01-25 12:44:46
3453,240,1,99,12,111,3412,2021-01-25 09:24:08
3454,470,3,997,129,1126,3413,2021-01-25 10:37:32
3455,209,3,1197,155,1352,3414,2021-01-25 21:21:14
3456,632,2,898,116,1014,3415,2021-01-25 23:41:04
3457,571,3,727,94,821,3416,2021-01-26 01:31:29
3458,67,3,1047,136,1183,3417,2021-01-25 09:37:10
3459,60,2,748,97,845,3418,2021-01-25 22:46:47
3460,354,3,1197,155,1352,3419,2021-01-25 13:16:13
3461,565,1,149,19,168,3420,2021-01-25 03:04:43
3462,471,2,798,103,901,3421,2021-01-24 17:44:52
3463,586,6,1544,200,1744,3422,2021-01-24 17:12:40
3464,61,3,797,103,900,3423,2021-01-24 17:36:49
3465,150,3,688,89,777,3424,2021-01-24 23:34:02
3466,70,2,698,90,788,3425,2021-01-24 20:11:32
3467,825,3,797,103,900,3426,2021-01-25 05:38:19
3468,742,2,598,77,675,3427,2021-01-25 01:06:48
3469,789,3,927,120,1047,3428,2021-01-24 22:10:56
3470,966,2,828,107,935,3429,2021-01-24 22:41:05
3471,675,3,758,98,856,3430,2021-01-25 02:38:45
3472,328,5,1745,226,1971,3431,2021-01-25 03:18:00
3473,38,5,1306,169,1475,3432,2021-01-24 16:20:20
3474,543,3,947,123,1070,3433,2021-01-24 14:06:53
3475,223,2,898,116,1014,3434,2021-01-25 00:44:08
3476,397,2,429,55,484,3435,2021-01-24 23:59:15
3477,917,3,897,116,1013,3436,2021-01-24 08:56:55
3478,712,3,1047,136,1183,3437,2021-01-23 16:43:33
3479,449,3,747,97,844,3438,2021-01-24 06:35:03
3480,465,3,1127,146,1273,3439,2021-01-24 03:17:41
3481,849,2,798,103,901,3440,2021-01-23 20:43:22
3482,975,2,1098,142,1240,3441,2021-01-24 05:33:58
3483,471,2,548,71,619,3442,2021-01-24 03:57:45
3484,596,3,808,105,913,3443,2021-01-24 15:51:50
3485,212,3,1247,162,1409,3444,2021-01-24 13:37:22
3486,677,3,688,89,777,3445,2021-01-24 21:16:00
3487,458,2,598,77,675,3446,2021-01-24 05:02:38
3488,533,3,888,115,1003,3447,2021-01-24 04:10:35
3489,77,2,498,64,562,3448,2021-01-24 12:03:30
3490,550,2,459,59,518,3449,2021-01-25 18:31:00
3491,423,2,459,59,518,3450,2021-01-25 06:00:43
3492,373,3,597,77,674,3451,2021-01-25 04:12:09
3493,170,3,1327,172,1499,3452,2021-01-25 08:54:04
3494,202,2,798,103,901,3453,2021-01-25 15:31:28
3495,831,3,478,62,540,3454,2021-01-25 13:56:03
3496,31,3,478,62,540,3455,2021-01-25 10:37:39
3497,349,1,599,77,676,3456,2021-01-25 12:45:39
3498,466,3,1127,146,1273,3457,2021-01-25 21:30:49
3499,714,3,1027,133,1160,3458,2021-01-26 01:42:15
3500,60,3,727,94,821,3459,2021-01-26 02:30:39
3501,589,5,926,120,1046,3460,2021-01-25 11:30:55
3502,883,3,697,90,787,3461,2021-01-26 01:25:17
3503,975,1,99,12,111,3462,2021-01-25 15:14:50
3504,840,6,1305,169,1474,3463,2021-01-25 05:20:56
3505,342,3,558,72,630,3464,2021-01-24 19:18:57
3506,443,1,149,19,168,3465,2021-01-24 18:20:56
3507,42,3,658,85,743,3466,2021-01-24 18:12:48
3508,656,2,898,116,1014,3467,2021-01-25 01:06:12
3509,107,6,1954,254,2208,3468,2021-01-24 21:31:42
3510,665,2,798,103,901,3469,2021-01-25 06:23:49
3511,451,3,808,105,913,3470,2021-01-25 01:56:03
3512,501,1,599,77,676,3471,2021-01-24 22:13:21
3513,654,3,1327,172,1499,3472,2021-01-25 00:57:19
3514,683,3,1327,172,1499,3473,2021-01-25 03:51:37
3515,165,2,448,58,506,3474,2021-01-25 04:24:50
3516,183,3,578,75,653,3475,2021-01-24 18:42:22
3517,243,3,1127,146,1273,3476,2021-01-24 15:32:51
3518,951,3,727,94,821,3477,2021-01-25 03:12:36
3519,942,3,888,115,1003,3478,2021-01-25 01:08:01
3520,616,4,1157,150,1307,3479,2021-01-24 09:58:52
3521,892,4,996,129,1125,3480,2021-01-23 18:40:18
3522,333,2,898,116,1014,3481,2021-01-24 07:16:24
3523,634,1,99,12,111,3482,2021-01-24 05:57:41
3524,136,3,997,129,1126,3483,2021-01-23 22:31:00
3525,399,3,558,72,630,3484,2021-01-24 07:27:10
3526,448,3,697,90,787,3485,2021-01-24 06:39:55
3527,688,3,897,116,1013,3486,2021-01-24 16:31:05
3528,372,3,1127,146,1273,3487,2021-01-24 15:58:02
3529,848,5,1445,187,1632,3488,2021-01-24 23:03:56
3530,175,2,329,42,371,3489,2021-01-24 07:31:37
3531,447,2,1098,142,1240,3490,2021-01-24 04:39:48
3532,169,3,608,79,687,3491,2021-01-24 12:08:11
3533,414,2,429,55,484,3492,2021-01-25 19:52:59
3534,451,3,1047,136,1183,3493,2021-01-25 08:39:09
3535,374,4,1596,207,1803,3494,2021-01-25 05:28:00
3536,32,5,1495,194,1689,3495,2021-01-25 09:44:05
3537,765,5,1186,154,1340,3496,2021-01-25 17:55:49
3538,230,2,429,55,484,3497,2021-01-25 14:20:14
3539,227,2,459,59,518,3498,2021-01-25 10:39:45
3540,787,3,608,79,687,3499,2021-01-25 14:33:11
3541,787,5,1995,259,2254,3500,2021-01-25 22:04:29
3542,988,3,897,116,1013,3501,2021-01-26 01:44:49
3543,997,2,329,42,371,3502,2021-01-26 04:07:32
3544,138,3,697,90,787,3503,2021-01-25 12:31:26
3545,633,2,598,77,675,3504,2021-01-26 02:11:07
3546,625,3,947,123,1070,3505,2021-01-25 17:32:13
3547,532,5,1495,194,1689,3506,2021-01-25 05:31:04
3548,63,3,997,129,1126,3507,2021-01-24 20:53:12
3549,764,3,647,84,731,3508,2021-01-24 18:45:05
3550,812,3,697,90,787,3509,2021-01-24 20:20:02
3551,284,3,827,107,934,3510,2021-01-25 01:58:31
3552,480,3,608,79,687,3511,2021-01-24 22:18:09
3553,638,3,608,79,687,3512,2021-01-25 08:27:17
3554,225,3,528,68,596,3513,2021-01-25 04:14:48
3555,634,2,659,85,744,3514,2021-01-25 00:20:08
3556,135,2,459,59,518,3515,2021-01-25 03:06:11
3557,703,3,478,62,540,3516,2021-01-25 05:08:56
3558,285,5,1426,185,1611,3517,2021-01-25 06:34:29
3559,45,3,897,116,1013,3518,2021-01-24 19:15:19
3560,564,2,498,64,562,3519,2021-01-24 17:44:06
3561,275,3,727,94,821,3520,2021-01-25 04:12:42
3562,126,1,599,77,676,3521,2021-01-25 01:09:03
3563,650,2,498,64,562,3522,2021-01-24 10:54:39
3564,515,2,598,77,675,3523,2021-01-23 20:40:26
3565,461,3,947,123,1070,3524,2021-01-24 08:11:37
3566,674,2,1098,142,1240,3525,2021-01-24 06:02:30
3567,602,3,428,55,483,3526,2021-01-24 00:02:39
3568,724,4,1226,159,1385,3527,2021-01-24 07:54:52
3569,487,3,758,98,856,3528,2021-01-24 08:43:39
3570,289,3,1197,155,1352,3529,2021-01-24 19:13:45
3571,953,3,1127,146,1273,3530,2021-01-24 17:50:24
3572,915,4,1226,159,1385,3531,2021-01-25 00:38:07
3573,84,3,1027,133,1160,3532,2021-01-24 08:57:34
3574,840,3,947,123,1070,3533,2021-01-24 07:25:46
3575,944,2,898,116,1014,3534,2021-01-24 14:17:59
3576,556,2,659,85,744,3535,2021-01-25 20:39:49
3577,823,1,599,77,676,3536,2021-01-25 11:23:18
3578,674,5,1325,172,1497,3537,2021-01-25 07:43:53
3579,770,6,1425,185,1610,3538,2021-01-25 10:13:07
3580,986,2,429,55,484,3539,2021-01-25 19:15:38
3581,171,2,659,85,744,3540,2021-01-25 16:02:44
3582,79,2,448,58,506,3541,2021-01-25 13:11:18
3583,609,4,1107,143,1250,3542,2021-01-25 14:56:02
3584,382,3,1247,162,1409,3543,2021-01-26 00:45:58
3585,554,4,1357,176,1533,3544,2021-01-26 03:18:34
3586,652,3,827,107,934,3545,2021-01-26 04:11:11
3587,701,3,827,107,934,3546,2021-01-25 14:04:59
3588,883,5,1376,178,1554,3547,2021-01-26 04:15:31
3589,971,3,997,129,1126,3548,2021-01-25 17:50:28
3590,218,5,1925,250,2175,3549,2021-01-25 06:15:04
3591,203,3,647,84,731,3550,2021-01-24 21:48:29
3592,478,3,1047,136,1183,3551,2021-01-24 21:08:04
3593,643,3,888,115,1003,3552,2021-01-24 22:11:30
3594,488,3,997,129,1126,3553,2021-01-25 01:58:48
3595,287,2,329,42,371,3554,2021-01-24 23:00:06
3596,972,1,399,51,450,3555,2021-01-25 08:34:22
3597,900,3,1047,136,1183,3556,2021-01-25 04:23:29
3598,807,3,947,123,1070,3557,2021-01-25 01:54:10
3599,978,3,947,123,1070,3558,2021-01-25 04:12:11
3600,453,3,947,123,1070,3559,2021-01-25 05:48:17
3601,811,6,1544,200,1744,3560,2021-01-25 08:10:20
3602,114,1,499,64,563,3561,2021-01-24 19:21:52
3603,70,3,847,110,957,3562,2021-01-24 19:20:00
3604,245,2,598,77,675,3563,2021-01-25 06:49:31
3605,602,3,758,98,856,3564,2021-01-25 02:40:30
3606,967,3,758,98,856,3565,2021-01-24 12:59:15
3607,17,3,797,103,900,3566,2021-01-23 22:46:23
3608,403,3,558,72,630,3567,2021-01-24 09:01:14
3609,547,1,229,29,258,3568,2021-01-24 07:17:20
3610,679,3,478,62,540,3569,2021-01-24 01:35:03
3611,655,3,1127,146,1273,3570,2021-01-24 10:25:56
3612,890,4,1696,220,1916,3571,2021-01-24 10:52:01
3613,558,2,1098,142,1240,3572,2021-01-24 21:30:49
3614,889,5,1076,139,1215,3573,2021-01-24 17:58:59
3615,357,3,1027,133,1160,3574,2021-01-25 01:59:47
3616,725,3,997,129,1126,3575,2021-01-24 10:00:56
3617,665,2,598,77,675,3576,2021-01-24 09:59:54
3618,729,3,608,79,687,3577,2021-01-24 17:01:32
3619,563,2,329,42,371,3578,2021-01-25 23:12:55
3620,780,5,1545,200,1745,3579,2021-01-25 12:27:17
3621,641,2,329,42,371,3580,2021-01-25 08:38:19
3622,502,2,598,77,675,3581,2021-01-25 10:50:00
3623,164,3,647,84,731,3582,2021-01-25 21:43:53
3624,270,3,1047,136,1183,3583,2021-01-25 18:26:42
3625,629,4,1196,155,1351,3584,2021-01-25 14:24:20
3626,183,2,1098,142,1240,3585,2021-01-25 17:08:59
3627,892,3,578,75,653,3586,2021-01-26 03:28:46
3628,453,2,598,77,675,3587,2021-01-26 04:55:38
3629,769,6,1544,200,1744,3588,2021-01-26 06:04:18
3630,592,3,558,72,630,3589,2021-01-25 16:13:33
3631,729,2,498,64,562,3590,2021-01-26 05:47:09
3632,1,4,1696,220,1916,3591,2021-01-25 20:08:44
3633,225,3,997,129,1126,3592,2021-01-25 07:59:56
3634,607,3,747,97,844,3593,2021-01-24 22:30:41
3635,367,3,1127,146,1273,3594,2021-01-24 23:35:02
3636,297,3,578,75,653,3595,2021-01-24 23:18:45
3637,220,4,1526,198,1724,3596,2021-01-25 02:45:12
3638,544,2,598,77,675,3597,2021-01-24 23:46:41
3639,681,3,1047,136,1183,3598,2021-01-25 08:36:33
3640,938,3,758,98,856,3599,2021-01-25 06:14:09
3641,91,2,548,71,619,3600,2021-01-25 03:59:10
3642,223,2,498,64,562,3601,2021-01-25 05:36:29
3643,595,5,1525,198,1723,3602,2021-01-25 07:11:20
3644,429,2,628,81,709,3603,2021-01-25 10:11:19
3645,433,5,1325,172,1497,3604,2021-01-24 20:05:20
3646,592,3,1127,146,1273,3605,2021-01-24 21:32:32
3647,340,3,697,90,787,3606,2021-01-25 08:28:22
3648,297,3,1047,136,1183,3607,2021-01-25 04:26:26
3649,305,3,478,62,540,3608,2021-01-24 13:34:59
3650,250,2,659,85,744,3609,2021-01-23 23:36:05
3651,372,2,798,103,901,3610,2021-01-24 09:09:48
3652,323,4,1246,161,1407,3611,2021-01-24 09:17:25
3653,539,3,1127,146,1273,3612,2021-01-24 03:34:40
3654,437,3,1027,133,1160,3613,2021-01-24 11:53:05
3655,119,1,99,12,111,3614,2021-01-24 13:16:02
3656,565,3,1047,136,1183,3615,2021-01-24 23:28:41
3657,384,2,659,85,744,3616,2021-01-24 18:06:30
3658,39,3,827,107,934,3617,2021-01-25 02:11:31
3659,648,3,1197,155,1352,3618,2021-01-24 11:27:23
3660,621,3,558,72,630,3619,2021-01-24 12:41:21
3661,790,1,399,51,450,3620,2021-01-24 19:26:32
3662,562,3,1127,146,1273,3621,2021-01-26 01:33:30
3663,462,2,329,42,371,3622,2021-01-25 13:06:09
3664,562,3,747,97,844,3623,2021-01-25 09:07:27
3665,554,3,1047,136,1183,3624,2021-01-25 11:14:08
3666,996,4,1996,259,2255,3625,2021-01-25 22:44:28
3667,724,3,478,62,540,3626,2021-01-25 21:07:59
3668,328,3,578,75,653,3627,2021-01-25 16:27:10
3669,181,3,997,129,1126,3628,2021-01-25 18:19:21
3670,615,3,747,97,844,3629,2021-01-26 05:14:23
3671,851,2,329,42,371,3630,2021-01-26 06:48:22
3672,681,3,697,90,787,3631,2021-01-26 07:36:44
3673,253,3,827,107,934,3632,2021-01-25 17:06:00
3674,227,3,658,85,743,3633,2021-01-26 08:28:15
3675,140,3,558,72,630,3634,2021-01-25 22:08:18
3676,958,3,888,115,1003,3635,2021-01-25 09:30:15
3677,835,3,697,90,787,3636,2021-01-25 01:12:10
3678,332,3,747,97,844,3637,2021-01-25 01:18:40
3679,651,3,608,79,687,3638,2021-01-25 01:33:08
3680,885,2,498,64,562,3639,2021-01-25 03:42:21
3681,431,2,598,77,675,3640,2021-01-25 01:13:43
3682,522,2,459,59,518,3641,2021-01-25 09:20:43
3683,407,3,808,105,913,3642,2021-01-25 07:17:35
3684,913,2,648,84,732,3643,2021-01-25 05:24:01
3685,438,5,1955,254,2209,3644,2021-01-25 07:06:59
3686,69,3,697,90,787,3645,2021-01-25 07:40:03
3687,901,3,827,107,934,3646,2021-01-25 11:23:52
3688,516,3,947,123,1070,3647,2021-01-24 20:36:34
3689,992,2,798,103,901,3648,2021-01-25 00:16:17
3690,33,2,1098,142,1240,3649,2021-01-25 11:06:27
3691,671,3,597,77,674,3650,2021-01-25 06:10:04
3692,671,3,597,77,674,3650,2021-01-25 06:10:04
3693,233,3,578,75,653,3651,2021-01-24 15:46:35
3694,465,3,647,84,731,3652,2021-01-24 01:47:00
3695,422,3,1247,162,1409,3653,2021-01-24 09:38:47
3696,680,2,598,77,675,3654,2021-01-24 11:31:46
3697,368,5,1575,204,1779,3655,2021-01-24 03:54:24
3698,692,3,558,72,630,3656,2021-01-24 13:22:49
3699,282,3,927,120,1047,3657,2021-01-24 13:56:08
3700,977,5,1475,191,1666,3658,2021-01-25 01:06:50
3701,412,3,1027,133,1160,3659,2021-01-24 20:30:39
3702,316,2,429,55,484,3660,2021-01-25 04:39:46
3703,269,3,827,107,934,3661,2021-01-24 11:29:32
3704,200,4,1346,174,1520,3662,2021-01-24 13:00:53
3705,332,2,498,64,562,3663,2021-01-24 19:59:32
3706,139,3,528,68,596,3664,2021-01-26 01:41:58
3707,204,2,329,42,371,3665,2021-01-25 15:23:08
3708,256,2,598,77,675,3666,2021-01-25 11:16:14
3709,776,1,299,38,337,3667,2021-01-25 12:24:16
3710,971,2,329,42,371,3668,2021-01-25 23:54:39
3711,603,3,558,72,630,3669,2021-01-25 21:16:23
3712,923,2,898,116,1014,3670,2021-01-25 16:45:27
3713,643,3,847,110,957,3671,2021-01-25 21:04:13
3714,504,3,558,72,630,3672,2021-01-26 07:15:58
3715,299,3,697,90,787,3673,2021-01-26 08:37:55
3716,498,3,1047,136,1183,3674,2021-01-26 10:22:05
3717,706,3,888,115,1003,3675,2021-01-25 19:24:22
3718,836,5,1276,165,1441,3676,2021-01-26 09:24:38
3719,505,3,897,116,1013,3677,2021-01-25 23:37:33
3720,952,3,727,94,821,3678,2021-01-25 11:53:09
3721,336,3,1327,172,1499,3679,2021-01-25 01:19:19
3722,188,2,898,116,1014,3680,2021-01-25 03:42:07
3723,511,5,1225,159,1384,3681,2021-01-25 02:28:42
3724,127,3,897,116,1013,3682,2021-01-25 04:47:03
3725,975,6,2024,263,2287,3683,2021-01-25 01:47:15
3726,426,6,1685,219,1904,3684,2021-01-25 10:27:18
3727,889,2,698,90,788,3685,2021-01-25 08:55:56
3728,244,3,747,97,844,3686,2021-01-25 06:49:24
3729,36,5,1326,172,1498,3687,2021-01-25 09:07:03
3730,148,2,429,55,484,3688,2021-01-25 08:48:40
3731,995,6,1954,254,2208,3689,2021-01-25 12:55:56
3732,881,2,898,116,1014,3690,2021-01-24 21:51:13
3733,818,3,1127,146,1273,3691,2021-01-25 01:31:43
3734,564,3,558,72,630,3692,2021-01-25 11:09:34
3735,260,2,598,77,675,3693,2021-01-25 06:53:38
3736,115,2,898,116,1014,3694,2021-01-25 06:55:13
3737,45,2,329,42,371,3695,2021-01-24 16:39:54
3738,506,2,898,116,1014,3696,2021-01-24 03:42:26
3739,743,2,329,42,371,3697,2021-01-24 11:25:27
3740,73,3,428,55,483,3698,2021-01-24 12:36:46
3741,651,3,1197,155,1352,3699,2021-01-24 06:38:25
3742,253,3,608,79,687,3700,2021-01-24 14:29:59
3743,140,3,827,107,934,3701,2021-01-24 15:38:09
3744,881,3,747,97,844,3702,2021-01-25 01:48:54
3745,40,3,827,107,934,3703,2021-01-24 22:18:00
3746,804,3,608,79,687,3704,2021-01-25 05:03:05
3747,102,5,1376,178,1554,3705,2021-01-24 13:48:41
3748,231,3,697,90,787,3706,2021-01-24 13:51:20
3749,742,3,688,89,777,3707,2021-01-24 22:28:22
3750,740,3,608,79,687,3708,2021-01-26 04:10:51
3751,453,3,797,103,900,3709,2021-01-25 17:53:36
3752,502,3,897,116,1013,3710,2021-01-25 12:25:07
3753,867,3,727,94,821,3711,2021-01-25 13:41:11
3754,473,1,699,90,789,3712,2021-01-26 01:35:37
3755,230,3,697,90,787,3713,2021-01-25 22:25:55
3756,907,3,997,129,1126,3714,2021-01-25 18:01:58
3757,771,3,808,105,913,3715,2021-01-25 23:42:37
3758,586,3,528,68,596,3716,2021-01-26 07:33:43
3759,178,2,429,55,484,3717,2021-01-26 08:40:23
3760,18,2,898,116,1014,3718,2021-01-26 10:26:25
3761,443,1,399,51,450,3719,2021-01-25 19:51:11
3762,504,3,947,123,1070,3720,2021-01-26 11:16:51
3763,379,2,898,116,1014,3721,2021-01-26 01:08:50
3764,734,2,329,42,371,3722,2021-01-25 12:35:47
3765,693,3,747,97,844,3723,2021-01-25 02:47:26
3766,882,2,848,110,958,3724,2021-01-25 04:18:28
3767,200,5,1356,176,1532,3725,2021-01-25 04:50:04
3768,247,4,1096,142,1238,3726,2021-01-25 04:51:28
3769,628,2,598,77,675,3727,2021-01-25 04:28:55
3770,253,6,1424,185,1609,3728,2021-01-25 12:18:32
3771,693,3,658,85,743,3729,2021-01-25 10:50:06
3772,756,3,927,120,1047,3730,2021-01-25 07:26:26
3773,702,2,698,90,788,3731,2021-01-25 11:52:05
3774,678,2,598,77,675,3732,2021-01-25 10:37:44
3775,709,3,1247,162,1409,3733,2021-01-25 13:14:04
3776,78,6,2324,302,2626,3734,2021-01-24 23:53:22
3777,186,3,578,75,653,3735,2021-01-25 02:42:48
3778,9,3,1127,146,1273,3736,2021-01-25 12:54:34
3779,78,3,1047,136,1183,3737,2021-01-25 09:31:29
3780,185,5,2175,282,2457,3738,2021-01-25 07:42:11
3781,81,3,697,90,787,3739,2021-01-24 18:25:18
3782,510,6,1575,204,1779,3740,2021-01-24 04:06:24
3783,42,4,1726,224,1950,3741,2021-01-24 11:57:30
3784,511,2,898,116,1014,3742,2021-01-24 13:07:23
3785,208,2,698,90,788,3743,2021-01-24 09:24:32
3786,352,3,658,85,743,3744,2021-01-24 14:40:31
3787,492,6,2154,280,2434,3745,2021-01-24 16:50:06
3788,95,2,598,77,675,3746,2021-01-25 02:54:06
3789,84,3,997,129,1126,3747,2021-01-24 22:45:57
3790,765,3,747,97,844,3748,2021-01-25 07:29:43
3791,56,3,428,55,483,3749,2021-01-24 16:13:07
3792,513,3,597,77,674,3750,2021-01-24 15:49:58
3793,455,2,429,55,484,3751,2021-01-25 00:26:00
3794,822,2,1098,142,1240,3752,2021-01-26 05:01:25
3795,765,3,997,129,1126,3753,2021-01-25 19:15:49
3796,799,3,947,123,1070,3754,2021-01-25 14:02:23
3797,899,6,1605,208,1813,3755,2021-01-25 16:10:36
3798,89,3,1247,162,1409,3756,2021-01-26 04:01:36
3799,129,3,888,115,1003,3757,2021-01-26 00:47:57
3800,475,2,798,103,901,3758,2021-01-25 18:31:02
3801,490,2,798,103,901,3759,2021-01-26 00:47:56
3802,299,2,898,116,1014,3760,2021-01-26 08:28:53
3803,832,3,1047,136,1183,3761,2021-01-26 10:03:04
3804,675,2,459,59,518,3762,2021-01-26 11:03:42
3805,425,3,658,85,743,3763,2021-01-25 22:11:23
3806,800,2,398,51,449,3764,2021-01-26 13:00:22
3807,497,3,528,68,596,3765,2021-01-26 02:03:15
3808,710,2,459,59,518,3766,2021-01-25 15:20:18
3809,500,3,558,72,630,3767,2021-01-25 02:55:10
3810,810,2,698,90,788,3768,2021-01-25 04:44:38
3811,304,3,927,120,1047,3769,2021-01-25 05:05:58
3812,197,2,659,85,744,3770,2021-01-25 07:08:39
3813,127,2,398,51,449,3771,2021-01-25 04:54:01
3814,139,5,1386,180,1566,3772,2021-01-25 13:46:39
3815,348,3,697,90,787,3773,2021-01-25 11:43:50
3816,428,3,597,77,674,3774,2021-01-25 09:59:13
3817,133,3,797,103,900,3775,2021-01-25 12:41:26
3818,950,3,428,55,483,3776,2021-01-25 11:32:47
3819,682,2,698,90,788,3777,2021-01-25 15:30:41
3820,66,3,1247,162,1409,3778,2021-01-25 01:08:07
3821,57,3,1047,136,1183,3779,2021-01-25 04:22:50
3822,938,3,947,123,1070,3780,2021-01-25 15:00:16
3823,538,3,1127,146,1273,3781,2021-01-25 11:50:33
3824,834,2,498,64,562,3782,2021-01-25 08:10:01
3825,558,3,997,129,1126,3783,2021-01-24 21:02:52
3826,821,3,647,84,731,3784,2021-01-24 05:22:48
3827,720,3,528,68,596,3785,2021-01-24 12:19:08
3828,828,3,888,115,1003,3786,2021-01-24 13:16:26
3829,973,4,1246,161,1407,3787,2021-01-24 10:00:36
3830,968,3,1127,146,1273,3788,2021-01-24 15:49:55
3831,25,3,688,89,777,3789,2021-01-24 17:53:06
3832,5,6,1424,185,1609,3790,2021-01-25 03:09:30
3833,78,2,548,71,619,3791,2021-01-25 00:32:38
3834,395,2,1098,142,1240,3792,2021-01-25 09:14:28
3835,544,3,747,97,844,3793,2021-01-24 18:31:13
3836,93,3,528,68,596,3794,2021-01-24 17:17:52
3837,468,3,747,97,844,3795,2021-01-25 02:41:47
3838,897,2,429,55,484,3796,2021-01-26 07:01:06
3839,280,3,747,97,844,3797,2021-01-25 20:19:55
3840,496,2,659,85,744,3798,2021-01-25 15:46:48
3841,536,3,797,103,900,3799,2021-01-25 16:58:11
3842,858,2,498,64,562,3800,2021-01-26 06:24:12
3843,682,1,149,19,168,3801,2021-01-26 00:49:18
3844,150,3,1327,172,1499,3802,2021-01-25 18:45:07
3845,962,3,1127,146,1273,3803,2021-01-26 01:20:13
3846,335,2,848,110,958,3804,2021-01-26 08:41:58
3847,62,3,1197,155,1352,3805,2021-01-26 11:09:48
3848,326,5,1445,187,1632,3806,2021-01-26 13:47:57
3849,366,2,898,116,1014,3807,2021-01-25 23:44:04
3850,814,3,927,120,1047,3808,2021-01-26 14:12:52
3851,445,3,558,72,630,3809,2021-01-26 02:51:08
3852,573,2,928,120,1048,3810,2021-01-25 15:49:00
3853,846,3,927,120,1047,3811,2021-01-25 03:22:01
3854,889,3,758,98,856,3812,2021-01-25 06:41:48
3855,111,2,798,103,901,3813,2021-01-25 07:14:20
3856,862,2,459,59,518,3814,2021-01-25 08:09:25
3857,817,3,758,98,856,3815,2021-01-25 06:43:04
3858,44,3,808,105,913,3816,2021-01-25 15:22:55
3859,800,3,1127,146,1273,3817,2021-01-25 12:21:01
3860,348,3,847,110,957,3818,2021-01-25 11:44:16
3861,38,2,429,55,484,3819,2021-01-25 13:01:34
3862,912,1,499,64,563,3820,2021-01-25 12:19:44
3863,15,3,847,110,957,3821,2021-01-25 18:15:58
3864,868,3,1047,136,1183,3822,2021-01-25 02:52:45
3865,868,3,1047,136,1183,3822,2021-01-25 02:52:45
3866,100,1,229,29,258,3823,2021-01-25 04:51:15
3867,195,3,1127,146,1273,3824,2021-01-25 15:10:59
3868,319,3,827,107,934,3825,2021-01-25 12:29:33
3869,841,3,997,129,1126,3826,2021-01-25 09:21:01
3870,292,3,428,55,483,3827,2021-01-24 22:38:44
3871,855,2,848,110,958,3828,2021-01-24 07:02:54
3872,866,2,598,77,675,3829,2021-01-24 13:42:50
3873,717,3,727,94,821,3830,2021-01-24 13:59:23
3874,688,5,1576,204,1780,3831,2021-01-24 12:00:52
3875,678,3,597,77,674,3832,2021-01-24 15:53:55
3876,320,5,1906,247,2153,3833,2021-01-24 17:53:13
3877,312,3,827,107,934,3834,2021-01-25 04:00:48
3878,523,3,1247,162,1409,3835,2021-01-25 03:06:59
3879,134,1,599,77,676,3836,2021-01-25 10:26:14
3880,590,3,597,77,674,3837,2021-01-24 19:08:41
3881,191,3,827,107,934,3838,2021-01-24 18:39:14
3882,450,3,1247,162,1409,3839,2021-01-25 05:13:02
3883,680,5,1545,200,1745,3840,2021-01-26 09:13:50
3884,98,2,329,42,371,3841,2021-01-25 22:44:17
3885,607,3,997,129,1126,3842,2021-01-25 17:15:00
3886,222,3,1247,162,1409,3843,2021-01-25 17:40:17
3887,57,2,898,116,1014,3844,2021-01-26 07:10:52
3888,90,2,828,107,935,3845,2021-01-26 02:38:30
3889,797,3,747,97,844,3846,2021-01-25 19:49:36
3890,723,3,647,84,731,3847,2021-01-26 01:49:53
3891,673,3,827,107,934,3848,2021-01-26 08:52:29
3892,340,3,827,107,934,3849,2021-01-26 12:53:42
3893,809,2,659,85,744,3850,2021-01-26 15:44:50
3894,141,2,498,64,562,3851,2021-01-26 00:30:56
3895,426,3,478,62,540,3852,2021-01-26 15:14:15
3896,206,5,1745,226,1971,3853,2021-01-26 04:53:41
3897,855,2,659,85,744,3854,2021-01-25 18:24:00
3898,658,3,647,84,731,3855,2021-01-25 05:25:41
3899,250,2,698,90,788,3856,2021-01-25 07:06:12
3900,927,5,1656,215,1871,3857,2021-01-25 08:19:55
3901,710,3,947,123,1070,3858,2021-01-25 08:53:59
3902,747,2,898,116,1014,3859,2021-01-25 07:41:56
3903,456,3,1127,146,1273,3860,2021-01-25 16:57:09
3904,991,2,498,64,562,3861,2021-01-25 13:29:05
3905,532,5,1225,159,1384,3862,2021-01-25 13:16:13
3906,713,1,699,90,789,3863,2021-01-25 15:18:13
3907,381,3,688,89,777,3864,2021-01-25 12:45:35
3908,397,2,659,85,744,3865,2021-01-25 20:51:55
3909,603,3,1127,146,1273,3866,2021-01-25 05:07:51
3910,34,2,648,84,732,3867,2021-01-25 03:12:45
3911,458,6,1155,150,1305,3868,2021-01-25 05:34:08
3912,310,3,727,94,821,3869,2021-01-25 16:42:59
3913,483,4,1546,200,1746,3870,2021-01-25 13:09:41
3914,213,2,698,90,788,3871,2021-01-25 11:45:31
3915,826,1,499,64,563,3872,2021-01-24 23:25:11
3916,94,3,997,129,1126,3873,2021-01-24 09:18:14
3917,199,5,1645,213,1858,3874,2021-01-24 14:54:27
3918,834,2,598,77,675,3875,2021-01-24 15:03:57
3919,807,3,727,94,821,3876,2021-01-24 14:30:28
3920,922,3,697,90,787,3877,2021-01-24 18:19:50
3921,35,2,698,90,788,3878,2021-01-24 19:59:23
3922,741,2,459,59,518,3879,2021-01-25 06:25:51
3923,27,2,698,90,788,3880,2021-01-25 04:21:27
3924,346,3,597,77,674,3881,2021-01-25 12:12:30
3925,561,3,847,110,957,3882,2021-01-24 19:25:26
3926,467,2,1098,142,1240,3883,2021-01-24 20:34:08
3927,134,5,1306,169,1475,3884,2021-01-25 05:39:23
3928,462,5,1695,220,1915,3885,2021-01-26 11:55:00
3929,215,5,1217,158,1375,3886,2021-01-26 01:02:02
3930,103,3,997,129,1126,3887,2021-01-25 17:21:59
3931,899,2,698,90,788,3888,2021-01-25 19:01:11
3932,500,3,727,94,821,3889,2021-01-26 08:38:31
3933,942,5,1195,155,1350,3890,2021-01-26 04:07:36
3934,851,3,428,55,483,3891,2021-01-25 20:58:10
3935,614,3,697,90,787,3892,2021-01-26 03:55:27
3936,748,1,599,77,676,3893,2021-01-26 11:05:47
3937,898,3,647,84,731,3894,2021-01-26 15:18:32
3938,640,3,847,110,957,3895,2021-01-26 15:59:15
3939,256,5,1356,176,1532,3896,2021-01-26 01:03:36
3940,671,2,598,77,675,3897,2021-01-26 16:48:31
3941,754,3,697,90,787,3898,2021-01-26 06:27:22
3942,256,6,1644,213,1857,3899,2021-01-25 19:13:59
3943,191,3,1127,146,1273,3900,2021-01-25 06:15:08
3944,866,2,598,77,675,3901,2021-01-25 07:35:03
3945,41,3,847,110,957,3902,2021-01-25 08:47:37
3946,895,5,1495,194,1689,3903,2021-01-25 11:08:08
3947,93,2,698,90,788,3904,2021-01-25 10:11:34
3948,569,3,1247,162,1409,3905,2021-01-25 18:10:20
3949,206,1,229,29,258,3906,2021-01-25 16:13:04
3950,150,3,1027,133,1160,3907,2021-01-25 14:17:27
3951,639,2,598,77,675,3908,2021-01-25 16:22:23
3952,952,3,1047,136,1183,3909,2021-01-25 15:24:57
3953,957,2,429,55,484,3910,2021-01-25 22:27:50
3954,649,3,808,105,913,3911,2021-01-25 06:12:14
3955,143,2,329,42,371,3912,2021-01-25 03:26:37
3956,244,4,1396,181,1577,3913,2021-01-25 06:12:47
3957,101,2,598,77,675,3914,2021-01-25 19:28:14
3958,68,3,1327,172,1499,3915,2021-01-25 15:03:52
3959,464,3,888,115,1003,3916,2021-01-25 14:25:56
3960,188,3,888,115,1003,3917,2021-01-24 23:48:28
3961,201,3,1327,172,1499,3918,2021-01-24 10:15:05
3962,578,3,597,77,674,3919,2021-01-24 17:14:50
3963,721,5,1476,191,1667,3920,2021-01-24 16:52:04
3964,407,3,558,72,630,3921,2021-01-24 16:10:13
3965,866,3,747,97,844,3922,2021-01-24 20:05:07
3966,316,5,1486,193,1679,3923,2021-01-24 20:00:23
3967,141,3,597,77,674,3924,2021-01-25 06:33:39
3968,790,5,1376,178,1554,3925,2021-01-25 06:39:45
3969,33,1,399,51,450,3926,2021-01-25 12:19:54
3970,598,3,1127,146,1273,3927,2021-01-24 19:30:48
3971,706,2,898,116,1014,3928,2021-01-24 20:44:13
3972,973,3,558,72,630,3929,2021-01-25 08:01:08
3973,711,1,499,64,563,3930,2021-01-26 14:34:22
3974,816,2,459,59,518,3931,2021-01-26 02:38:20
3975,757,3,428,55,483,3932,2021-01-25 18:29:21
3976,184,2,329,42,371,3933,2021-01-25 20:46:22
3977,510,3,747,97,844,3934,2021-01-26 10:29:42
3978,592,3,1127,146,1273,3935,2021-01-26 04:48:05
3979,613,2,898,116,1014,3936,2021-01-25 22:55:04
3980,769,3,597,77,674,3937,2021-01-26 05:20:54
3981,694,3,797,103,900,3938,2021-01-26 11:56:28
3982,625,2,898,116,1014,3939,2021-01-26 15:27:30
3983,447,3,1247,162,1409,3940,2021-01-26 16:47:43
3984,223,3,1197,155,1352,3941,2021-01-26 01:51:36
3985,443,5,1226,159,1385,3942,2021-01-26 17:42:15
3986,910,3,697,90,787,3943,2021-01-26 07:52:35
3987,476,2,498,64,562,3944,2021-01-25 21:04:05
3988,29,5,1456,189,1645,3945,2021-01-25 08:00:50
3989,219,2,429,55,484,3946,2021-01-25 08:48:56
3990,108,5,2425,315,2740,3947,2021-01-25 11:03:58
3991,647,2,598,77,675,3948,2021-01-25 11:23:06
3992,860,3,528,68,596,3949,2021-01-25 10:22:35
3993,550,2,659,85,744,3950,2021-01-25 18:35:02
3994,588,2,598,77,675,3951,2021-01-25 17:44:47
3995,478,3,1247,162,1409,3952,2021-01-25 17:03:11
3996,932,2,548,71,619,3953,2021-01-25 18:36:34
3997,521,3,1327,172,1499,3954,2021-01-25 16:57:18
3998,194,3,758,98,856,3955,2021-01-25 23:13:25
3999,840,3,747,97,844,3956,2021-01-25 08:40:58
4000,855,3,727,94,821,3957,2021-01-25 05:04:56
4001,56,3,428,55,483,3958,2021-01-25 07:36:26
4002,900,3,727,94,821,3959,2021-01-25 19:36:51
4003,10,3,608,79,687,3960,2021-01-25 15:20:28
4004,502,2,898,116,1014,3961,2021-01-25 16:14:31
4005,705,3,597,77,674,3962,2021-01-25 00:17:01
4006,859,3,647,84,731,3963,2021-01-24 12:04:29
4007,115,2,329,42,371,3964,2021-01-24 18:23:31
4008,127,2,698,90,788,3965,2021-01-24 18:49:04
4009,238,3,1197,155,1352,3966,2021-01-24 18:40:18
4010,967,3,1327,172,1499,3967,2021-01-24 22:11:10
4011,992,2,598,77,675,3968,2021-01-24 22:41:31
4012,824,2,698,90,788,3969,2021-01-25 08:08:18
4013,372,3,827,107,934,3970,2021-01-25 07:09:38
4014,610,3,578,75,653,3971,2021-01-25 13:46:04
4015,182,2,329,42,371,3972,2021-01-24 20:23:31
4016,743,3,647,84,731,3973,2021-01-24 22:38:40
4017,175,3,947,123,1070,3974,2021-01-25 08:12:26
4018,816,1,149,19,168,3975,2021-01-26 14:52:31
4019,876,4,1446,187,1633,3976,2021-01-26 04:10:56
4020,7,2,598,77,675,3977,2021-01-25 18:31:47
4021,256,5,1295,168,1463,3978,2021-01-25 21:55:04
4022,1000,3,697,90,787,3979,2021-01-26 11:39:21
4023,595,2,598,77,675,3980,2021-01-26 07:15:43
4024,537,2,329,42,371,3981,2021-01-25 23:54:35
4025,135,2,459,59,518,3982,2021-01-26 05:57:25
4026,410,3,688,89,777,3983,2021-01-26 12:22:26
4027,223,2,659,85,744,3984,2021-01-26 17:06:20
4028,983,2,329,42,371,3985,2021-01-26 17:05:38
4029,716,2,798,103,901,3986,2021-01-26 02:32:56
4030,917,3,1197,155,1352,3987,2021-01-26 18:14:57
4031,570,3,1047,136,1183,3988,2021-01-26 09:04:56
4032,176,3,597,77,674,3989,2021-01-25 22:37:06
4033,422,2,429,55,484,3990,2021-01-25 09:47:15
4034,255,3,558,72,630,3991,2021-01-25 10:43:39
4035,992,3,997,129,1126,3992,2021-01-25 12:12:52
4036,440,3,558,72,630,3993,2021-01-25 13:23:57
4037,570,2,598,77,675,3994,2021-01-25 12:30:18
4038,834,2,798,103,901,3995,2021-01-25 19:19:30
4039,433,3,997,129,1126,3996,2021-01-25 20:28:21
4040,557,2,1098,142,1240,3997,2021-01-25 17:14:53
4041,982,3,758,98,856,3998,2021-01-25 20:55:46
4042,349,5,1525,198,1723,3999,2021-01-25 19:13:57
4043,860,3,597,77,674,4000,2021-01-26 01:59:50
4044,748,5,1395,181,1576,4001,2021-01-25 10:16:16
4045,289,3,428,55,483,4002,2021-01-25 05:18:41
4046,219,2,898,116,1014,4003,2021-01-25 09:58:18
4047,998,4,877,114,991,4004,2021-01-25 21:35:12
4048,251,5,1376,178,1554,4005,2021-01-25 16:30:44
4049,305,3,1247,162,1409,4006,2021-01-25 16:44:16
4050,937,3,478,62,540,4007,2021-01-25 01:31:36
4051,466,4,1356,176,1532,4008,2021-01-24 13:29:15
4052,119,6,2044,265,2309,4009,2021-01-24 20:27:48
4053,65,3,1247,162,1409,4010,2021-01-24 21:34:33
4054,355,2,628,81,709,4011,2021-01-24 19:14:33
4055,368,3,997,129,1126,4012,2021-01-25 00:20:18
4056,407,2,659,85,744,4013,2021-01-24 23:24:18
4057,212,2,498,64,562,4014,2021-01-25 09:52:56
4058,815,2,698,90,788,4015,2021-01-25 08:40:03
4059,989,3,688,89,777,4016,2021-01-25 14:11:33
4060,337,2,598,77,675,4017,2021-01-24 21:29:02
4061,471,3,1327,172,1499,4018,2021-01-25 00:56:39
4062,194,5,1525,198,1723,4019,2021-01-25 09:02:11
4063,402,3,827,107,934,4020,2021-01-26 16:13:55
4064,712,6,1325,172,1497,4021,2021-01-26 06:09:16
4065,14,3,697,90,787,4022,2021-01-25 20:18:27
4066,708,2,498,64,562,4023,2021-01-25 22:07:39
4067,520,1,99,12,111,4024,2021-01-26 12:06:56
4068,123,1,599,77,676,4025,2021-01-26 08:57:48
4069,614,1,99,12,111,4026,2021-01-26 00:18:05
4070,534,2,459,59,518,4027,2021-01-26 07:06:56
4071,445,1,599,77,676,4028,2021-01-26 12:26:48
4072,178,3,578,75,653,4029,2021-01-26 17:38:02
4073,418,2,448,58,506,4030,2021-01-26 18:37:27
4074,17,5,1406,182,1588,4031,2021-01-26 05:08:05
4075,83,3,1247,162,1409,4032,2021-01-26 20:02:16
4076,299,2,598,77,675,4033,2021-01-26 09:39:46
4077,414,3,947,123,1070,4034,2021-01-25 23:22:10
4078,675,3,847,110,957,4035,2021-01-25 11:21:19
4079,675,3,847,110,957,4035,2021-01-25 11:21:19
4080,727,3,947,123,1070,4036,2021-01-25 10:46:30
4081,916,3,927,120,1047,4037,2021-01-25 14:53:36
4082,501,3,608,79,687,4038,2021-01-25 15:28:34
4083,934,3,558,72,630,4039,2021-01-25 14:12:42
4084,340,5,1295,168,1463,4040,2021-01-25 19:32:51
4085,81,3,927,120,1047,4041,2021-01-25 22:33:21
4086,657,3,1247,162,1409,4042,2021-01-25 18:31:40
4087,679,3,558,72,630,4043,2021-01-25 23:34:27
4088,188,4,1826,237,2063,4044,2021-01-25 20:25:55
4089,688,2,329,42,371,4045,2021-01-26 02:09:32
4090,506,3,558,72,630,4046,2021-01-25 10:50:32
4091,588,3,758,98,856,4047,2021-01-25 06:03:52
4092,769,5,1156,150,1306,4048,2021-01-25 11:42:11
4093,603,3,608,79,687,4049,2021-01-26 00:01:09
4094,45,2,798,103,901,4050,2021-01-25 17:39:18
4095,67,3,528,68,596,4051,2021-01-25 18:12:57
4096,375,3,597,77,674,4052,2021-01-25 03:13:45
4097,319,3,528,68,596,4053,2021-01-24 14:39:01
4098,735,5,1625,211,1836,4054,2021-01-24 22:37:14
4099,736,2,329,42,371,4055,2021-01-24 22:59:22
4100,441,2,698,90,788,4056,2021-01-24 21:37:47
4101,22,3,947,123,1070,4057,2021-01-25 00:23:52
4102,178,5,1586,206,1792,4058,2021-01-25 01:24:31
4103,257,3,558,72,630,4059,2021-01-25 10:10:24
4104,963,1,699,90,789,4060,2021-01-25 09:22:51
4105,125,3,827,107,934,4061,2021-01-25 14:37:43
4106,131,3,797,103,900,4062,2021-01-24 23:42:52
4107,603,2,459,59,518,4063,2021-01-25 02:52:11
4108,81,3,1047,136,1183,4064,2021-01-25 11:16:39
4109,596,3,578,75,653,4065,2021-01-26 17:35:43
4110,590,3,578,75,653,4066,2021-01-26 08:29:29
4111,279,3,558,72,630,4067,2021-01-25 20:19:05
4112,359,2,598,77,675,4068,2021-01-26 00:08:28
4113,597,2,429,55,484,4069,2021-01-26 12:42:00
4114,496,3,997,129,1126,4070,2021-01-26 10:44:54
4115,299,3,608,79,687,4071,2021-01-26 00:44:57
4116,901,2,1098,142,1240,4072,2021-01-26 07:43:44
4117,287,3,747,97,844,4073,2021-01-26 12:35:49
4118,724,3,1047,136,1183,4074,2021-01-26 18:27:01
4119,468,3,697,90,787,4075,2021-01-26 19:56:46
4120,609,2,598,77,675,4076,2021-01-26 07:12:43
4121,101,3,827,107,934,4077,2021-01-26 21:09:29
4122,554,6,1524,198,1722,4078,2021-01-26 09:53:57
4123,98,3,997,129,1126,4079,2021-01-26 00:51:37
4124,175,3,1197,155,1352,4080,2021-01-25 11:29:35
4125,652,3,428,55,483,4081,2021-01-25 13:46:11
4126,482,2,659,85,744,4082,2021-01-25 11:54:35
4127,650,3,947,123,1070,4083,2021-01-25 16:54:31
4128,404,3,888,115,1003,4084,2021-01-25 17:20:40
4129,230,3,478,62,540,4085,2021-01-25 14:55:06
4130,641,3,758,98,856,4086,2021-01-25 20:21:59
4131,544,2,598,77,675,4087,2021-01-26 00:35:12
4132,744,3,1197,155,1352,4088,2021-01-25 20:03:46
4133,766,3,1127,146,1273,4089,2021-01-26 00:30:07
4134,404,3,947,123,1070,4090,2021-01-25 20:28:53
4135,270,3,727,94,821,4091,2021-01-26 02:32:48
4136,449,3,1197,155,1352,4092,2021-01-25 11:31:05
4137,586,3,647,84,731,4093,2021-01-25 08:08:32
4138,548,3,888,115,1003,4094,2021-01-25 12:30:51
4139,292,3,797,103,900,4095,2021-01-26 01:07:49
4140,471,5,2075,269,2344,4096,2021-01-25 19:20:25
4141,289,2,459,59,518,4097,2021-01-25 18:26:16
4142,637,3,428,55,483,4098,2021-01-25 04:45:30
4143,187,3,1197,155,1352,4099,2021-01-24 16:03:07
4144,214,2,598,77,675,4100,2021-01-24 23:01:52
4145,95,5,1845,239,2084,4101,2021-01-25 00:30:52
4146,298,2,648,84,732,4102,2021-01-24 22:06:33
4147,989,3,688,89,777,4103,2021-01-25 02:16:52
4148,523,3,1327,172,1499,4104,2021-01-25 03:30:13
4149,111,3,997,129,1126,4105,2021-01-25 11:58:17
4150,435,3,697,90,787,4106,2021-01-25 10:38:32
4151,518,2,1098,142,1240,4107,2021-01-25 16:46:18
4152,499,2,698,90,788,4108,2021-01-25 01:38:42
4153,901,2,898,116,1014,4109,2021-01-25 04:45:26
4154,164,3,1047,136,1183,4110,2021-01-25 13:44:52
4155,113,2,898,116,1014,4111,2021-01-26 18:29:10
4156,677,3,1127,146,1273,4112,2021-01-26 09:55:43
4157,237,3,578,75,653,4113,2021-01-25 21:41:44
4158,287,3,608,79,687,4114,2021-01-26 01:23:09
4159,987,2,659,85,744,4115,2021-01-26 13:47:25
4160,307,2,898,116,1014,4116,2021-01-26 13:09:43
4161,942,6,1725,224,1949,4117,2021-01-26 01:00:59
4162,111,3,827,107,934,4118,2021-01-26 09:21:25
4163,119,3,797,103,900,4119,2021-01-26 14:32:19
4164,930,2,698,90,788,4120,2021-01-26 20:57:03
4165,214,2,698,90,788,4121,2021-01-26 20:56:11
4166,773,5,1286,167,1453,4122,2021-01-26 07:58:29
4167,119,2,498,64,562,4123,2021-01-26 22:36:28
4168,972,2,429,55,484,4124,2021-01-26 11:13:52
4169,227,3,927,120,1047,4125,2021-01-26 03:21:52
4170,232,1,229,29,258,4126,2021-01-25 12:40:02
4171,708,3,578,75,653,4127,2021-01-25 14:22:59
4172,266,6,1505,195,1700,4128,2021-01-25 11:55:05
4173,438,3,927,120,1047,4129,2021-01-25 18:00:38
4174,472,3,947,123,1070,4130,2021-01-25 18:39:24
4175,510,2,329,42,371,4131,2021-01-25 16:18:03
4176,563,3,1047,136,1183,4132,2021-01-25 21:18:16
4177,591,3,658,85,743,4133,2021-01-26 01:41:57
4178,829,3,697,90,787,4134,2021-01-25 21:39:06
4179,645,3,1247,162,1409,4135,2021-01-26 01:58:55
4180,645,3,1247,162,1409,4135,2021-01-26 01:58:55
4181,878,3,888,115,1003,4136,2021-01-25 20:55:32
4182,265,3,1327,172,1499,4137,2021-01-26 03:35:51
4183,92,5,1295,168,1463,4138,2021-01-25 12:44:17
4184,273,3,1327,172,1499,4139,2021-01-25 10:04:34
4185,689,3,747,97,844,4140,2021-01-25 15:04:40
4186,639,3,428,55,483,4141,2021-01-26 01:56:48
4187,229,3,428,55,483,4142,2021-01-25 20:43:48
4188,535,3,747,97,844,4143,2021-01-25 19:08:36
4189,742,3,478,62,540,4144,2021-01-25 05:03:19
4190,621,2,598,77,675,4145,2021-01-24 18:33:42
4191,653,2,698,90,788,4146,2021-01-24 23:45:01
4192,716,3,827,107,934,4147,2021-01-25 00:59:28
4193,756,3,647,84,731,4148,2021-01-24 22:08:05
4194,484,3,847,110,957,4149,2021-01-25 03:36:26
4195,320,2,448,58,506,4150,2021-01-25 05:05:55
4196,703,2,398,51,449,4151,2021-01-25 14:25:24
4197,9,3,688,89,777,4152,2021-01-25 13:09:24
4198,539,3,597,77,674,4153,2021-01-25 19:25:11
4199,810,5,1545,200,1745,4154,2021-01-25 03:26:14
4200,398,3,697,90,787,4155,2021-01-25 06:45:08
4201,109,5,1556,202,1758,4156,2021-01-25 15:11:00
4202,994,3,1247,162,1409,4157,2021-01-26 18:42:46
4203,293,3,1247,162,1409,4158,2021-01-26 11:28:23
4204,742,2,598,77,675,4159,2021-01-25 21:50:45
4205,554,3,1027,133,1160,4160,2021-01-26 02:51:19
4206,626,3,758,98,856,4161,2021-01-26 16:18:12
4207,417,3,597,77,674,4162,2021-01-26 15:22:46
4208,632,3,1127,146,1273,4163,2021-01-26 01:48:09
4209,236,5,1506,195,1701,4164,2021-01-26 10:22:54
4210,504,5,1625,211,1836,4165,2021-01-26 17:04:32
4211,568,4,1326,172,1498,4166,2021-01-26 22:10:54
4212,353,3,647,84,731,4167,2021-01-26 22:21:08
4213,758,2,448,58,506,4168,2021-01-26 10:13:10
4214,625,3,697,90,787,4169,2021-01-26 23:53:59
4215,323,3,1197,155,1352,4170,2021-01-26 12:49:37
4216,71,3,1327,172,1499,4171,2021-01-26 04:43:52
4217,358,3,997,129,1126,4172,2021-01-25 15:07:54
4218,534,2,928,120,1048,4173,2021-01-25 14:49:28
4219,198,3,897,116,1013,4174,2021-01-25 14:22:43
4220,577,5,1545,200,1745,4175,2021-01-25 19:02:15
4221,862,3,827,107,934,4176,2021-01-25 20:56:43
4222,616,3,1127,146,1273,4177,2021-01-25 18:05:13
4223,214,2,898,116,1014,4178,2021-01-25 23:59:38
4224,972,1,149,19,168,4179,2021-01-26 02:17:27
4225,862,3,1047,136,1183,4180,2021-01-26 00:11:35
4226,124,3,528,68,596,4181,2021-01-26 02:45:09
4227,294,3,847,110,957,4182,2021-01-26 04:00:39
4228,981,5,1345,174,1519,4183,2021-01-25 23:09:36
4229,904,2,628,81,709,4184,2021-01-26 05:14:26
4230,178,3,1127,146,1273,4185,2021-01-25 12:57:25
4231,483,3,1127,146,1273,4186,2021-01-25 12:26:44
4232,948,3,558,72,630,4187,2021-01-25 16:01:11
4233,36,2,659,85,744,4188,2021-01-26 02:31:10
4234,520,3,558,72,630,4189,2021-01-25 22:54:13
4235,519,3,827,107,934,4190,2021-01-25 19:56:09
4236,740,2,598,77,675,4191,2021-01-25 05:15:26
4237,626,2,498,64,562,4192,2021-01-24 19:59:14
4238,24,3,758,98,856,4193,2021-01-25 00:48:57
4239,102,2,1098,142,1240,4194,2021-01-25 03:22:42
4240,466,3,827,107,934,4195,2021-01-25 00:44:39
4241,517,6,1485,193,1678,4196,2021-01-25 06:19:23
4242,517,6,1485,193,1678,4196,2021-01-25 06:19:23
4243,154,1,229,29,258,4197,2021-01-25 06:22:18
4244,409,1,499,64,563,4198,2021-01-25 15:01:35
4245,375,3,597,77,674,4199,2021-01-25 15:29:28
4246,6,3,428,55,483,4200,2021-01-25 20:16:16
4247,401,1,149,19,168,4201,2021-01-25 05:01:34
4248,977,3,1247,162,1409,4202,2021-01-25 06:57:07
4249,661,1,599,77,676,4203,2021-01-25 16:41:47
4250,179,3,1127,146,1273,4204,2021-01-26 19:08:00
4251,840,3,888,115,1003,4205,2021-01-26 13:52:22
4252,829,3,827,107,934,4206,2021-01-25 22:14:38
4253,674,2,898,116,1014,4207,2021-01-26 03:38:06
4254,710,3,597,77,674,4208,2021-01-26 17:15:50
4255,602,3,1127,146,1273,4209,2021-01-26 18:00:58
4256,741,3,558,72,630,4210,2021-01-26 03:54:05
4257,414,5,926,120,1046,4211,2021-01-26 11:35:25
4258,571,2,798,103,901,4212,2021-01-26 17:56:17
4259,261,2,598,77,675,4213,2021-01-26 23:12:27
4260,286,2,798,103,901,4214,2021-01-26 23:44:48
4261,996,2,548,71,619,4215,2021-01-26 11:36:34
4262,601,2,828,107,935,4216,2021-01-27 02:16:59
4263,552,3,1197,155,1352,4217,2021-01-26 15:04:37
4264,84,3,528,68,596,4218,2021-01-26 06:48:40
4265,295,2,659,85,744,4219,2021-01-25 15:30:41
4266,19,3,608,79,687,4220,2021-01-25 15:31:52
4267,649,3,727,94,821,4221,2021-01-25 14:47:20
4268,791,2,898,116,1014,4222,2021-01-25 20:05:37
4269,604,1,99,12,111,4223,2021-01-25 21:13:02
4270,462,2,1098,142,1240,4224,2021-01-25 18:44:02
4271,975,5,1716,223,1939,4225,2021-01-26 01:00:29
4272,72,2,329,42,371,4226,2021-01-26 02:49:16
4273,439,3,1027,133,1160,4227,2021-01-26 01:02:57
4274,781,3,1047,136,1183,4228,2021-01-26 03:09:01
4275,576,2,329,42,371,4229,2021-01-26 04:59:23
4276,440,2,329,42,371,4230,2021-01-25 23:40:45
4277,501,2,898,116,1014,4231,2021-01-26 06:00:59
4278,623,3,428,55,483,4232,2021-01-25 15:17:02
4279,945,4,1546,200,1746,4233,2021-01-25 13:19:08
4280,594,3,847,110,957,4234,2021-01-25 17:54:57
4281,453,3,1247,162,1409,4235,2021-01-26 03:10:00
4282,436,4,1157,150,1307,4236,2021-01-25 23:44:58
4283,145,3,578,75,653,4237,2021-01-25 20:24:32
4284,415,5,1795,233,2028,4238,2021-01-25 05:33:23
4285,129,3,747,97,844,4239,2021-01-24 22:43:11
4286,386,3,428,55,483,4240,2021-01-25 00:57:41
4287,505,1,149,19,168,4241,2021-01-25 05:35:32
4288,169,4,1307,169,1476,4242,2021-01-25 01:18:33
4289,224,2,898,116,1014,4243,2021-01-25 09:01:46
4290,680,6,1525,198,1723,4244,2021-01-25 07:01:07
4291,773,3,1127,146,1273,4245,2021-01-25 06:35:27
4292,292,3,688,89,777,4246,2021-01-25 17:28:58
4293,259,3,1127,146,1273,4247,2021-01-25 15:31:25
4294,525,3,1047,136,1183,4248,2021-01-25 20:54:55
4295,442,2,429,55,484,4249,2021-01-25 05:43:03
4296,265,3,808,105,913,4250,2021-01-25 09:08:20
4297,424,2,798,103,901,4251,2021-01-25 17:55:19
4298,973,3,597,77,674,4252,2021-01-26 21:47:59
4299,284,3,1027,133,1160,4253,2021-01-26 15:03:19
4300,455,3,827,107,934,4254,2021-01-26 00:24:49
4301,730,3,428,55,483,4255,2021-01-26 03:58:43
4302,805,4,707,91,798,4256,2021-01-26 18:57:36
4303,357,2,429,55,484,4257,2021-01-26 18:40:08
4304,247,3,947,123,1070,4258,2021-01-26 04:19:37
4305,596,2,329,42,371,4259,2021-01-26 13:54:11
4306,327,5,887,115,1002,4260,2021-01-26 19:07:11
4307,409,3,558,72,630,4261,2021-01-27 00:46:43
4308,59,2,498,64,562,4262,2021-01-27 02:25:00
4309,59,2,498,64,562,4262,2021-01-27 02:25:00
4310,312,3,688,89,777,4263,2021-01-26 12:38:00
4311,953,2,429,55,484,4264,2021-01-27 04:11:14
4312,229,2,598,77,675,4265,2021-01-26 17:46:26
4313,362,5,1475,191,1666,4266,2021-01-26 09:30:49
4314,976,1,699,90,789,4267,2021-01-25 17:34:52
4315,766,2,898,116,1014,4268,2021-01-25 17:30:54
4316,255,3,688,89,777,4269,2021-01-25 16:10:05
4317,737,3,727,94,821,4270,2021-01-25 20:11:55
4318,794,2,498,64,562,4271,2021-01-25 22:13:33
4319,869,2,598,77,675,4272,2021-01-25 20:02:52
4320,265,3,1047,136,1183,4273,2021-01-26 01:55:06
4321,853,6,1494,194,1688,4274,2021-01-26 04:31:43
4322,465,3,927,120,1047,4275,2021-01-26 03:37:28
4323,812,2,898,116,1014,4276,2021-01-26 04:29:09
4324,364,2,329,42,371,4277,2021-01-26 07:22:56
4325,563,2,698,90,788,4278,2021-01-26 01:31:56
4326,852,3,747,97,844,4279,2021-01-26 06:50:47
4327,626,3,997,129,1126,4280,2021-01-25 16:58:53
4328,191,3,747,97,844,4281,2021-01-25 13:22:33
4329,657,1,699,90,789,4282,2021-01-25 20:27:03
4330,27,3,1127,146,1273,4283,2021-01-26 04:31:58
4331,837,5,1425,185,1610,4284,2021-01-26 01:21:30
4332,837,3,727,94,821,4285,2021-01-25 21:52:25
4333,510,3,647,84,731,4286,2021-01-25 06:06:51
4334,969,2,898,116,1014,4287,2021-01-24 23:33:12
4335,530,2,548,71,619,4288,2021-01-25 02:58:00
4336,355,3,997,129,1126,4289,2021-01-25 07:54:03
4337,181,3,558,72,630,4290,2021-01-25 02:17:24
4338,869,2,598,77,675,4291,2021-01-25 11:43:02
4339,649,3,478,62,540,4292,2021-01-25 08:59:26
4340,466,3,827,107,934,4293,2021-01-25 07:48:29
4341,841,1,399,51,450,4294,2021-01-25 18:33:48
4342,835,2,498,64,562,4295,2021-01-25 16:36:57
4343,963,3,478,62,540,4296,2021-01-25 21:53:58
4344,573,3,528,68,596,4297,2021-01-25 07:24:10
4345,448,3,897,116,1013,4298,2021-01-25 11:22:53
4346,307,3,927,120,1047,4299,2021-01-25 19:56:36
4347,434,2,898,116,1014,4300,2021-01-26 22:24:13
4348,557,3,578,75,653,4301,2021-01-26 17:02:12
4349,996,3,747,97,844,4302,2021-01-26 00:54:10
4350,102,3,747,97,844,4303,2021-01-26 06:31:23
4351,967,5,1725,224,1949,4304,2021-01-26 20:17:13
4352,286,3,997,129,1126,4305,2021-01-26 19:24:23
4353,802,4,996,129,1125,4306,2021-01-26 06:19:43
4354,860,3,608,79,687,4307,2021-01-26 15:12:50
4355,512,2,698,90,788,4308,2021-01-26 19:53:33
4356,2,4,1557,202,1759,4309,2021-01-27 01:51:52
4357,414,3,1027,133,1160,4310,2021-01-27 02:58:47
4358,97,2,698,90,788,4311,2021-01-27 02:34:22
4359,915,3,597,77,674,4312,2021-01-26 14:28:48
4360,249,2,598,77,675,4313,2021-01-27 05:46:48
4361,269,2,659,85,744,4314,2021-01-26 18:43:17
4362,345,3,697,90,787,4315,2021-01-26 09:49:06
4363,158,1,399,51,450,4316,2021-01-25 17:45:33
4364,527,3,888,115,1003,4317,2021-01-25 19:13:34
4365,19,5,2095,272,2367,4318,2021-01-25 17:39:13
4366,9,3,1327,172,1499,4319,2021-01-25 20:36:14
4367,767,3,797,103,900,4320,2021-01-25 23:00:39
4368,462,3,897,116,1013,4321,2021-01-25 22:18:54
4369,68,2,898,116,1014,4322,2021-01-26 03:15:04
4370,250,3,1027,133,1160,4323,2021-01-26 04:52:09
4371,475,5,2175,282,2457,4324,2021-01-26 04:54:08
4372,373,3,697,90,787,4325,2021-01-26 05:19:16
4373,331,1,299,38,337,4326,2021-01-26 09:41:44
4374,98,5,1656,215,1871,4327,2021-01-26 03:36:13
4375,763,3,947,123,1070,4328,2021-01-26 08:33:14
4376,302,2,498,64,562,4329,2021-01-25 17:37:44
4377,496,3,747,97,844,4330,2021-01-25 14:26:47
4378,333,2,459,59,518,4331,2021-01-25 22:44:36
4379,852,3,528,68,596,4332,2021-01-26 06:06:51
4380,105,2,329,42,371,4333,2021-01-26 02:39:27
4381,990,2,498,64,562,4334,2021-01-25 23:51:53
4382,448,2,798,103,901,4335,2021-01-25 07:43:27
4383,338,2,548,71,619,4336,2021-01-25 02:15:22
4384,769,3,897,116,1013,4337,2021-01-25 04:40:48
4385,97,3,608,79,687,4338,2021-01-25 09:40:15
4386,884,3,1047,136,1183,4339,2021-01-25 04:15:09
4387,123,3,658,85,743,4340,2021-01-25 12:44:37
4388,774,3,847,110,957,4341,2021-01-25 11:42:18
4389,978,3,927,120,1047,4342,2021-01-25 09:02:57
4390,961,2,659,85,744,4343,2021-01-25 19:54:47
4391,829,5,1056,137,1193,4344,2021-01-25 17:54:21
4392,372,5,1495,194,1689,4345,2021-01-25 22:12:13
4393,803,3,747,97,844,4346,2021-01-25 09:23:34
4394,665,5,1676,217,1893,4347,2021-01-25 13:45:46
4395,229,2,498,64,562,4348,2021-01-25 22:15:19
4396,23,3,1047,136,1183,4349,2021-01-26 23:02:01
4397,697,3,1047,136,1183,4350,2021-01-26 18:51:30
4398,964,2,848,110,958,4351,2021-01-26 02:10:55
4399,949,3,647,84,731,4352,2021-01-26 08:25:44
4400,899,5,1156,150,1306,4353,2021-01-26 20:29:58
4401,617,2,648,84,732,4354,2021-01-26 21:30:58
4402,790,2,429,55,484,4355,2021-01-26 08:25:16
4403,430,5,1625,211,1836,4356,2021-01-26 17:12:31
4404,933,2,598,77,675,4357,2021-01-26 21:46:44
4405,83,2,459,59,518,4358,2021-01-27 03:25:50
4406,372,3,888,115,1003,4359,2021-01-27 03:03:15
4407,922,2,798,103,901,4360,2021-01-27 04:39:34
4408,520,2,498,64,562,4361,2021-01-26 15:01:09
4409,212,5,1226,159,1385,4362,2021-01-27 06:12:54
4410,571,2,598,77,675,4363,2021-01-26 18:53:39
4411,759,2,598,77,675,4364,2021-01-26 12:13:52
4412,779,3,1127,146,1273,4365,2021-01-25 18:07:11
4413,563,3,578,75,653,4366,2021-01-25 19:39:19
4414,492,4,1357,176,1533,4367,2021-01-25 17:47:23
4415,561,3,528,68,596,4368,2021-01-25 21:07:26
4416,934,2,798,103,901,4369,2021-01-25 23:57:25
4417,13,6,2124,276,2400,4370,2021-01-25 23:14:19
4418,932,2,448,58,506,4371,2021-01-26 04:07:50
4419,465,3,997,129,1126,4372,2021-01-26 05:06:47
4420,838,3,947,123,1070,4373,2021-01-26 05:30:23
4421,320,3,997,129,1126,4374,2021-01-26 07:51:13
4422,102,2,698,90,788,4375,2021-01-26 12:05:53
4423,480,2,498,64,562,4376,2021-01-26 05:12:43
4424,444,5,1475,191,1666,4377,2021-01-26 09:19:56
4425,631,3,827,107,934,4378,2021-01-25 20:00:38
4426,751,3,528,68,596,4379,2021-01-25 16:45:07
4427,238,5,1406,182,1588,4380,2021-01-26 00:23:56
4428,955,3,1327,172,1499,4381,2021-01-26 07:39:13
4429,714,2,828,107,935,4382,2021-01-26 03:17:16
4430,102,6,1574,204,1778,4383,2021-01-26 02:00:33
4431,30,2,598,77,675,4384,2021-01-25 10:24:50
4432,294,3,608,79,687,4385,2021-01-25 03:33:06
4433,422,5,1795,233,2028,4386,2021-01-25 07:04:58
4434,325,3,997,129,1126,4387,2021-01-25 11:45:19
4435,429,3,747,97,844,4388,2021-01-25 04:18:30
4436,938,3,797,103,900,4389,2021-01-25 13:14:37
4437,18,2,1098,142,1240,4390,2021-01-25 14:18:54
4438,908,3,1127,146,1273,4391,2021-01-25 11:32:56
4439,547,3,558,72,630,4392,2021-01-25 21:05:01
4440,237,5,2095,272,2367,4393,2021-01-25 20:14:55
4441,837,3,927,120,1047,4394,2021-01-25 22:52:19
4442,52,2,498,64,562,4395,2021-01-25 11:00:19
4443,277,3,697,90,787,4396,2021-01-25 14:28:44
4444,71,2,498,64,562,4397,2021-01-26 00:12:55
4445,908,3,927,120,1047,4398,2021-01-27 00:18:28
4446,217,3,428,55,483,4399,2021-01-26 19:04:42
4447,210,3,688,89,777,4400,2021-01-26 03:17:48
4448,682,2,498,64,562,4401,2021-01-26 08:46:54
4449,663,2,1098,142,1240,4402,2021-01-26 21:39:10
4450,295,3,1047,136,1183,4403,2021-01-26 23:11:10
4451,759,2,928,120,1048,4404,2021-01-26 09:28:03
4452,959,3,597,77,674,4405,2021-01-26 18:45:42
4453,690,6,1435,186,1621,4406,2021-01-27 00:29:53
4454,785,5,1376,178,1554,4407,2021-01-27 03:45:35
4455,33,1,99,12,111,4408,2021-01-27 04:15:48
4456,605,3,1197,155,1352,4409,2021-01-27 05:06:12
4457,159,3,827,107,934,4410,2021-01-26 15:06:10
4458,250,2,698,90,788,4411,2021-01-27 08:25:26
4459,100,3,1327,172,1499,4412,2021-01-26 20:18:38
4460,209,2,898,116,1014,4413,2021-01-26 12:23:14
4461,972,6,1305,169,1474,4414,2021-01-25 18:11:15
4462,746,3,1197,155,1352,4415,2021-01-25 22:02:00
4463,260,3,647,84,731,4416,2021-01-25 18:30:09
4464,692,1,399,51,450,4417,2021-01-25 21:26:47
4465,578,2,498,64,562,4418,2021-01-26 00:00:32
4466,454,1,399,51,450,4419,2021-01-26 00:39:46
4467,52,5,1206,156,1362,4420,2021-01-26 05:14:27
4468,916,3,727,94,821,4421,2021-01-26 07:22:07
4469,460,6,1774,230,2004,4422,2021-01-26 07:52:16
4470,891,2,429,55,484,4423,2021-01-26 08:33:48
4471,891,2,429,55,484,4423,2021-01-26 08:33:48
4472,166,1,229,29,258,4424,2021-01-26 12:35:34
4473,70,1,699,90,789,4425,2021-01-26 07:28:55
4474,913,3,697,90,787,4426,2021-01-26 11:11:20
4475,741,3,697,90,787,4427,2021-01-25 22:32:37
4476,847,2,659,85,744,4428,2021-01-25 16:54:43
4477,547,2,648,84,732,4429,2021-01-26 02:21:18
4478,748,3,727,94,821,4430,2021-01-26 09:38:48
4479,380,3,578,75,653,4431,2021-01-26 03:43:59
4480,640,2,628,81,709,4432,2021-01-26 02:39:03
4481,27,6,1475,191,1666,4433,2021-01-25 12:10:37
4482,905,3,727,94,821,4434,2021-01-25 05:24:45
4483,401,3,558,72,630,4435,2021-01-25 09:06:42
4484,254,3,528,68,596,4436,2021-01-25 13:32:54
4485,96,3,1247,162,1409,4437,2021-01-25 06:06:20
4486,908,3,1247,162,1409,4438,2021-01-25 15:03:22
4487,526,2,698,90,788,4439,2021-01-25 16:01:27
4488,320,3,1027,133,1160,4440,2021-01-25 12:40:28
4489,919,2,498,64,562,4441,2021-01-25 23:01:51
4490,832,3,888,115,1003,4442,2021-01-25 22:32:58
4491,794,3,808,105,913,4443,2021-01-26 00:30:25
4492,186,2,898,116,1014,4444,2021-01-25 13:26:21
4493,132,3,688,89,777,4445,2021-01-25 16:47:01
4494,173,4,1096,142,1238,4446,2021-01-26 00:39:29
4495,724,3,827,107,934,4447,2021-01-27 02:37:27
4496,394,3,608,79,687,4448,2021-01-26 19:16:08
4497,30,2,898,116,1014,4449,2021-01-26 04:42:15
4498,260,3,747,97,844,4450,2021-01-26 11:22:42
4499,438,3,797,103,900,4451,2021-01-26 22:01:40
4500,781,3,608,79,687,4452,2021-01-27 00:38:05
4501,435,3,558,72,630,4453,2021-01-26 10:49:46
4502,16,3,808,105,913,4454,2021-01-26 18:46:15
4503,809,2,698,90,788,4455,2021-01-27 02:15:44
4504,427,3,658,85,743,4456,2021-01-27 03:56:36
4505,776,2,498,64,562,4457,2021-01-27 06:07:24
4506,298,3,697,90,787,4458,2021-01-27 05:53:15
4507,787,3,947,123,1070,4459,2021-01-26 15:47:44
4508,291,4,1496,194,1690,4460,2021-01-27 11:08:30
4509,126,3,747,97,844,4461,2021-01-26 20:38:18
4510,668,4,1057,137,1194,4462,2021-01-26 14:49:40
4511,214,2,1098,142,1240,4463,2021-01-25 20:31:54
4512,458,2,698,90,788,4464,2021-01-25 22:44:56
4513,292,3,847,110,957,4465,2021-01-25 19:48:28
4514,728,5,1376,178,1554,4466,2021-01-25 23:19:44
4515,762,2,798,103,901,4467,2021-01-26 02:19:46
4516,112,2,598,77,675,4468,2021-01-26 01:15:36
4517,742,3,1127,146,1273,4469,2021-01-26 07:33:39
4518,359,3,1047,136,1183,4470,2021-01-26 09:22:40
4519,464,3,1127,146,1273,4471,2021-01-26 09:08:28
4520,97,3,697,90,787,4472,2021-01-26 10:59:27
4521,383,3,1197,155,1352,4473,2021-01-26 10:28:42
4522,570,2,429,55,484,4474,2021-01-26 14:06:25
4523,85,2,598,77,675,4475,2021-01-26 09:04:55
4524,552,3,897,116,1013,4476,2021-01-26 11:23:44
4525,32,3,747,97,844,4477,2021-01-25 23:12:47
4526,605,3,1047,136,1183,4478,2021-01-25 18:12:50
4527,825,3,528,68,596,4479,2021-01-26 02:55:27
4528,391,3,578,75,653,4480,2021-01-26 12:24:50
4529,834,2,798,103,901,4481,2021-01-26 05:31:21
4530,748,3,1247,162,1409,4482,2021-01-26 04:41:52
4531,331,3,727,94,821,4483,2021-01-25 14:20:57
4532,978,3,927,120,1047,4484,2021-01-25 07:16:03
4533,779,2,429,55,484,4485,2021-01-25 10:22:20
4534,966,3,1197,155,1352,4486,2021-01-25 13:46:19
4535,746,3,747,97,844,4487,2021-01-25 06:24:17
4536,676,2,628,81,709,4488,2021-01-25 16:15:13
4537,207,3,528,68,596,4489,2021-01-25 17:51:29
4538,525,3,797,103,900,4490,2021-01-25 13:52:56
4539,140,5,1645,213,1858,4491,2021-01-25 23:36:18
4540,870,2,928,120,1048,4492,2021-01-26 00:49:16
4541,778,3,747,97,844,4493,2021-01-26 00:47:51
4542,420,3,528,68,596,4494,2021-01-25 14:35:41
4543,83,2,429,55,484,4495,2021-01-25 18:58:53
4544,937,2,429,55,484,4496,2021-01-26 00:50:24
4545,60,2,329,42,371,4497,2021-01-27 04:38:27
4546,891,3,1197,155,1352,4498,2021-01-26 21:49:44
4547,827,2,598,77,675,4499,2021-01-26 05:35:42
4548,495,5,1325,172,1497,4500,2021-01-26 12:48:33
4549,49,1,399,51,450,4501,2021-01-27 00:46:08
4550,670,2,329,42,371,4502,2021-01-27 03:00:55
4551,334,3,997,129,1126,4503,2021-01-26 12:08:37
4552,187,2,448,58,506,4504,2021-01-26 21:01:16
4553,105,4,1356,176,1532,4505,2021-01-27 03:38:02
4554,211,2,329,42,371,4506,2021-01-27 04:54:55
4555,318,3,608,79,687,4507,2021-01-27 07:46:14
4556,132,1,229,29,258,4508,2021-01-27 06:06:00
4557,452,3,1327,172,1499,4509,2021-01-26 17:58:26
4558,614,3,997,129,1126,4510,2021-01-27 12:44:23
4559,476,2,459,59,518,4511,2021-01-26 21:48:48
4560,193,6,2024,263,2287,4512,2021-01-26 17:32:16
4561,777,2,598,77,675,4513,2021-01-25 21:53:43
4562,674,1,99,12,111,4514,2021-01-26 00:16:33
4563,556,3,647,84,731,4515,2021-01-25 21:10:52
4564,519,4,1276,165,1441,4516,2021-01-26 00:22:17
4565,323,3,997,129,1126,4517,2021-01-26 02:47:46
4566,269,3,747,97,844,4518,2021-01-26 01:26:44
4567,687,3,1127,146,1273,4519,2021-01-26 08:25:06
4568,21,2,598,77,675,4520,2021-01-26 11:31:01
4569,516,3,1327,172,1499,4521,2021-01-26 09:19:32
4570,790,6,1615,209,1824,4522,2021-01-26 13:42:40
4571,798,2,698,90,788,4523,2021-01-26 13:07:42
4572,435,3,697,90,787,4524,2021-01-26 14:17:33
4573,463,3,1047,136,1183,4525,2021-01-26 10:16:50
4574,657,3,528,68,596,4526,2021-01-26 11:40:07
4575,313,3,478,62,540,4527,2021-01-26 01:43:19
4576,557,3,688,89,777,4528,2021-01-25 20:33:12
4577,689,2,628,81,709,4529,2021-01-26 05:13:17
4578,779,2,498,64,562,4530,2021-01-26 13:57:34
4579,386,3,758,98,856,4531,2021-01-26 07:04:58
4580,117,2,898,116,1014,4532,2021-01-26 07:12:12
4581,582,3,558,72,630,4533,2021-01-25 15:25:51
4582,72,2,659,85,744,4534,2021-01-25 09:51:10
4583,632,3,1327,172,1499,4535,2021-01-25 12:45:22
4584,441,4,976,126,1102,4536,2021-01-25 13:51:47
4585,483,3,658,85,743,4537,2021-01-25 06:48:46
4586,583,2,928,120,1048,4538,2021-01-25 17:01:34
4587,392,2,598,77,675,4539,2021-01-25 18:22:06
4588,218,2,898,116,1014,4540,2021-01-25 14:54:40
4589,430,1,229,29,258,4541,2021-01-25 23:41:23
4590,693,2,459,59,518,4542,2021-01-26 03:08:07
4591,522,3,997,129,1126,4543,2021-01-26 01:21:24
4592,428,1,99,12,111,4544,2021-01-25 16:45:02
4593,131,3,428,55,483,4545,2021-01-25 20:31:58
4594,951,2,598,77,675,4546,2021-01-26 02:40:42
4595,345,3,428,55,483,4547,2021-01-27 04:48:33
4596,509,3,578,75,653,4548,2021-01-26 23:55:46
4597,457,3,608,79,687,4549,2021-01-26 06:25:05
4598,303,3,1197,155,1352,4550,2021-01-26 13:48:56
4599,458,2,898,116,1014,4551,2021-01-27 01:11:52
4600,380,3,688,89,777,4552,2021-01-27 05:37:43
4601,899,5,1106,143,1249,4553,2021-01-26 12:57:36
4602,769,4,1146,148,1294,4554,2021-01-26 21:13:47
4603,642,2,459,59,518,4555,2021-01-27 05:27:18
4604,58,3,1247,162,1409,4556,2021-01-27 07:38:16
4605,577,3,1047,136,1183,4557,2021-01-27 10:23:20
4606,320,2,598,77,675,4558,2021-01-27 08:41:56
4607,658,3,947,123,1070,4559,2021-01-26 20:28:36
4608,261,3,1247,162,1409,4560,2021-01-27 13:32:18
4609,767,3,697,90,787,4561,2021-01-26 23:22:46
4610,456,3,997,129,1126,4562,2021-01-26 18:09:35
4611,922,5,1225,159,1384,4563,2021-01-25 22:27:57
4612,163,3,927,120,1047,4564,2021-01-26 00:47:01
4613,33,3,1047,136,1183,4565,2021-01-25 23:20:45
4614,444,1,229,29,258,4566,2021-01-26 00:56:11
4615,158,2,648,84,732,4567,2021-01-26 02:55:52
4616,524,2,659,85,744,4568,2021-01-26 03:52:42
4617,428,3,897,116,1013,4569,2021-01-26 09:57:59
4618,29,2,498,64,562,4570,2021-01-26 14:03:56
4619,319,3,1047,136,1183,4571,2021-01-26 11:32:05
4620,792,3,758,98,856,4572,2021-01-26 15:29:14
4621,154,5,1245,161,1406,4573,2021-01-26 15:50:20
4622,527,3,478,62,540,4574,2021-01-26 16:28:14
4623,275,3,747,97,844,4575,2021-01-26 12:51:45
4624,616,2,798,103,901,4576,2021-01-26 13:24:02
4625,921,3,597,77,674,4577,2021-01-26 03:53:43
4626,907,1,229,29,258,4578,2021-01-25 22:47:12
4627,816,3,658,85,743,4579,2021-01-26 05:58:49
4628,77,3,797,103,900,4580,2021-01-26 14:34:02
4629,717,4,1457,189,1646,4581,2021-01-26 09:38:19
4630,523,3,597,77,674,4582,2021-01-26 07:16:33
4631,928,3,897,116,1013,4583,2021-01-25 16:14:42
4632,259,3,747,97,844,4584,2021-01-25 11:46:24
4633,328,3,888,115,1003,4585,2021-01-25 14:06:59
4634,998,3,797,103,900,4586,2021-01-25 16:30:42
4635,98,2,648,84,732,4587,2021-01-25 09:33:56
4636,963,2,598,77,675,4588,2021-01-25 17:09:05
4637,903,2,498,64,562,4589,2021-01-25 19:53:35
4638,10,4,1626,211,1837,4590,2021-01-25 16:04:58
4639,584,2,798,103,901,4591,2021-01-26 01:59:38
4640,439,2,429,55,484,4592,2021-01-26 05:36:25
4641,142,2,459,59,518,4593,2021-01-26 03:14:04
4642,856,2,898,116,1014,4594,2021-01-25 18:13:27
4643,684,2,598,77,675,4595,2021-01-25 22:58:08
4644,661,3,808,105,913,4596,2021-01-26 02:53:53
4645,152,2,898,116,1014,4597,2021-01-27 06:55:59
4646,567,2,459,59,518,4598,2021-01-27 01:22:14
4647,952,4,1176,152,1328,4599,2021-01-26 08:51:04
4648,121,1,699,90,789,4600,2021-01-26 16:12:08
4649,319,3,1027,133,1160,4601,2021-01-27 02:30:14
4650,844,2,1098,142,1240,4602,2021-01-27 08:24:06
4651,573,3,658,85,743,4603,2021-01-26 13:05:10
4652,484,3,1297,168,1465,4604,2021-01-26 21:21:46
4653,442,3,578,75,653,4605,2021-01-27 06:08:05
4654,216,2,628,81,709,4606,2021-01-27 07:58:51
4655,165,3,697,90,787,4607,2021-01-27 10:50:46
4656,236,3,1027,133,1160,4608,2021-01-27 10:55:49
4657,309,2,498,64,562,4609,2021-01-26 23:05:32
4658,319,2,659,85,744,4610,2021-01-27 14:45:24
4659,163,1,99,12,111,4611,2021-01-27 00:45:57
4660,356,3,997,129,1126,4612,2021-01-26 18:34:10
4661,100,2,329,42,371,4613,2021-01-26 01:01:15
4662,249,2,1098,142,1240,4614,2021-01-26 01:51:30
4663,115,2,459,59,518,4615,2021-01-26 01:33:31
4664,181,2,798,103,901,4616,2021-01-26 03:39:07
4665,679,2,798,103,901,4617,2021-01-26 03:30:06
4666,430,4,1326,172,1498,4618,2021-01-26 06:28:40
4667,309,3,597,77,674,4619,2021-01-26 10:27:01
4668,593,2,459,59,518,4620,2021-01-26 15:04:05
4669,729,3,697,90,787,4621,2021-01-26 12:42:05
4670,676,3,1247,162,1409,4622,2021-01-26 16:02:25
4671,82,2,698,90,788,4623,2021-01-26 16:39:44
4672,249,3,797,103,900,4624,2021-01-26 18:59:22
4673,995,3,747,97,844,4625,2021-01-26 15:07:14
4674,760,3,997,129,1126,4626,2021-01-26 15:13:07
4675,28,2,898,116,1014,4627,2021-01-26 06:04:31
4676,660,1,149,19,168,4628,2021-01-26 00:30:56
4677,57,5,1645,213,1858,4629,2021-01-26 07:35:09
4678,820,3,1127,146,1273,4630,2021-01-26 15:09:25
4679,459,3,808,105,913,4631,2021-01-26 12:20:11
4680,319,3,1127,146,1273,4632,2021-01-26 09:10:39
4681,401,2,459,59,518,4633,2021-01-25 17:06:15
4682,172,2,598,77,675,4634,2021-01-25 14:07:23
4683,612,3,1027,133,1160,4635,2021-01-25 14:44:16
4684,782,1,699,90,789,4636,2021-01-25 16:52:00
4685,320,6,1374,178,1552,4637,2021-01-25 09:35:42
4686,804,4,1487,193,1680,4638,2021-01-25 18:43:44
4687,26,2,659,85,744,4639,2021-01-25 22:34:10
4688,309,2,459,59,518,4640,2021-01-25 17:14:49
4689,706,2,498,64,562,4641,2021-01-26 04:17:22
4690,134,3,797,103,900,4642,2021-01-26 06:54:54
4691,335,3,558,72,630,4643,2021-01-26 03:33:13
4692,374,2,429,55,484,4644,2021-01-25 18:49:13
4693,58,3,997,129,1126,4645,2021-01-25 23:05:02
4694,336,2,598,77,675,4646,2021-01-26 03:20:26
4695,279,3,827,107,934,4647,2021-01-27 08:04:25
4696,592,3,1247,162,1409,4648,2021-01-27 03:34:35
4697,47,2,898,116,1014,4649,2021-01-26 11:15:09
4698,612,3,808,105,913,4650,2021-01-26 16:46:13
4699,941,3,997,129,1126,4651,2021-01-27 04:18:45
4700,62,2,659,85,744,4652,2021-01-27 09:29:50
4701,663,3,658,85,743,4653,2021-01-26 15:32:33
4702,748,3,1027,133,1160,4654,2021-01-26 21:23:41
4703,524,3,888,115,1003,4655,2021-01-27 07:06:15
4704,494,3,528,68,596,4656,2021-01-27 09:13:53
4705,279,3,697,90,787,4657,2021-01-27 11:19:47
4706,57,3,827,107,934,4658,2021-01-27 13:09:37
4707,450,3,608,79,687,4659,2021-01-26 23:37:16
4708,79,2,628,81,709,4660,2021-01-27 15:08:20
4709,79,2,628,81,709,4660,2021-01-27 15:08:20
4710,694,2,598,77,675,4661,2021-01-27 01:54:17
4711,606,2,598,77,675,4662,2021-01-26 20:38:57
4712,779,3,528,68,596,4663,2021-01-26 02:07:06
4713,602,3,747,97,844,4664,2021-01-26 03:49:27
4714,707,3,428,55,483,4665,2021-01-26 01:41:23
4715,542,2,798,103,901,4666,2021-01-26 05:26:25
4716,903,4,1826,237,2063,4667,2021-01-26 06:01:23
4717,840,3,927,120,1047,4668,2021-01-26 08:29:11
4718,192,1,149,19,168,4669,2021-01-26 12:29:02
4719,991,3,997,129,1126,4670,2021-01-26 16:05:01
4720,51,3,1047,136,1183,4671,2021-01-26 13:22:54
4721,969,3,797,103,900,4672,2021-01-26 17:57:54
4722,928,3,997,129,1126,4673,2021-01-26 19:24:04
4723,898,2,1098,142,1240,4674,2021-01-26 19:35:48
4724,655,4,1596,207,1803,4675,2021-01-26 15:40:02
4725,516,3,1197,155,1352,4676,2021-01-26 17:21:03
4726,662,3,758,98,856,4677,2021-01-26 06:15:49
4727,77,3,697,90,787,4678,2021-01-26 00:40:24
4728,290,2,798,103,901,4679,2021-01-26 09:33:09
4729,883,2,429,55,484,4680,2021-01-26 17:02:20
4730,775,4,1596,207,1803,4681,2021-01-26 13:47:22
4731,455,3,578,75,653,4682,2021-01-26 09:21:00
4732,437,2,1098,142,1240,4683,2021-01-25 18:58:08
4733,833,3,997,129,1126,4684,2021-01-25 16:08:07
4734,388,3,428,55,483,4685,2021-01-25 16:30:01
4735,304,1,399,51,450,4686,2021-01-25 18:59:32
4736,102,3,747,97,844,4687,2021-01-25 10:27:10
4737,892,3,658,85,743,4688,2021-01-25 20:43:08
4738,524,3,747,97,844,4689,2021-01-25 22:47:30
4739,150,2,548,71,619,4690,2021-01-25 19:26:28
4740,669,2,798,103,901,4691,2021-01-26 05:17:57
4741,550,3,827,107,934,4692,2021-01-26 08:27:25
4742,621,3,997,129,1126,4693,2021-01-26 05:31:06
4743,828,6,1505,195,1700,4694,2021-01-25 19:20:04
4744,789,2,1098,142,1240,4695,2021-01-26 00:06:26
4745,237,3,558,72,630,4696,2021-01-26 05:12:24
4746,144,3,827,107,934,4697,2021-01-27 09:37:42
4747,986,3,1027,133,1160,4698,2021-01-27 05:43:54
4748,449,2,898,116,1014,4699,2021-01-26 13:31:10
4749,440,3,747,97,844,4700,2021-01-26 17:06:27
4750,627,3,1247,162,1409,4701,2021-01-27 05:44:53
4751,816,3,808,105,913,4702,2021-01-27 09:53:28
4752,695,3,428,55,483,4703,2021-01-26 16:03:08
4753,4,2,898,116,1014,4704,2021-01-26 23:01:06
4754,16,3,1127,146,1273,4705,2021-01-27 09:13:20
4755,687,6,1525,198,1723,4706,2021-01-27 09:47:24
4756,386,3,647,84,731,4707,2021-01-27 13:24:45
4757,504,2,798,103,901,4708,2021-01-27 13:10:04
4758,633,3,947,123,1070,4709,2021-01-27 01:32:29
4759,776,3,1127,146,1273,4710,2021-01-27 17:50:06
4760,936,4,876,113,989,4711,2021-01-27 17:01:51
4761,809,3,897,116,1013,4712,2021-01-27 02:26:11
4762,498,3,1027,133,1160,4713,2021-01-26 22:26:52
4763,129,3,528,68,596,4714,2021-01-26 02:42:23
4764,378,3,1327,172,1499,4715,2021-01-26 05:59:57
4765,452,3,997,129,1126,4716,2021-01-26 04:25:51
4766,985,1,229,29,258,4717,2021-01-26 06:03:22
4767,802,3,927,120,1047,4718,2021-01-26 08:04:30
4768,942,6,2024,263,2287,4719,2021-01-26 09:19:48
4769,460,3,597,77,674,4720,2021-01-26 13:09:46
4770,815,2,498,64,562,4721,2021-01-26 17:55:58
4771,136,3,1127,146,1273,4722,2021-01-26 13:35:11
4772,669,2,1098,142,1240,4723,2021-01-26 18:06:48
4773,19,4,1207,156,1363,4724,2021-01-26 19:42:42
4774,588,3,847,110,957,4725,2021-01-26 19:53:15
4775,458,2,528,68,596,4726,2021-01-26 16:41:51
4776,262,3,997,129,1126,4727,2021-01-26 19:22:56
4777,708,3,597,77,674,4728,2021-01-26 06:20:57
4778,428,3,428,55,483,4729,2021-01-26 02:23:51
4779,103,1,699,90,789,4730,2021-01-26 09:47:22
4780,670,3,478,62,540,4731,2021-01-26 18:23:14
4781,837,3,428,55,483,4732,2021-01-26 16:23:11
4782,448,4,1346,174,1520,4733,2021-01-26 10:02:27
4783,197,5,1486,193,1679,4734,2021-01-25 21:32:45
4784,798,3,808,105,913,4735,2021-01-25 16:30:35
4785,554,5,1975,256,2231,4736,2021-01-25 18:38:01
4786,69,3,1327,172,1499,4737,2021-01-25 21:25:27
4787,348,3,578,75,653,4738,2021-01-25 10:29:24
4788,587,6,1505,195,1700,4739,2021-01-25 20:56:00
4789,910,3,1047,136,1183,4740,2021-01-25 23:52:49
4790,356,2,329,42,371,4741,2021-01-25 21:32:57
4791,993,2,628,81,709,4742,2021-01-26 05:23:17
4792,673,3,1047,136,1183,4743,2021-01-26 10:10:05
4793,655,3,897,116,1013,4744,2021-01-26 07:18:39
4794,179,3,647,84,731,4745,2021-01-25 20:09:07
4795,295,3,747,97,844,4746,2021-01-26 00:33:35
4796,906,2,798,103,901,4747,2021-01-26 06:36:05
4797,498,2,498,64,562,4748,2021-01-27 11:13:23
4798,747,3,927,120,1047,4749,2021-01-27 06:16:10
4799,285,3,1027,133,1160,4750,2021-01-26 14:40:49
4800,67,3,658,85,743,4751,2021-01-26 19:30:40
4801,487,3,478,62,540,4752,2021-01-27 05:50:13
4802,785,3,558,72,630,4753,2021-01-27 10:10:40
4803,485,2,898,116,1014,4754,2021-01-26 18:49:15
4804,788,2,798,103,901,4755,2021-01-26 23:13:05
4805,204,3,847,110,957,4756,2021-01-27 10:50:02
4806,615,3,1047,136,1183,4757,2021-01-27 11:56:43
4807,279,2,548,71,619,4758,2021-01-27 15:05:39
4808,743,3,947,123,1070,4759,2021-01-27 15:04:52
4809,11,3,647,84,731,4760,2021-01-27 01:38:22
4810,717,3,808,105,913,4761,2021-01-27 18:11:23
4811,805,2,429,55,484,4762,2021-01-27 19:11:18
4812,841,1,599,77,676,4763,2021-01-27 02:53:55
4813,984,3,578,75,653,4764,2021-01-27 00:13:50
4814,900,3,688,89,777,4765,2021-01-26 05:11:46
4815,315,2,898,116,1014,4766,2021-01-26 07:38:40
4816,717,2,898,116,1014,4767,2021-01-26 07:02:22
4817,820,4,1117,145,1262,4768,2021-01-26 08:32:30
4818,240,2,828,107,935,4769,2021-01-26 08:42:40
4819,195,2,598,77,675,4770,2021-01-26 10:55:07
4820,398,3,558,72,630,4771,2021-01-26 15:19:08
4821,662,3,1197,155,1352,4772,2021-01-26 19:18:34
4822,670,3,528,68,596,4773,2021-01-26 14:23:38
4823,427,3,827,107,934,4774,2021-01-26 20:26:03
4824,995,3,658,85,743,4775,2021-01-26 20:00:50
4825,131,3,688,89,777,4776,2021-01-26 19:57:42
4826,969,5,1925,250,2175,4777,2021-01-26 18:42:01
4827,141,3,997,129,1126,4778,2021-01-26 20:38:38
4828,877,2,329,42,371,4779,2021-01-26 06:46:38
4829,182,2,698,90,788,4780,2021-01-26 02:31:22
4830,796,5,1556,202,1758,4781,2021-01-26 11:02:39
4831,966,4,1357,176,1533,4782,2021-01-26 18:59:06
4832,349,3,1247,162,1409,4783,2021-01-26 18:01:09
4833,595,3,428,55,483,4784,2021-01-26 11:17:51
4834,697,3,697,90,787,4785,2021-01-25 22:11:15
4835,433,3,428,55,483,4786,2021-01-25 16:50:53
4836,770,3,1047,136,1183,4787,2021-01-25 20:08:57
4837,144,3,888,115,1003,4788,2021-01-25 23:36:50
4838,960,2,498,64,562,4789,2021-01-25 11:13:22
4839,371,2,598,77,675,4790,2021-01-25 23:33:28
4840,826,3,827,107,934,4791,2021-01-26 02:31:23
4841,494,3,827,107,934,4792,2021-01-26 00:12:01
4842,482,3,1047,136,1183,4793,2021-01-26 06:53:49
4843,831,3,697,90,787,4794,2021-01-26 11:04:33
4844,553,2,928,120,1048,4795,2021-01-26 09:19:39
4845,520,3,897,116,1013,4796,2021-01-25 22:24:02
4846,520,3,897,116,1013,4796,2021-01-25 22:24:02
4847,896,3,697,90,787,4797,2021-01-26 02:25:18
4848,220,2,1098,142,1240,4798,2021-01-26 06:43:12
4849,446,3,997,129,1126,4799,2021-01-27 13:09:00
4850,769,3,888,115,1003,4800,2021-01-27 08:04:50
4851,315,2,598,77,675,4801,2021-01-26 16:21:35
4852,455,3,1027,133,1160,4802,2021-01-26 21:40:25
4853,30,2,848,110,958,4803,2021-01-27 07:25:50
4854,862,2,398,51,449,4804,2021-01-27 12:38:58
4855,599,2,459,59,518,4805,2021-01-26 20:24:08
4856,480,3,1127,146,1273,4806,2021-01-27 01:29:37
4857,425,5,976,126,1102,4807,2021-01-27 12:41:58
4858,203,5,1195,155,1350,4808,2021-01-27 12:48:09
4859,221,3,997,129,1126,4809,2021-01-27 15:13:04
4860,672,3,847,110,957,4810,2021-01-27 17:03:53
4861,686,3,697,90,787,4811,2021-01-27 03:09:46
4862,439,3,697,90,787,4812,2021-01-27 19:11:29
4863,261,3,1027,133,1160,4813,2021-01-27 21:22:45
4864,469,3,808,105,913,4814,2021-01-27 03:50:06
4865,704,2,798,103,901,4815,2021-01-27 00:58:59
4866,23,3,947,123,1070,4816,2021-01-26 07:22:04
4867,164,3,1127,146,1273,4817,2021-01-26 08:57:41
4868,913,3,997,129,1126,4818,2021-01-26 09:45:52
4869,869,3,927,120,1047,4819,2021-01-26 09:54:10
4870,360,2,659,85,744,4820,2021-01-26 09:09:55
4871,916,2,459,59,518,4821,2021-01-26 12:26:10
4872,966,3,1027,133,1160,4822,2021-01-26 17:51:07
4873,646,2,548,71,619,4823,2021-01-26 21:12:29
4874,525,3,478,62,540,4824,2021-01-26 15:07:03
4875,555,2,398,51,449,4825,2021-01-26 23:04:56
4876,694,2,698,90,788,4826,2021-01-26 21:48:38
4877,971,2,1098,142,1240,4827,2021-01-26 20:13:33
4878,625,3,1127,146,1273,4828,2021-01-26 20:55:02
4879,126,3,697,90,787,4829,2021-01-26 21:47:48
4880,652,3,478,62,540,4830,2021-01-26 08:44:51
4881,132,6,1615,209,1824,4831,2021-01-26 03:17:42
4882,621,5,1256,163,1419,4832,2021-01-26 13:47:09
4883,468,3,558,72,630,4833,2021-01-26 20:17:35
4884,896,2,659,85,744,4834,2021-01-26 18:28:24
4885,9,3,997,129,1126,4835,2021-01-26 12:11:10
4886,489,3,528,68,596,4836,2021-01-26 00:57:13
4887,144,3,1197,155,1352,4837,2021-01-25 19:09:04
4888,214,6,2074,269,2343,4838,2021-01-25 20:37:53
4889,978,2,659,85,744,4839,2021-01-26 00:09:30
4890,943,3,997,129,1126,4840,2021-01-25 13:04:07
4891,600,3,1127,146,1273,4841,2021-01-26 00:45:58
4892,250,3,428,55,483,4842,2021-01-26 04:30:15
4893,568,2,498,64,562,4843,2021-01-26 02:33:47
4894,299,2,698,90,788,4844,2021-01-26 07:38:47
4895,447,5,1295,168,1463,4845,2021-01-26 12:28:22
4896,479,3,647,84,731,4846,2021-01-26 10:23:14
4897,647,3,947,123,1070,4847,2021-01-26 00:06:10
4898,346,3,1047,136,1183,4848,2021-01-25 23:22:07
4899,346,3,1047,136,1183,4848,2021-01-25 23:22:07
4900,618,2,329,42,371,4849,2021-01-26 04:17:37
4901,256,2,429,55,484,4850,2021-01-26 08:14:55
4902,581,3,827,107,934,4851,2021-01-27 14:09:32
4903,198,1,299,38,337,4852,2021-01-27 09:23:48
4904,234,1,149,19,168,4853,2021-01-26 17:52:43
4905,234,1,149,19,168,4853,2021-01-26 17:52:43
4906,868,3,478,62,540,4854,2021-01-26 23:40:33
4907,381,3,1197,155,1352,4855,2021-01-27 09:56:32
4908,76,3,578,75,653,4856,2021-01-27 14:57:20
4909,984,2,598,77,675,4857,2021-01-26 21:22:03
4910,706,2,398,51,449,4858,2021-01-27 01:46:14
4911,50,3,827,107,934,4859,2021-01-27 14:13:24
4912,239,3,997,129,1126,4860,2021-01-27 13:32:30
4913,569,5,2145,278,2423,4861,2021-01-27 16:25:36
4914,583,6,1546,200,1746,4862,2021-01-27 18:07:23
4915,201,2,698,90,788,4863,2021-01-27 03:55:40
4916,405,2,898,116,1014,4864,2021-01-27 20:27:41
4917,184,5,1845,239,2084,4865,2021-01-27 21:32:58
4918,556,2,659,85,744,4866,2021-01-27 05:51:45
4919,14,2,459,59,518,4867,2021-01-27 02:38:38
4920,319,3,927,120,1047,4868,2021-01-26 08:25:33
4921,180,3,758,98,856,4869,2021-01-26 10:41:10
4922,285,3,1027,133,1160,4870,2021-01-26 10:43:56
4923,662,1,99,12,111,4871,2021-01-26 11:14:56
4924,120,3,1127,146,1273,4872,2021-01-26 11:44:32
4925,504,2,928,120,1048,4873,2021-01-26 14:10:13
4926,58,3,997,129,1126,4874,2021-01-26 17:58:43
4927,994,3,758,98,856,4875,2021-01-26 23:38:41
4928,238,2,798,103,901,4876,2021-01-26 15:26:48
4929,895,3,528,68,596,4877,2021-01-26 23:38:29
4930,454,3,608,79,687,4878,2021-01-26 22:34:29
4931,493,2,598,77,675,4879,2021-01-26 22:47:01
4932,837,3,478,62,540,4880,2021-01-26 22:52:02
4933,367,3,697,90,787,4881,2021-01-26 21:57:28
4934,183,3,1047,136,1183,4882,2021-01-26 09:08:28
4935,296,2,598,77,675,4883,2021-01-26 05:39:44
4936,253,2,848,110,958,4884,2021-01-26 14:45:36
4937,583,3,758,98,856,4885,2021-01-26 22:17:53
4938,664,3,688,89,777,4886,2021-01-26 21:09:48
4939,579,2,1098,142,1240,4887,2021-01-26 14:04:29
4940,640,3,558,72,630,4888,2021-01-26 03:40:21
4941,311,2,329,42,371,4889,2021-01-25 19:14:50
4942,235,3,658,85,743,4890,2021-01-25 21:24:24
4943,728,3,997,129,1126,4891,2021-01-26 00:54:10
4944,283,2,598,77,675,4892,2021-01-25 13:13:19
4945,27,3,1027,133,1160,4893,2021-01-26 03:20:53
4946,855,3,688,89,777,4894,2021-01-26 06:25:30
4947,751,2,628,81,709,4895,2021-01-26 02:50:04
4948,983,2,429,55,484,4896,2021-01-26 09:01:14
4949,665,2,698,90,788,4897,2021-01-26 13:28:23
4950,264,3,997,129,1126,4898,2021-01-26 12:41:46
4951,689,3,697,90,787,4899,2021-01-26 02:45:43
4952,804,3,847,110,957,4900,2021-01-26 00:30:18
4953,439,1,299,38,337,4901,2021-01-26 00:51:08
4954,500,3,528,68,596,4902,2021-01-26 06:07:06
4955,278,3,647,84,731,4903,2021-01-26 08:25:32
4956,995,1,699,90,789,4904,2021-01-27 16:16:09
4957,694,3,647,84,731,4905,2021-01-27 10:29:41
4958,1,3,697,90,787,4906,2021-01-26 18:21:32
4959,378,4,1526,198,1724,4907,2021-01-26 18:14:01
4960,726,3,888,115,1003,4908,2021-01-27 00:44:11
4961,770,3,608,79,687,4909,2021-01-27 12:24:55
4962,544,2,459,59,518,4910,2021-01-27 17:29:16
4963,745,2,598,77,675,4911,2021-01-26 22:21:22
4964,445,3,478,62,540,4912,2021-01-27 04:11:57
4965,220,3,997,129,1126,4913,2021-01-27 16:32:02
4966,678,2,659,85,744,4914,2021-01-27 16:01:24
4967,680,2,398,51,449,4915,2021-01-27 18:12:01
4968,521,5,1676,217,1893,4916,2021-01-27 18:31:49
4969,618,3,1127,146,1273,4917,2021-01-27 04:04:42
4970,894,3,727,94,821,4918,2021-01-27 23:05:20
4971,228,4,1307,169,1476,4919,2021-01-27 23:24:17
4972,753,3,478,62,540,4920,2021-01-27 07:01:41
4973,215,1,229,29,258,4921,2021-01-27 03:55:04
4974,304,3,747,97,844,4922,2021-01-26 09:01:25
4975,304,3,747,97,844,4922,2021-01-26 09:01:25
4976,494,3,1327,172,1499,4923,2021-01-26 12:42:37
4977,296,3,888,115,1003,4924,2021-01-26 12:44:24
4978,714,3,827,107,934,4925,2021-01-26 13:31:02
4979,15,2,459,59,518,4926,2021-01-26 13:47:26
4980,824,6,1385,180,1565,4927,2021-01-26 14:30:16
4981,555,3,1047,136,1183,4928,2021-01-26 19:04:48
4982,604,2,459,59,518,4929,2021-01-27 01:11:34
4983,586,4,1596,207,1803,4930,2021-01-26 15:40:17
4984,659,3,1047,136,1183,4931,2021-01-27 00:23:55
4985,106,3,997,129,1126,4932,2021-01-26 23:23:29
4986,363,6,1544,200,1744,4933,2021-01-27 00:55:18
4987,429,3,1047,136,1183,4934,2021-01-26 23:15:49
4988,280,4,1696,220,1916,4935,2021-01-27 00:05:09
4989,280,4,1696,220,1916,4935,2021-01-27 00:05:09
4990,148,3,658,85,743,4936,2021-01-26 11:47:05
4991,921,2,459,59,518,4937,2021-01-26 06:33:23
4992,624,1,399,51,450,4938,2021-01-26 17:30:19
4993,101,4,1546,200,1746,4939,2021-01-27 00:49:19
4994,292,3,697,90,787,4940,2021-01-26 21:53:51
4995,589,3,1197,155,1352,4941,2021-01-26 16:07:23
4996,847,5,1545,200,1745,4942,2021-01-26 04:02:28
4997,274,3,1027,133,1160,4943,2021-01-25 21:28:20
4998,578,3,1247,162,1409,4944,2021-01-25 23:22:16
4999,450,3,608,79,687,4945,2021-01-26 01:06:49
5000,191,4,1426,185,1611,4946,2021-01-25 15:35:40
5001,820,3,927,120,1047,4947,2021-01-26 03:25:13
5002,730,5,1275,165,1440,4948,2021-01-26 07:07:52
5003,603,2,798,103,901,4949,2021-01-26 05:33:26
5004,774,2,848,110,958,4950,2021-01-26 10:56:07
5005,305,2,798,103,901,4951,2021-01-26 16:04:14
5006,916,3,697,90,787,4952,2021-01-26 14:03:02
5007,494,3,697,90,787,4953,2021-01-26 04:19:54
5008,17,5,1326,172,1498,4954,2021-01-26 01:45:36
5009,681,2,928,120,1048,4955,2021-01-26 02:24:13
5010,252,5,1456,189,1645,4956,2021-01-26 06:48:10
5011,118,3,1247,162,1409,4957,2021-01-26 10:47:40
5012,940,2,798,103,901,4958,2021-01-27 16:49:59
5013,699,2,698,90,788,4959,2021-01-27 10:53:12
5014,23,3,558,72,630,4960,2021-01-26 19:05:59
5015,254,2,598,77,675,4961,2021-01-26 19:39:27
5016,982,5,1356,176,1532,4962,2021-01-27 01:50:18
5017,602,5,1595,207,1802,4963,2021-01-27 15:05:39
5018,377,3,808,105,913,4964,2021-01-27 18:56:46
5019,552,2,698,90,788,4965,2021-01-26 23:55:28
5020,998,3,478,62,540,4966,2021-01-27 06:14:16
5021,15,4,1296,168,1464,4967,2021-01-27 19:17:28
5022,785,3,428,55,483,4968,2021-01-27 18:25:34
5023,798,6,1905,247,2152,4969,2021-01-27 20:25:49
5024,270,2,598,77,675,4970,2021-01-27 19:31:44
5025,114,2,828,107,935,4971,2021-01-27 06:12:22
5026,595,2,898,116,1014,4972,2021-01-28 01:04:26
5027,789,3,658,85,743,4973,2021-01-28 00:22:47
5028,581,3,688,89,777,4974,2021-01-27 09:14:14
5029,770,4,577,75,652,4975,2021-01-27 05:00:16
5030,51,3,658,85,743,4976,2021-01-26 11:13:41
5031,657,3,808,105,913,4977,2021-01-26 10:45:44
5032,270,5,1206,156,1362,4978,2021-01-26 14:26:05
5033,840,6,1644,213,1857,4979,2021-01-26 15:21:10
5034,44,2,598,77,675,4980,2021-01-26 14:25:12
5035,454,3,997,129,1126,4981,2021-01-26 16:02:02
5036,515,2,698,90,788,4982,2021-01-26 15:19:11
5037,783,2,329,42,371,4983,2021-01-26 19:47:32
5038,428,3,478,62,540,4984,2021-01-27 03:16:44
5039,173,3,1027,133,1160,4985,2021-01-26 17:41:57
5040,941,3,1327,172,1499,4986,2021-01-27 00:59:06
5041,893,6,1166,151,1317,4987,2021-01-27 00:25:40
5042,747,3,688,89,777,4988,2021-01-27 03:15:17
5043,199,3,747,97,844,4989,2021-01-26 23:53:30
5044,388,3,558,72,630,4990,2021-01-27 01:47:15
5045,266,3,478,62,540,4991,2021-01-27 00:10:20
5046,960,3,1247,162,1409,4992,2021-01-26 14:01:28
5047,967,3,947,123,1070,4993,2021-01-26 08:14:00
5048,947,3,927,120,1047,4994,2021-01-26 19:39:36
5049,413,3,558,72,630,4995,2021-01-27 02:24:45
5050,187,3,428,55,483,4996,2021-01-26 23:09:14
5051,961,3,647,84,731,4997,2021-01-26 18:09:49
5052,780,3,1047,136,1183,4998,2021-01-26 05:18:13
5053,14,2,698,90,788,4999,2021-01-25 23:43:10
5054,842,3,1127,146,1273,5000,2021-01-26 00:50:05
5055,465,2,528,68,596,5001,2021-01-26 03:32:43
5056,588,2,329,42,371,5002,2021-01-25 17:08:09
5057,864,4,1346,174,1520,5003,2021-01-26 04:01:09
5058,99,2,728,94,822,5004,2021-01-26 08:08:09
5059,721,3,1047,136,1183,5005,2021-01-26 07:19:33
5060,195,3,847,110,957,5006,2021-01-26 12:45:52
5061,19,3,1047,136,1183,5007,2021-01-26 16:41:42
5062,166,3,697,90,787,5008,2021-01-26 16:01:18
5063,474,5,1345,174,1519,5009,2021-01-26 05:12:47
5064,613,3,558,72,630,5010,2021-01-26 01:51:16
5065,948,6,1944,252,2196,5011,2021-01-26 04:53:23
5066,266,3,597,77,674,5012,2021-01-26 08:40:46
5067,225,3,1047,136,1183,5013,2021-01-26 11:55:20
5068,369,5,1545,200,1745,5014,2021-01-27 19:34:05
5069,450,2,848,110,958,5015,2021-01-27 13:23:50
5070,780,2,798,103,901,5016,2021-01-26 21:02:49
5071,276,3,647,84,731,5017,2021-01-26 21:42:35
5072,47,2,828,107,935,5018,2021-01-27 03:10:19
5073,461,2,329,42,371,5019,2021-01-27 15:34:53
5074,416,3,1197,155,1352,5020,2021-01-27 19:06:40
5075,790,5,1445,187,1632,5021,2021-01-27 02:13:03
5076,432,2,659,85,744,5022,2021-01-27 07:26:03
5077,522,3,1047,136,1183,5023,2021-01-27 20:17:20
5078,345,4,1257,163,1420,5024,2021-01-27 21:09:47
5079,139,2,798,103,901,5025,2021-01-27 23:04:08
5080,822,3,847,110,957,5026,2021-01-27 20:27:40
5081,191,3,1247,162,1409,5027,2021-01-27 07:09:44
5082,706,5,1276,165,1441,5028,2021-01-28 01:06:26
5083,94,3,1197,155,1352,5029,2021-01-28 01:25:27
5084,589,3,688,89,777,5030,2021-01-27 11:56:45
5085,206,2,659,85,744,5031,2021-01-27 06:35:03
5086,467,3,688,89,777,5032,2021-01-26 12:18:38
5087,83,4,1596,207,1803,5033,2021-01-26 13:18:04
5088,177,2,548,71,619,5034,2021-01-26 16:22:54
5089,62,3,847,110,957,5035,2021-01-26 16:47:49
5090,396,3,1127,146,1273,5036,2021-01-26 15:11:03
5091,308,5,1076,139,1215,5037,2021-01-26 18:32:23
5092,586,3,608,79,687,5038,2021-01-26 17:01:59
5093,496,3,697,90,787,5039,2021-01-26 21:00:35
5094,371,3,797,103,900,5040,2021-01-27 04:36:59
5095,194,2,698,90,788,5041,2021-01-26 18:06:05
5096,926,3,947,123,1070,5042,2021-01-27 03:14:13
5097,289,5,1067,138,1205,5043,2021-01-27 03:00:32
5098,253,3,597,77,674,5044,2021-01-27 05:11:38
5099,584,3,1127,146,1273,5045,2021-01-27 00:21:04
5100,957,4,1027,133,1160,5046,2021-01-27 02:36:35
5101,35,4,1057,137,1194,5047,2021-01-27 02:42:39
5102,478,3,797,103,900,5048,2021-01-26 15:23:35
5103,747,3,647,84,731,5049,2021-01-26 10:58:37
5104,779,3,797,103,900,5050,2021-01-26 22:10:33
5105,367,2,1098,142,1240,5051,2021-01-27 03:37:58
5106,616,2,898,116,1014,5052,2021-01-27 00:51:15
5107,311,2,698,90,788,5053,2021-01-26 19:04:01
5108,508,3,1027,133,1160,5054,2021-01-26 07:44:30
5109,358,3,1047,136,1183,5055,2021-01-26 00:21:13
5110,951,3,578,75,653,5056,2021-01-26 02:44:34
5111,316,2,498,64,562,5057,2021-01-26 03:52:41
5112,282,5,1545,200,1745,5058,2021-01-25 18:51:27
5113,524,3,1127,146,1273,5059,2021-01-26 04:32:00
5114,253,2,448,58,506,5060,2021-01-26 08:17:06
5115,409,2,329,42,371,5061,2021-01-26 08:10:53
5116,647,2,659,85,744,5062,2021-01-26 15:04:12
5117,64,3,697,90,787,5063,2021-01-26 17:56:03
5118,383,3,797,103,900,5064,2021-01-26 18:44:18
5119,50,3,1127,146,1273,5065,2021-01-26 07:44:23
5120,324,2,698,90,788,5066,2021-01-26 03:37:15
5121,579,3,597,77,674,5067,2021-01-26 07:06:44
5122,942,3,428,55,483,5068,2021-01-26 11:12:42
5123,926,5,1345,174,1519,5069,2021-01-26 13:54:48
5124,944,3,558,72,630,5070,2021-01-27 20:49:06
5125,675,2,429,55,484,5071,2021-01-27 13:44:05
5126,950,3,747,97,844,5072,2021-01-26 23:26:47
5127,984,2,329,42,371,5073,2021-01-26 22:04:55
5128,750,2,329,42,371,5074,2021-01-27 05:01:11
5129,856,3,808,105,913,5075,2021-01-27 18:19:28
5130,941,3,827,107,934,5076,2021-01-27 19:30:45
5131,381,2,798,103,901,5077,2021-01-27 03:22:47
5132,788,2,628,81,709,5078,2021-01-27 08:44:28
5133,71,3,827,107,934,5079,2021-01-27 21:02:37
5134,538,2,498,64,562,5080,2021-01-27 23:38:45
5135,434,4,1426,185,1611,5081,2021-01-27 23:54:58
5136,948,3,1047,136,1183,5082,2021-01-27 20:39:30
5137,894,3,658,85,743,5083,2021-01-27 08:43:09
5138,890,6,1544,200,1744,5084,2021-01-28 03:29:29
5139,733,2,659,85,744,5085,2021-01-28 02:13:55
5140,408,2,798,103,901,5086,2021-01-27 13:06:54
5141,839,2,898,116,1014,5087,2021-01-27 08:23:42
5142,601,2,1098,142,1240,5088,2021-01-26 13:06:15
5143,425,3,827,107,934,5089,2021-01-26 15:55:21
5144,803,3,1027,133,1160,5090,2021-01-26 18:39:55
5145,51,3,797,103,900,5091,2021-01-26 17:44:29
5146,398,5,2025,263,2288,5092,2021-01-26 15:33:43
5147,541,3,1047,136,1183,5093,2021-01-26 18:37:42
5148,374,2,498,64,562,5094,2021-01-26 19:32:45
5149,894,5,1795,233,2028,5095,2021-01-26 21:12:00
5150,368,4,1037,134,1171,5096,2021-01-27 05:38:49
5151,636,3,697,90,787,5097,2021-01-26 20:36:45
5152,799,2,798,103,901,5098,2021-01-27 04:14:27
5153,807,3,888,115,1003,5099,2021-01-27 03:04:41
5154,19,2,798,103,901,5100,2021-01-27 07:32:50
5155,135,2,748,97,845,5101,2021-01-27 02:50:42
5156,476,2,659,85,744,5102,2021-01-27 04:15:39
5157,981,3,747,97,844,5103,2021-01-27 05:13:25
5158,357,3,1047,136,1183,5104,2021-01-26 15:24:29
5159,65,3,478,62,540,5105,2021-01-26 13:44:58
5160,849,2,498,64,562,5106,2021-01-26 22:34:14
5161,241,1,99,12,111,5107,2021-01-27 04:11:11
5162,810,3,1127,146,1273,5108,2021-01-27 02:28:14
5163,379,3,888,115,1003,5109,2021-01-26 19:35:57
5164,197,4,1126,146,1272,5110,2021-01-26 08:02:53
5165,894,3,1047,136,1183,5111,2021-01-26 01:09:28
5166,814,3,1247,162,1409,5112,2021-01-26 03:46:47
5167,303,2,429,55,484,5113,2021-01-26 06:33:57
5168,569,3,808,105,913,5114,2021-01-25 20:00:39
5169,978,3,478,62,540,5115,2021-01-26 04:57:32
5170,49,3,1327,172,1499,5116,2021-01-26 10:20:03
5171,397,3,597,77,674,5117,2021-01-26 10:11:51
5172,808,2,528,68,596,5118,2021-01-26 16:21:34
5173,148,6,1416,184,1600,5119,2021-01-26 18:19:54
5174,345,2,329,42,371,5120,2021-01-26 19:31:31
5175,565,4,1226,159,1385,5121,2021-01-26 07:55:37
5176,536,3,688,89,777,5122,2021-01-26 05:18:04
5177,833,5,1855,241,2096,5123,2021-01-26 08:43:06
5178,193,5,1795,233,2028,5124,2021-01-26 12:40:25
5179,473,2,429,55,484,5125,2021-01-26 16:40:35
5180,124,2,459,59,518,5126,2021-01-27 21:31:35
5181,124,2,459,59,518,5126,2021-01-27 21:31:35
5182,85,3,688,89,777,5127,2021-01-27 15:40:00
5183,517,2,459,59,518,5128,2021-01-26 23:51:16
5184,517,2,459,59,518,5128,2021-01-26 23:51:16
5185,860,2,898,116,1014,5129,2021-01-26 22:32:44
5186,646,3,597,77,674,5130,2021-01-27 06:17:19
5187,467,3,1127,146,1273,5131,2021-01-27 18:46:53
5188,396,3,647,84,731,5132,2021-01-27 20:48:16
5189,331,2,659,85,744,5133,2021-01-27 05:06:56
5190,884,3,658,85,743,5134,2021-01-27 09:07:51
5191,66,2,898,116,1014,5135,2021-01-27 23:37:08
5192,182,2,429,55,484,5136,2021-01-28 01:46:45
5193,71,3,747,97,844,5137,2021-01-28 01:50:29
5194,323,3,597,77,674,5138,2021-01-27 23:00:52
5195,781,5,1076,139,1215,5139,2021-01-27 11:14:41
5196,561,2,329,42,371,5140,2021-01-28 05:47:04
5197,489,3,478,62,540,5141,2021-01-28 03:25:45
5198,296,5,1745,226,1971,5142,2021-01-27 14:01:10
5199,329,2,459,59,518,5143,2021-01-27 10:50:54
5200,233,3,888,115,1003,5144,2021-01-26 13:25:20
5201,51,2,498,64,562,5145,2021-01-26 17:47:39
5202,532,3,658,85,743,5146,2021-01-26 20:54:23
5203,232,2,429,55,484,5147,2021-01-26 20:00:24
5204,107,3,1127,146,1273,5148,2021-01-26 15:35:31
5205,793,2,898,116,1014,5149,2021-01-26 19:25:20
5206,645,6,2074,269,2343,5150,2021-01-26 20:13:05
5207,701,2,528,68,596,5151,2021-01-26 23:41:56
5208,880,2,628,81,709,5152,2021-01-27 05:51:19
5209,23,2,698,90,788,5153,2021-01-26 21:29:26
5210,135,3,747,97,844,5154,2021-01-27 06:09:51
5211,799,3,797,103,900,5155,2021-01-27 04:21:14
5212,368,4,1396,181,1577,5156,2021-01-27 10:02:56
5213,735,4,1057,137,1194,5157,2021-01-27 03:13:25
5214,153,3,528,68,596,5158,2021-01-27 06:09:51
5215,458,2,498,64,562,5159,2021-01-27 05:19:23
5216,799,3,578,75,653,5160,2021-01-26 16:43:49
5217,476,2,898,116,1014,5161,2021-01-26 15:28:40
5218,513,3,697,90,787,5162,2021-01-26 23:24:18
5219,173,2,429,55,484,5163,2021-01-27 05:47:16
5220,150,5,1595,207,1802,5164,2021-01-27 04:52:10
5221,806,1,399,51,450,5165,2021-01-26 20:29:06
5222,768,3,558,72,630,5166,2021-01-26 09:50:20
5223,833,3,827,107,934,5167,2021-01-26 01:29:27
5224,736,3,797,103,900,5168,2021-01-26 04:17:37
5225,466,3,1047,136,1183,5169,2021-01-26 07:45:38
5226,358,3,658,85,743,5170,2021-01-25 22:24:16
5227,197,3,897,116,1013,5171,2021-01-26 06:18:32
5228,219,3,1197,155,1352,5172,2021-01-26 11:10:54
5229,509,3,1127,146,1273,5173,2021-01-26 12:37:05
5230,276,3,658,85,743,5174,2021-01-26 16:52:52
5231,268,3,747,97,844,5175,2021-01-26 19:26:44
5232,470,6,1855,241,2096,5176,2021-01-26 22:10:12
5233,741,4,1246,161,1407,5177,2021-01-26 09:46:46
5234,745,3,727,94,821,5178,2021-01-26 06:08:05
5235,704,1,149,19,168,5179,2021-01-26 09:33:23
5236,919,3,428,55,483,5180,2021-01-26 15:23:32
5237,324,3,1047,136,1183,5181,2021-01-26 18:55:39
5238,785,3,927,120,1047,5182,2021-01-27 22:34:54
5239,726,3,1027,133,1160,5183,2021-01-28 00:04:09
5240,802,3,1327,172,1499,5184,2021-01-27 16:33:33
5241,300,6,1835,238,2073,5185,2021-01-27 00:20:20
5242,43,3,747,97,844,5186,2021-01-27 01:00:04
5243,802,5,1606,208,1814,5187,2021-01-27 00:17:16
5244,357,5,1326,172,1498,5188,2021-01-27 06:37:16
5245,137,3,688,89,777,5189,2021-01-27 18:48:51
5246,206,3,808,105,913,5190,2021-01-27 20:58:39
5247,361,3,1047,136,1183,5191,2021-01-27 07:48:16
5248,125,1,499,64,563,5192,2021-01-27 09:34:59
5249,655,3,597,77,674,5193,2021-01-28 00:13:56
5250,116,3,997,129,1126,5194,2021-01-28 03:35:43
5251,915,3,647,84,731,5195,2021-01-28 03:46:59
5252,601,3,888,115,1003,5196,2021-01-28 01:25:16
5253,753,3,1247,162,1409,5197,2021-01-27 13:13:58
5254,624,3,608,79,687,5198,2021-01-28 05:48:03
5255,695,3,528,68,596,5199,2021-01-28 04:22:58
5256,881,1,499,64,563,5200,2021-01-27 16:03:49
5257,849,3,847,110,957,5201,2021-01-27 13:33:30
5258,863,3,947,123,1070,5202,2021-01-26 14:47:27
5259,907,3,1127,146,1273,5203,2021-01-26 19:53:01
5260,147,2,528,68,596,5204,2021-01-26 22:23:46
5261,236,1,149,19,168,5205,2021-01-26 20:59:47
5262,57,3,1197,155,1352,5206,2021-01-26 17:37:00
5263,6,1,99,12,111,5207,2021-01-26 20:25:46
5264,33,1,699,90,789,5208,2021-01-26 20:50:09
5265,467,3,1047,136,1183,5209,2021-01-27 00:23:05
5266,736,3,947,123,1070,5210,2021-01-27 07:14:14
5267,812,3,597,77,674,5211,2021-01-26 22:15:23
5268,154,3,808,105,913,5212,2021-01-27 08:37:07
5269,147,3,558,72,630,5213,2021-01-27 05:44:11
5270,861,2,598,77,675,5214,2021-01-27 10:25:48
5271,631,1,399,51,450,5215,2021-01-27 04:00:58
5272,278,6,1505,195,1700,5216,2021-01-27 07:59:57
5273,4,3,647,84,731,5217,2021-01-27 08:02:37
5274,667,2,698,90,788,5218,2021-01-26 19:08:30
5275,416,3,797,103,900,5219,2021-01-26 16:02:13
5276,842,3,1027,133,1160,5220,2021-01-27 01:27:38
5277,872,1,299,38,337,5221,2021-01-27 08:22:10
5278,582,3,528,68,596,5222,2021-01-27 07:26:45
5279,721,3,1197,155,1352,5223,2021-01-26 21:01:18
5280,441,3,1197,155,1352,5224,2021-01-26 11:35:32
5281,581,2,429,55,484,5225,2021-01-26 03:18:48
5282,493,3,697,90,787,5226,2021-01-26 04:27:25
5283,895,3,747,97,844,5227,2021-01-26 08:59:46
5284,323,3,888,115,1003,5228,2021-01-25 23:11:29
5285,632,3,558,72,630,5229,2021-01-26 07:47:23
5286,669,3,947,123,1070,5230,2021-01-26 12:54:00
5287,36,3,647,84,731,5231,2021-01-26 12:48:48
5288,691,2,659,85,744,5232,2021-01-26 18:33:30
5289,573,4,927,120,1047,5233,2021-01-26 20:52:42
5290,573,4,927,120,1047,5233,2021-01-26 20:52:42
5291,888,3,828,107,935,5234,2021-01-26 23:56:10
5292,934,3,897,116,1013,5235,2021-01-26 09:52:01
5293,453,4,627,81,708,5236,2021-01-26 06:41:51
5294,724,2,898,116,1014,5237,2021-01-26 09:45:44
5295,991,6,1255,163,1418,5238,2021-01-26 16:24:00
5296,871,3,808,105,913,5239,2021-01-26 21:06:54
5297,440,3,1327,172,1499,5240,2021-01-27 23:31:37
5298,580,3,528,68,596,5241,2021-01-28 00:27:06
5299,324,3,1197,155,1352,5242,2021-01-27 16:34:50
5300,463,3,727,94,821,5243,2021-01-27 03:02:10
5301,337,3,1327,172,1499,5244,2021-01-27 01:22:41
5302,714,6,1244,161,1405,5245,2021-01-27 02:09:21
5303,845,3,697,90,787,5246,2021-01-27 07:09:56
5304,880,3,827,107,934,5247,2021-01-27 19:57:53
5305,79,3,528,68,596,5248,2021-01-27 22:03:01
5306,522,2,329,42,371,5249,2021-01-27 08:20:07
5307,50,3,797,103,900,5250,2021-01-27 10:03:10
5308,1,3,1327,172,1499,5251,2021-01-28 00:20:38
5309,320,3,797,103,900,5252,2021-01-28 04:32:27
5310,540,3,888,115,1003,5253,2021-01-28 05:55:51
5311,588,3,1047,136,1183,5254,2021-01-28 03:46:26
5312,955,4,1296,168,1464,5255,2021-01-27 14:27:22
5313,289,3,597,77,674,5256,2021-01-28 07:53:52
5314,328,3,1327,172,1499,5257,2021-01-28 04:35:37
5315,816,4,1187,154,1341,5258,2021-01-27 18:25:31
5316,527,3,1027,133,1160,5259,2021-01-27 14:34:49
5317,449,3,1047,136,1183,5260,2021-01-26 17:20:51
5318,112,3,747,97,844,5261,2021-01-26 21:18:03
5319,123,3,597,77,674,5262,2021-01-26 23:25:02
5320,620,3,897,116,1013,5263,2021-01-26 21:17:38
5321,832,3,727,94,821,5264,2021-01-26 19:11:00
5322,327,3,997,129,1126,5265,2021-01-26 21:55:29
5323,802,2,928,120,1048,5266,2021-01-26 23:20:54
5324,897,3,827,107,934,5267,2021-01-27 01:35:51
5325,581,3,1047,136,1183,5268,2021-01-27 07:51:58
5326,874,3,528,68,596,5269,2021-01-27 00:09:28
5327,140,3,1197,155,1352,5270,2021-01-27 10:13:40
5328,961,3,897,116,1013,5271,2021-01-27 07:15:52
5329,249,3,428,55,483,5272,2021-01-27 10:47:11
5330,106,3,947,123,1070,5273,2021-01-27 06:30:26
5331,121,4,846,109,955,5274,2021-01-27 08:12:00
5332,426,3,1327,172,1499,5275,2021-01-27 09:00:03
5333,49,3,558,72,630,5276,2021-01-26 20:19:24
5334,84,3,997,129,1126,5277,2021-01-26 17:41:23
5335,677,3,758,98,856,5278,2021-01-27 02:52:10
5336,672,3,688,89,777,5279,2021-01-27 10:17:44
5337,26,1,299,38,337,5280,2021-01-27 08:15:47
5338,110,3,888,115,1003,5281,2021-01-26 21:32:19
5339,70,2,698,90,788,5282,2021-01-26 12:38:37
5340,548,3,758,98,856,5283,2021-01-26 05:55:45
5341,316,1,229,29,258,5284,2021-01-26 07:08:25
5342,780,6,1574,204,1778,5285,2021-01-26 10:50:32
5343,460,3,428,55,483,5286,2021-01-26 00:01:53
5344,515,1,149,19,168,5287,2021-01-26 09:15:12
5345,11,2,898,116,1014,5288,2021-01-26 14:27:56
5346,234,2,498,64,562,5289,2021-01-26 15:35:09
5347,298,3,658,85,743,5290,2021-01-26 18:57:21
5348,680,3,1047,136,1183,5291,2021-01-26 21:55:19
5349,135,1,699,90,789,5292,2021-01-26 21:56:46
5350,336,3,827,107,934,5293,2021-01-27 01:33:44
5351,976,3,758,98,856,5294,2021-01-26 10:18:24
5352,688,3,797,103,900,5295,2021-01-26 06:48:46
5353,110,3,1197,155,1352,5296,2021-01-26 11:25:10
5354,907,5,1686,219,1905,5297,2021-01-26 18:41:36
5355,704,2,598,77,675,5298,2021-01-26 22:15:28
5356,811,2,598,77,675,5299,2021-01-28 01:22:20
5357,631,3,997,129,1126,5300,2021-01-28 01:55:25
5358,358,2,598,77,675,5301,2021-01-27 16:51:29
5359,253,3,1047,136,1183,5302,2021-01-27 04:04:32
5360,397,3,1127,146,1273,5303,2021-01-27 01:37:52
5361,196,2,498,64,562,5304,2021-01-27 02:10:31
5362,108,3,478,62,540,5305,2021-01-27 07:31:22
5363,434,2,898,116,1014,5306,2021-01-27 22:00:43
5364,663,2,498,64,562,5307,2021-01-27 23:03:28
5365,144,3,578,75,653,5308,2021-01-27 08:42:43
5366,782,2,659,85,744,5309,2021-01-27 10:34:33
5367,975,5,1245,161,1406,5310,2021-01-28 01:28:50
5368,910,3,558,72,630,5311,2021-01-28 04:40:22
5369,318,3,927,120,1047,5312,2021-01-28 07:12:30
5370,136,3,697,90,787,5313,2021-01-28 06:14:45
5371,862,3,428,55,483,5314,2021-01-27 15:10:44
5372,646,3,428,55,483,5315,2021-01-28 10:14:40
5373,579,3,1127,146,1273,5316,2021-01-28 06:19:26
5374,455,3,528,68,596,5317,2021-01-27 19:27:06
5375,708,3,1127,146,1273,5318,2021-01-27 14:57:26
5376,855,3,1327,172,1499,5319,2021-01-26 17:37:59
5377,157,3,558,72,630,5320,2021-01-27 00:00:23
5378,693,3,697,90,787,5321,2021-01-26 23:39:14
5379,655,2,398,51,449,5322,2021-01-26 23:13:37
5380,672,3,747,97,844,5323,2021-01-26 21:56:24
5381,744,3,597,77,674,5324,2021-01-26 23:33:16
5382,494,2,798,103,901,5325,2021-01-26 23:32:05
5383,601,2,898,116,1014,5326,2021-01-27 04:16:45
5384,172,2,459,59,518,5327,2021-01-27 09:27:10
5385,265,3,808,105,913,5328,2021-01-27 02:53:38
5386,351,4,1396,181,1577,5329,2021-01-27 11:44:22
5387,688,3,997,129,1126,5330,2021-01-27 09:52:04
5388,904,2,429,55,484,5331,2021-01-27 13:21:11
5389,63,5,1656,215,1871,5332,2021-01-27 07:35:39
5390,633,2,548,71,619,5333,2021-01-27 09:15:32
5391,993,3,927,120,1047,5334,2021-01-27 10:39:24
5392,675,3,608,79,687,5335,2021-01-26 21:55:08
5393,381,3,997,129,1126,5336,2021-01-26 19:11:14
5394,762,3,528,68,596,5337,2021-01-27 04:04:24
5395,440,2,659,85,744,5338,2021-01-27 12:02:30
5396,198,3,478,62,540,5339,2021-01-27 10:25:59
5397,672,2,598,77,675,5340,2021-01-27 00:12:03
5398,672,6,1735,225,1960,5341,2021-01-26 13:26:22
5399,751,2,898,116,1014,5342,2021-01-26 06:01:53
5400,76,3,697,90,787,5343,2021-01-26 09:44:49
5401,472,3,747,97,844,5344,2021-01-26 13:10:14
5402,417,3,997,129,1126,5345,2021-01-26 01:56:53
5403,288,5,1406,182,1588,5346,2021-01-26 09:23:09
5404,973,2,898,116,1014,5347,2021-01-26 15:30:16
5405,660,1,99,12,111,5348,2021-01-26 17:07:55
5406,129,2,459,59,518,5349,2021-01-26 19:59:01
5407,20,5,937,121,1058,5350,2021-01-27 00:38:56
5408,645,2,898,116,1014,5351,2021-01-26 22:14:29
5409,491,3,528,68,596,5352,2021-01-27 04:20:19
5410,879,3,1247,162,1409,5353,2021-01-26 11:34:57
5411,151,2,898,116,1014,5354,2021-01-26 08:34:39
5412,144,3,558,72,630,5355,2021-01-26 12:08:23
5413,260,2,659,85,744,5356,2021-01-26 21:20:00
5414,753,3,1127,146,1273,5357,2021-01-26 22:15:32
5415,745,3,827,107,934,5358,2021-01-28 02:07:37
5416,967,5,1206,156,1362,5359,2021-01-28 03:13:26
5417,762,1,699,90,789,5360,2021-01-27 19:36:00
5418,52,1,299,38,337,5361,2021-01-27 05:42:53
5419,362,3,827,107,934,5362,2021-01-27 02:36:01
5420,731,2,528,68,596,5363,2021-01-27 04:38:17
5421,731,2,528,68,596,5363,2021-01-27 04:38:17
5422,993,2,528,68,596,5364,2021-01-27 08:23:13
5423,993,2,528,68,596,5364,2021-01-27 08:23:13
5424,859,3,1327,172,1499,5365,2021-01-27 23:09:24
5425,622,2,628,81,709,5366,2021-01-28 01:36:20
5426,198,2,498,64,562,5367,2021-01-27 08:42:58
5427,134,2,459,59,518,5368,2021-01-27 12:53:59
5428,281,3,758,98,856,5369,2021-01-28 04:02:41
5429,551,3,947,123,1070,5370,2021-01-28 05:00:34
5430,984,3,528,68,596,5371,2021-01-28 08:45:40
5431,812,2,798,103,901,5372,2021-01-28 06:53:43
5432,745,3,558,72,630,5373,2021-01-27 15:37:30
5433,852,1,399,51,450,5374,2021-01-28 12:47:27
5434,803,4,976,126,1102,5375,2021-01-28 07:42:47
5435,692,2,329,42,371,5376,2021-01-27 22:09:42
5436,687,3,1327,172,1499,5377,2021-01-27 17:27:27
5437,573,3,897,116,1013,5378,2021-01-26 17:53:32
5438,118,3,1147,149,1296,5379,2021-01-27 02:30:02
5439,622,3,847,110,957,5380,2021-01-27 02:14:31
5440,887,3,1027,133,1160,5381,2021-01-26 23:47:22
5441,98,5,1375,178,1553,5382,2021-01-26 23:09:37
5442,281,3,597,77,674,5383,2021-01-27 01:38:11
5443,569,1,149,19,168,5384,2021-01-27 02:09:37
5444,55,6,1605,208,1813,5385,2021-01-27 04:40:34
5445,165,5,1706,221,1927,5386,2021-01-27 11:24:15
5446,146,3,528,68,596,5387,2021-01-27 05:36:35
5447,803,4,1207,156,1363,5388,2021-01-27 12:42:14
5448,877,2,598,77,675,5389,2021-01-27 11:50:41
5449,686,2,698,90,788,5390,2021-01-27 13:40:51
5450,702,2,898,116,1014,5391,2021-01-27 08:06:41
5451,818,2,898,116,1014,5392,2021-01-27 10:04:36
5452,896,3,808,105,913,5393,2021-01-27 11:35:57
5453,272,2,498,64,562,5394,2021-01-26 23:13:35
5454,767,3,747,97,844,5395,2021-01-26 21:48:11
5455,767,3,747,97,844,5395,2021-01-26 21:48:11
5456,924,3,558,72,630,5396,2021-01-27 05:33:25
5457,799,2,659,85,744,5397,2021-01-27 12:24:07
5458,506,5,1076,139,1215,5398,2021-01-27 12:44:12
5459,500,3,747,97,844,5399,2021-01-27 00:25:44
5460,283,3,1047,136,1183,5400,2021-01-26 15:23:49
5461,288,3,697,90,787,5401,2021-01-26 06:28:25
5462,589,2,898,116,1014,5402,2021-01-26 11:11:08
5463,565,5,1245,161,1406,5403,2021-01-26 14:12:16
5464,824,3,597,77,674,5404,2021-01-26 04:22:48
5465,368,2,598,77,675,5405,2021-01-26 11:02:45
5466,794,1,99,12,111,5406,2021-01-26 18:10:21
5467,891,2,1098,142,1240,5407,2021-01-26 19:41:44
5468,73,2,898,116,1014,5408,2021-01-26 20:47:25
5469,899,3,578,75,653,5409,2021-01-27 02:48:17
5470,609,3,1047,136,1183,5410,2021-01-26 23:45:36
5471,270,5,1406,182,1588,5411,2021-01-27 06:58:07
5472,671,1,599,77,676,5412,2021-01-26 13:59:25
5473,385,3,1247,162,1409,5413,2021-01-26 11:08:19
5474,374,3,1197,155,1352,5414,2021-01-26 14:31:54
5475,169,3,428,55,483,5415,2021-01-26 21:34:05
5476,740,3,947,123,1070,5416,2021-01-26 23:38:59
5477,562,2,459,59,518,5417,2021-01-28 02:52:20
5478,322,3,927,120,1047,5418,2021-01-28 04:08:20
5479,559,6,1705,221,1926,5419,2021-01-27 20:20:01
5480,996,2,329,42,371,5420,2021-01-27 08:10:36
5481,802,3,827,107,934,5421,2021-01-27 04:01:14
5482,257,3,688,89,777,5422,2021-01-27 05:36:05
5483,267,3,747,97,844,5423,2021-01-27 06:28:35
5484,93,2,628,81,709,5424,2021-01-27 10:08:57
5485,935,3,1047,136,1183,5425,2021-01-27 09:48:50
5486,915,3,797,103,900,5426,2021-01-27 23:34:24
5487,387,3,608,79,687,5427,2021-01-28 01:42:36
5488,676,3,688,89,777,5428,2021-01-27 11:06:37
5489,39,3,947,123,1070,5429,2021-01-27 14:56:25
5490,471,3,827,107,934,5430,2021-01-28 05:41:34
5491,796,6,1805,234,2039,5431,2021-01-28 06:10:53
5492,841,2,828,107,935,5432,2021-01-28 08:56:36
5493,521,2,698,90,788,5433,2021-01-28 07:22:41
5494,618,2,329,42,371,5434,2021-01-27 17:25:43
5495,656,2,898,116,1014,5435,2021-01-28 14:07:15
5496,173,4,1726,224,1950,5436,2021-01-28 10:15:39
5497,952,4,887,115,1002,5437,2021-01-27 23:41:43
5498,114,2,429,55,484,5438,2021-01-27 18:04:46
5499,543,3,1127,146,1273,5439,2021-01-26 19:19:53
5500,526,3,897,116,1013,5440,2021-01-27 05:00:43
5501,892,3,608,79,687,5441,2021-01-27 02:46:19
5502,288,6,1125,146,1271,5442,2021-01-27 01:39:57
5503,852,3,758,98,856,5443,2021-01-26 23:47:04
5504,657,2,429,55,484,5444,2021-01-27 04:19:21
5505,109,3,688,89,777,5445,2021-01-27 03:41:39
5506,124,2,659,85,744,5446,2021-01-27 07:08:37
5507,5,3,697,90,787,5447,2021-01-27 13:32:39
5508,937,2,648,84,732,5448,2021-01-27 07:16:31
5509,288,6,1724,224,1948,5449,2021-01-27 14:06:59
5510,285,3,997,129,1126,5450,2021-01-27 13:09:18
5511,4,2,898,116,1014,5451,2021-01-27 14:29:49
5512,384,2,659,85,744,5452,2021-01-27 08:31:45
5513,284,2,329,42,371,5453,2021-01-27 11:46:59
5514,819,4,1296,168,1464,5454,2021-01-27 11:41:48
5515,98,6,1644,213,1857,5455,2021-01-27 00:59:44
5516,100,3,727,94,821,5456,2021-01-26 22:58:27
5517,600,2,429,55,484,5457,2021-01-26 22:33:14
5518,311,2,598,77,675,5458,2021-01-27 07:58:14
5519,155,3,688,89,777,5459,2021-01-27 14:29:33
5520,483,2,598,77,675,5460,2021-01-27 14:00:41
5521,670,3,1127,146,1273,5461,2021-01-27 02:43:26
5522,887,2,329,42,371,5462,2021-01-26 16:38:29
5523,420,3,528,68,596,5463,2021-01-26 06:54:54
5524,559,3,997,129,1126,5464,2021-01-26 12:59:37
5525,969,3,797,103,900,5465,2021-01-26 16:39:30
5526,547,5,1845,239,2084,5466,2021-01-26 05:36:25
5527,725,2,598,77,675,5467,2021-01-26 11:37:12
5528,520,2,798,103,901,5468,2021-01-26 19:20:27
5529,604,3,597,77,674,5469,2021-01-26 20:47:34
5530,662,3,1027,133,1160,5470,2021-01-26 22:42:34
5531,654,2,548,71,619,5471,2021-01-27 03:35:39
5532,508,3,578,75,653,5472,2021-01-27 02:03:48
5533,916,2,628,81,709,5473,2021-01-27 08:08:10
5534,463,2,659,85,744,5474,2021-01-26 15:58:45
5535,179,2,628,81,709,5475,2021-01-26 11:35:50
5536,375,6,1305,169,1474,5476,2021-01-26 16:59:40
5537,229,2,698,90,788,5477,2021-01-26 22:58:19
5538,106,3,688,89,777,5478,2021-01-26 23:43:17
5539,590,3,478,62,540,5479,2021-01-28 03:10:46
5540,56,3,478,62,540,5480,2021-01-28 04:15:33
5541,66,2,329,42,371,5481,2021-01-27 21:26:15
5542,688,2,429,55,484,5482,2021-01-27 10:17:50
5543,870,2,498,64,562,5483,2021-01-27 06:15:11
5544,87,3,747,97,844,5484,2021-01-27 05:58:41
5545,536,3,1027,133,1160,5485,2021-01-27 08:25:24
5546,19,6,1855,241,2096,5486,2021-01-27 11:30:31
5547,374,5,1156,150,1306,5487,2021-01-27 12:06:24
5548,561,2,598,77,675,5488,2021-01-27 23:45:24
5549,234,2,548,71,619,5489,2021-01-28 03:02:35
5550,255,3,857,111,968,5490,2021-01-27 11:30:50
5551,590,3,1327,172,1499,5491,2021-01-27 17:20:23
5552,576,4,1246,161,1407,5492,2021-01-28 06:04:14
5553,15,2,828,107,935,5493,2021-01-28 08:18:56
5554,403,3,758,98,856,5494,2021-01-28 10:23:35
5555,417,3,997,129,1126,5495,2021-01-28 08:11:56
5556,208,3,888,115,1003,5496,2021-01-27 18:36:26
5557,949,3,997,129,1126,5497,2021-01-28 15:19:41
5558,232,3,747,97,844,5498,2021-01-28 12:54:24
5559,642,2,898,116,1014,5499,2021-01-28 01:08:19
5560,921,3,1127,146,1273,5500,2021-01-27 20:36:13
5561,408,1,229,29,258,5501,2021-01-26 20:06:18
5562,736,2,329,42,371,5502,2021-01-27 06:42:44
5563,966,2,459,59,518,5503,2021-01-27 03:36:00
5564,53,5,1695,220,1915,5504,2021-01-27 03:58:52
5565,710,3,1127,146,1273,5505,2021-01-27 02:16:58
5566,243,2,798,103,901,5506,2021-01-27 07:03:16
5567,713,3,647,84,731,5507,2021-01-27 04:04:53
5568,842,3,1127,146,1273,5508,2021-01-27 07:33:17
5569,475,1,229,29,258,5509,2021-01-27 15:41:12
5570,134,3,758,98,856,5510,2021-01-27 07:49:03
5571,232,3,827,107,934,5511,2021-01-27 14:20:31
5572,892,3,1047,136,1183,5512,2021-01-27 13:54:02
5573,458,2,329,42,371,5513,2021-01-27 16:31:24
5574,705,3,897,116,1013,5514,2021-01-27 08:38:53
5575,941,2,598,77,675,5515,2021-01-27 12:15:51
5576,167,3,1327,172,1499,5516,2021-01-27 13:42:14
5577,196,5,1325,172,1497,5517,2021-01-27 01:34:04
5578,16,2,659,85,744,5518,2021-01-26 23:34:37
5579,420,2,498,64,562,5519,2021-01-26 22:56:57
5580,217,2,598,77,675,5520,2021-01-27 09:55:27
5581,805,3,1127,146,1273,5521,2021-01-27 15:44:17
5582,652,2,398,51,449,5522,2021-01-27 14:12:48
5583,361,3,947,123,1070,5523,2021-01-27 04:36:42
5584,462,2,928,120,1048,5524,2021-01-26 17:01:38
5585,639,2,698,90,788,5525,2021-01-26 09:08:58
5586,789,3,558,72,630,5526,2021-01-26 13:24:52
5587,777,3,927,120,1047,5527,2021-01-26 17:04:38
5588,935,3,658,85,743,5528,2021-01-26 06:23:32
5589,235,3,608,79,687,5529,2021-01-26 12:43:04
5590,542,3,847,110,957,5530,2021-01-26 21:09:42
5591,71,3,1047,136,1183,5531,2021-01-26 21:01:19
5592,818,3,1127,146,1273,5532,2021-01-26 22:49:43
5593,571,3,608,79,687,5533,2021-01-27 03:35:50
5594,957,3,758,98,856,5534,2021-01-27 02:23:22
5595,330,5,1845,239,2084,5535,2021-01-27 08:35:56
5596,234,2,1098,142,1240,5536,2021-01-26 18:25:12
5597,38,4,1246,161,1407,5537,2021-01-26 12:11:36
5598,956,2,498,64,562,5538,2021-01-26 18:00:24
5599,100,3,997,129,1126,5539,2021-01-27 00:56:35
5600,71,3,1047,136,1183,5540,2021-01-27 00:23:55
5601,809,6,1654,215,1869,5541,2021-01-28 05:36:17
5602,809,6,1654,215,1869,5541,2021-01-28 05:36:17
5603,555,2,498,64,562,5542,2021-01-28 05:00:43
5604,15,6,2374,308,2682,5543,2021-01-27 22:03:15
5605,40,3,797,103,900,5544,2021-01-27 12:24:40
5606,999,2,598,77,675,5545,2021-01-27 07:34:27
5607,937,3,847,110,957,5546,2021-01-27 06:59:30
5608,99,3,947,123,1070,5547,2021-01-27 11:09:36
5609,157,1,399,51,450,5548,2021-01-27 12:39:48
5610,380,3,697,90,787,5549,2021-01-27 14:37:28
5611,780,3,1047,136,1183,5550,2021-01-28 00:21:12
5612,787,3,727,94,821,5551,2021-01-28 05:43:48
5613,797,2,528,68,596,5552,2021-01-27 11:45:06
5614,660,2,698,90,788,5553,2021-01-27 19:32:17
5615,230,2,798,103,901,5554,2021-01-28 08:30:26
5616,230,2,798,103,901,5554,2021-01-28 08:30:26
5617,756,2,698,90,788,5555,2021-01-28 08:42:56
5618,565,3,597,77,674,5556,2021-01-28 12:34:02
5619,856,3,727,94,821,5557,2021-01-28 08:54:25
5620,849,2,429,55,484,5558,2021-01-27 21:08:43
5621,707,2,898,116,1014,5559,2021-01-28 16:16:01
5622,368,3,647,84,731,5560,2021-01-28 12:55:11
5623,225,5,1586,206,1792,5561,2021-01-28 01:51:27
5624,743,2,659,85,744,5562,2021-01-27 21:06:02
5625,337,2,329,42,371,5563,2021-01-26 20:48:20
5626,999,3,727,94,821,5564,2021-01-27 06:45:10
5627,438,3,747,97,844,5565,2021-01-27 05:07:18
5628,187,3,1047,136,1183,5566,2021-01-27 06:29:07
5629,699,3,947,123,1070,5567,2021-01-27 03:16:47
5630,780,3,647,84,731,5568,2021-01-27 09:38:25
5631,862,2,798,103,901,5569,2021-01-27 06:21:52
5632,640,3,1247,162,1409,5570,2021-01-27 08:38:46
5633,853,3,727,94,821,5571,2021-01-27 15:53:29
5634,197,3,578,75,653,5572,2021-01-27 09:35:41
5635,442,2,898,116,1014,5573,2021-01-27 14:24:01
5636,700,2,459,59,518,5574,2021-01-27 14:05:21
5637,700,2,459,59,518,5574,2021-01-27 14:05:21
5638,635,3,697,90,787,5575,2021-01-27 17:50:35
5639,635,3,697,90,787,5575,2021-01-27 17:50:35
5640,223,5,2025,263,2288,5576,2021-01-27 10:25:39
5641,678,2,548,71,619,5577,2021-01-27 14:22:36
5642,392,2,459,59,518,5578,2021-01-27 16:00:57
5643,730,2,728,94,822,5579,2021-01-27 03:25:56
5644,128,3,997,129,1126,5580,2021-01-27 02:07:21
5645,162,3,1127,146,1273,5581,2021-01-26 23:12:06
5646,38,3,997,129,1126,5582,2021-01-27 11:57:50
5647,527,2,698,90,788,5583,2021-01-27 17:16:04
5648,777,2,898,116,1014,5584,2021-01-27 14:35:23
5649,507,3,827,107,934,5585,2021-01-27 07:15:31
5650,181,2,598,77,675,5586,2021-01-26 18:26:14
5651,37,3,827,107,934,5587,2021-01-26 10:35:07
5652,20,6,1166,151,1317,5588,2021-01-26 14:40:42
5653,198,1,299,38,337,5589,2021-01-26 17:40:40
5654,994,5,2095,272,2367,5590,2021-01-26 08:37:51
5655,496,3,578,75,653,5591,2021-01-26 13:08:01
5656,583,3,578,75,653,5592,2021-01-26 22:37:51
5657,650,2,459,59,518,5593,2021-01-26 21:05:46
5658,916,2,1098,142,1240,5594,2021-01-27 01:18:23
5659,769,2,498,64,562,5595,2021-01-27 06:16:52
5660,112,3,997,129,1126,5596,2021-01-27 03:38:14
5661,493,3,658,85,743,5597,2021-01-27 09:09:51
5662,685,2,429,55,484,5598,2021-01-26 19:28:05
5663,445,2,498,64,562,5599,2021-01-26 14:53:15
5664,427,2,598,77,675,5600,2021-01-26 19:53:27
5665,455,5,1376,178,1554,5601,2021-01-27 03:29:10
5666,487,3,608,79,687,5602,2021-01-27 00:27:56
5667,186,5,1217,158,1375,5603,2021-01-28 07:24:16
5668,846,3,827,107,934,5604,2021-01-28 06:38:14
5669,307,3,927,120,1047,5605,2021-01-28 05:17:11
5670,264,3,558,72,630,5606,2021-01-28 00:05:07
5671,852,3,1247,162,1409,5607,2021-01-27 13:27:23
5672,525,2,648,84,732,5608,2021-01-27 09:28:01
5673,440,2,848,110,958,5609,2021-01-27 07:25:34
5674,933,2,498,64,562,5610,2021-01-27 13:43:36
5675,451,3,428,55,483,5611,2021-01-27 13:30:46
5676,795,2,459,59,518,5612,2021-01-27 15:17:10
5677,659,3,558,72,630,5613,2021-01-28 00:57:17
5678,227,2,798,103,901,5614,2021-01-28 06:59:21
5679,168,3,727,94,821,5615,2021-01-27 13:39:07
5680,93,2,329,42,371,5616,2021-01-27 20:12:24
5681,793,2,429,55,484,5617,2021-01-28 11:08:54
5682,954,3,558,72,630,5618,2021-01-28 08:56:06
5683,697,3,578,75,653,5619,2021-01-28 10:21:43
5684,701,3,1127,146,1273,5620,2021-01-28 13:16:09
5685,620,5,1336,173,1509,5621,2021-01-28 11:24:41
5686,248,3,647,84,731,5622,2021-01-27 22:55:15
5687,635,6,1835,238,2073,5623,2021-01-28 18:19:49
5688,160,4,1596,207,1803,5624,2021-01-28 15:16:38
5689,495,1,99,12,111,5625,2021-01-28 02:13:27
5690,989,3,947,123,1070,5626,2021-01-27 21:15:03
5691,936,3,528,68,596,5627,2021-01-26 20:59:17
5692,630,3,888,115,1003,5628,2021-01-27 08:13:55
5693,583,2,598,77,675,5629,2021-01-27 06:08:00
5694,598,5,1925,250,2175,5630,2021-01-27 06:38:24
5695,229,3,727,94,821,5631,2021-01-27 04:58:15
5696,134,3,997,129,1126,5632,2021-01-27 10:13:45
5697,536,5,1725,224,1949,5633,2021-01-27 08:54:52
5698,209,2,429,55,484,5634,2021-01-27 10:34:41
5699,635,3,927,120,1047,5635,2021-01-27 15:58:52
5700,392,3,688,89,777,5636,2021-01-27 09:48:57
5701,563,3,697,90,787,5637,2021-01-27 16:08:04
5702,477,3,1127,146,1273,5638,2021-01-27 14:54:27
5703,786,2,659,85,744,5639,2021-01-27 14:21:45
5704,702,2,898,116,1014,5640,2021-01-27 18:58:21
5705,232,3,647,84,731,5641,2021-01-27 20:22:27
5706,482,1,99,12,111,5642,2021-01-27 11:54:59
5707,748,2,728,94,822,5643,2021-01-27 16:51:36
5708,822,3,1327,172,1499,5644,2021-01-27 16:12:58
5709,798,3,697,90,787,5645,2021-01-27 05:11:37
5710,342,3,1027,133,1160,5646,2021-01-27 03:13:39
5711,207,3,608,79,687,5647,2021-01-27 01:32:19
5712,671,3,558,72,630,5648,2021-01-27 14:42:28
5713,918,3,1027,133,1160,5649,2021-01-27 18:58:35
5714,711,3,558,72,630,5650,2021-01-27 16:14:04
5715,676,3,827,107,934,5651,2021-01-27 08:32:59
5716,949,2,598,77,675,5652,2021-01-26 21:01:02
5717,746,3,888,115,1003,5653,2021-01-26 12:34:46
5718,48,2,798,103,901,5654,2021-01-26 15:22:12
5719,478,3,558,72,630,5655,2021-01-26 17:51:51
5720,692,3,947,123,1070,5656,2021-01-26 09:26:24
5721,138,4,1257,163,1420,5657,2021-01-26 13:48:49
5722,193,5,1145,148,1293,5658,2021-01-26 22:53:38
5723,364,3,1327,172,1499,5659,2021-01-26 21:27:55
5724,108,2,798,103,901,5660,2021-01-27 03:06:51
5725,276,3,578,75,653,5661,2021-01-27 08:09:16
5726,376,5,1356,176,1532,5662,2021-01-27 06:01:48
5727,603,2,698,90,788,5663,2021-01-27 10:14:27
5728,494,2,898,116,1014,5664,2021-01-26 21:36:00
5729,459,3,927,120,1047,5665,2021-01-26 17:30:11
5730,761,5,1156,150,1306,5666,2021-01-26 21:32:34
5731,626,3,927,120,1047,5667,2021-01-27 05:12:42
5732,76,2,498,64,562,5668,2021-01-27 01:28:58
5733,165,2,598,77,675,5669,2021-01-28 07:52:54
5734,730,3,1127,146,1273,5670,2021-01-28 07:11:53
5735,990,6,1574,204,1778,5671,2021-01-28 07:23:38
5736,924,5,1795,233,2028,5672,2021-01-28 01:44:58
5737,466,3,808,105,913,5673,2021-01-27 16:05:51
5738,251,3,428,55,483,5674,2021-01-27 10:09:22
5739,524,3,747,97,844,5675,2021-01-27 09:48:29
5740,279,1,299,38,337,5676,2021-01-27 13:48:42
5741,998,1,99,12,111,5677,2021-01-27 13:42:21
5742,240,2,928,120,1048,5678,2021-01-27 15:31:52
5743,896,3,747,97,844,5679,2021-01-28 02:23:41
5744,17,2,898,116,1014,5680,2021-01-28 07:02:40
5745,841,2,459,59,518,5681,2021-01-27 14:26:45
5746,74,1,99,12,111,5682,2021-01-27 21:26:07
5747,57,4,1087,141,1228,5683,2021-01-28 13:20:07
5748,575,3,647,84,731,5684,2021-01-28 09:25:23
5749,175,3,658,85,743,5685,2021-01-28 12:36:36
5750,704,3,1047,136,1183,5686,2021-01-28 13:56:40
5751,757,3,658,85,743,5687,2021-01-28 13:11:12
5752,388,5,887,115,1002,5688,2021-01-28 00:36:48
5753,574,3,897,116,1013,5689,2021-01-28 20:04:08
5754,628,3,927,120,1047,5690,2021-01-28 15:22:56
5755,572,3,558,72,630,5691,2021-01-28 03:41:15
5756,707,1,229,29,258,5692,2021-01-27 22:36:38
5757,983,2,748,97,845,5693,2021-01-26 23:19:28
5758,84,2,398,51,449,5694,2021-01-27 09:34:15
5759,452,3,1247,162,1409,5695,2021-01-27 07:29:55
5760,521,2,648,84,732,5696,2021-01-27 09:20:42
5761,608,2,898,116,1014,5697,2021-01-27 05:03:46
5762,712,4,1096,142,1238,5698,2021-01-27 11:09:14
5763,800,2,498,64,562,5699,2021-01-27 11:16:58
5764,960,3,997,129,1126,5700,2021-01-27 13:13:48
5765,582,2,848,110,958,5701,2021-01-27 18:18:11
5766,269,2,648,84,732,5702,2021-01-27 11:56:10
5767,820,3,658,85,743,5703,2021-01-27 17:15:53
5768,626,3,827,107,934,5704,2021-01-27 15:19:07
5769,221,2,898,116,1014,5705,2021-01-27 14:34:11
5770,746,3,958,124,1082,5706,2021-01-27 19:56:10
5771,406,3,947,123,1070,5707,2021-01-27 20:53:47
5772,663,3,1127,146,1273,5708,2021-01-27 12:32:54
5773,175,3,697,90,787,5709,2021-01-27 19:35:00
5774,926,2,429,55,484,5710,2021-01-27 17:21:40
5775,355,3,688,89,777,5711,2021-01-27 06:34:37
5776,987,4,1207,156,1363,5712,2021-01-27 04:01:25
5777,496,3,927,120,1047,5713,2021-01-27 01:33:21
5778,368,3,997,129,1126,5714,2021-01-27 15:03:41
5779,875,2,329,42,371,5715,2021-01-27 20:56:12
5780,767,2,598,77,675,5716,2021-01-27 17:03:08
5781,182,1,229,29,258,5717,2021-01-27 09:27:16
5782,643,2,528,68,596,5718,2021-01-26 22:41:46
5783,330,3,647,84,731,5719,2021-01-26 13:16:26
5784,914,3,947,123,1070,5720,2021-01-26 18:03:03
5785,43,3,1047,136,1183,5721,2021-01-26 19:11:52
5786,787,3,1127,146,1273,5722,2021-01-26 11:56:41
5787,696,3,688,89,777,5723,2021-01-26 15:49:36
5788,747,2,798,103,901,5724,2021-01-27 00:05:55
5789,531,4,1526,198,1724,5725,2021-01-26 22:21:04
5790,660,1,399,51,450,5726,2021-01-27 04:19:50
5791,522,3,1027,133,1160,5727,2021-01-27 09:27:59
5792,764,3,1127,146,1273,5728,2021-01-27 06:35:06
5793,901,3,1127,146,1273,5729,2021-01-27 10:46:16
5794,322,3,1197,155,1352,5730,2021-01-26 23:10:59
5795,136,3,597,77,674,5731,2021-01-26 19:11:27
5796,918,3,597,77,674,5732,2021-01-26 22:06:37
5797,345,3,697,90,787,5733,2021-01-27 05:59:30
5798,82,3,597,77,674,5734,2021-01-27 02:20:53
5799,629,3,558,72,630,5735,2021-01-28 08:47:34
5800,51,3,888,115,1003,5736,2021-01-28 08:06:42
5801,115,2,898,116,1014,5737,2021-01-28 09:23:59
5802,122,1,399,51,450,5738,2021-01-28 02:23:30
5803,777,3,797,103,900,5739,2021-01-27 17:59:55
5804,805,3,827,107,934,5740,2021-01-27 11:39:50
5805,789,3,1327,172,1499,5741,2021-01-27 09:48:49
5806,991,3,997,129,1126,5742,2021-01-27 14:28:48
5807,221,3,808,105,913,5743,2021-01-27 16:06:32
5808,994,5,1755,228,1983,5744,2021-01-27 16:37:58
5809,611,3,897,116,1013,5745,2021-01-28 02:50:45
5810,236,3,558,72,630,5746,2021-01-28 08:14:26
5811,54,2,598,77,675,5747,2021-01-27 17:06:43
5812,866,5,1686,219,1905,5748,2021-01-27 23:37:37
5813,86,5,1117,145,1262,5749,2021-01-28 15:53:06
5814,116,2,659,85,744,5750,2021-01-28 09:52:50
5815,380,4,1826,237,2063,5751,2021-01-28 13:53:39
5816,554,3,697,90,787,5752,2021-01-28 13:57:16
5817,836,2,528,68,596,5753,2021-01-28 13:16:58
5818,422,4,1496,194,1690,5754,2021-01-28 03:10:03
5819,848,5,1376,178,1554,5755,2021-01-28 20:07:30
5820,186,3,528,68,596,5756,2021-01-28 16:44:28
5821,402,3,797,103,900,5757,2021-01-28 05:40:36
5822,912,3,647,84,731,5758,2021-01-28 00:42:52
5823,557,3,558,72,630,5759,2021-01-26 23:47:05
5824,648,2,898,116,1014,5760,2021-01-27 10:38:25
5825,507,3,1197,155,1352,5761,2021-01-27 08:08:58
5826,868,2,498,64,562,5762,2021-01-27 10:22:41
5827,131,2,398,51,449,5763,2021-01-27 07:00:26
5828,656,3,747,97,844,5764,2021-01-27 11:14:52
5829,859,3,827,107,934,5765,2021-01-27 12:57:23
5830,838,2,698,90,788,5766,2021-01-27 14:18:44
5831,940,3,697,90,787,5767,2021-01-27 18:25:02
5832,97,3,428,55,483,5768,2021-01-27 13:52:11
5833,676,3,478,62,540,5769,2021-01-27 19:58:09
5834,350,2,598,77,675,5770,2021-01-27 16:09:05
5835,175,3,1127,146,1273,5771,2021-01-27 15:15:32
5836,427,3,558,72,630,5772,2021-01-27 22:25:56
5837,631,3,808,105,913,5773,2021-01-27 21:49:57
5838,719,2,598,77,675,5774,2021-01-27 15:01:18
5839,436,5,1476,191,1667,5775,2021-01-27 20:55:01
5840,222,3,1027,133,1160,5776,2021-01-27 19:39:23
5841,296,3,897,116,1013,5777,2021-01-27 07:42:13
5842,944,2,698,90,788,5778,2021-01-27 04:46:16
5843,5,1,149,19,168,5779,2021-01-27 02:42:13
5844,805,2,598,77,675,5780,2021-01-27 17:12:10
5845,118,3,847,110,957,5781,2021-01-27 21:16:57
5846,832,2,898,116,1014,5782,2021-01-27 18:00:57
5847,518,5,1295,168,1463,5783,2021-01-27 10:02:20
5848,791,3,1127,146,1273,5784,2021-01-27 01:00:13
5849,165,3,1327,172,1499,5785,2021-01-26 14:34:10
5850,383,2,598,77,675,5786,2021-01-26 18:44:00
5851,751,2,498,64,562,5787,2021-01-26 19:51:15
5852,353,3,747,97,844,5788,2021-01-26 14:31:56
5853,909,3,647,84,731,5789,2021-01-26 18:14:52
5854,478,3,1027,133,1160,5790,2021-01-27 00:15:02
5855,241,2,498,64,562,5791,2021-01-27 00:31:19
5856,865,1,229,29,258,5792,2021-01-27 06:57:52
5857,914,2,659,85,744,5793,2021-01-27 11:38:48
5858,133,3,558,72,630,5794,2021-01-27 08:52:10
5859,173,3,927,120,1047,5795,2021-01-27 12:08:30
5860,498,3,478,62,540,5796,2021-01-27 00:53:10
5861,848,1,229,29,258,5797,2021-01-26 21:14:45
5862,391,1,599,77,676,5798,2021-01-26 22:55:19
5863,273,3,478,62,540,5799,2021-01-27 06:14:37
5864,815,3,1247,162,1409,5800,2021-01-27 02:26:41
5865,975,2,898,116,1014,5801,2021-01-28 09:08:55
5866,922,2,898,116,1014,5802,2021-01-28 10:15:39
5867,978,2,698,90,788,5803,2021-01-28 10:52:18
5868,847,3,847,110,957,5804,2021-01-28 03:06:27
5869,497,3,578,75,653,5805,2021-01-27 20:34:59
5870,143,3,997,129,1126,5806,2021-01-27 13:02:33
5871,751,4,1396,181,1577,5807,2021-01-27 10:34:21
5872,127,3,747,97,844,5808,2021-01-27 15:47:34
5873,148,6,1555,202,1757,5809,2021-01-27 17:23:52
5874,793,2,498,64,562,5810,2021-01-27 19:01:22
5875,513,3,797,103,900,5811,2021-01-28 05:37:07
5876,721,2,598,77,675,5812,2021-01-28 09:28:25
5877,889,3,697,90,787,5813,2021-01-27 19:29:48
5878,822,2,798,103,901,5814,2021-01-28 01:58:26
5879,574,3,1327,172,1499,5815,2021-01-28 16:02:48
5880,797,3,997,129,1126,5816,2021-01-28 11:28:31
5881,826,3,827,107,934,5817,2021-01-28 16:22:16
5882,70,3,758,98,856,5818,2021-01-28 15:01:17
5883,523,2,598,77,675,5819,2021-01-28 14:41:11
5884,948,3,947,123,1070,5820,2021-01-28 04:05:53
5885,783,3,847,110,957,5821,2021-01-28 22:06:07
5886,875,3,647,84,731,5822,2021-01-28 19:13:20
5887,667,2,1098,142,1240,5823,2021-01-28 07:20:41
5888,375,2,898,116,1014,5824,2021-01-28 02:34:32
5889,94,3,897,116,1013,5825,2021-01-27 00:48:09
5890,681,3,747,97,844,5826,2021-01-27 13:20:54
5891,313,2,798,103,901,5827,2021-01-27 08:49:01
5892,288,3,647,84,731,5828,2021-01-27 10:33:51
5893,772,3,688,89,777,5829,2021-01-27 07:12:05
5894,769,2,398,51,449,5830,2021-01-27 11:53:39
5895,191,1,699,90,789,5831,2021-01-27 13:01:36
5896,858,1,399,51,450,5832,2021-01-27 15:14:58
5897,656,5,1286,167,1453,5833,2021-01-27 19:20:27
5898,142,3,597,77,674,5834,2021-01-27 14:52:21
5899,60,2,1098,142,1240,5835,2021-01-27 22:23:38
5900,210,3,428,55,483,5836,2021-01-27 16:42:26
5901,814,3,997,129,1126,5837,2021-01-27 16:32:14
5902,29,2,898,116,1014,5838,2021-01-27 23:10:31
5903,904,3,647,84,731,5839,2021-01-28 00:27:17
5904,113,2,459,59,518,5840,2021-01-27 15:31:12
5905,647,3,578,75,653,5841,2021-01-27 23:01:26
5906,483,2,659,85,744,5842,2021-01-27 20:19:14
5907,464,2,498,64,562,5843,2021-01-27 09:07:48
5908,610,3,808,105,913,5844,2021-01-27 06:59:38
5909,406,2,848,110,958,5845,2021-01-27 05:18:44
5910,500,2,659,85,744,5846,2021-01-27 18:22:37
5911,904,2,898,116,1014,5847,2021-01-27 22:24:54
5912,412,2,598,77,675,5848,2021-01-27 20:18:52
5913,845,3,1247,162,1409,5849,2021-01-27 12:16:08
5914,555,3,597,77,674,5850,2021-01-27 01:49:06
5915,64,5,1176,152,1328,5851,2021-01-26 16:41:41
5916,678,3,747,97,844,5852,2021-01-26 21:06:48
5917,343,3,947,123,1070,5853,2021-01-26 21:10:33
5918,423,5,1217,158,1375,5854,2021-01-26 16:50:14
5919,629,3,1127,146,1273,5855,2021-01-26 19:37:50
5920,182,3,947,123,1070,5856,2021-01-27 02:32:30
5921,621,3,747,97,844,5857,2021-01-27 01:05:58
5922,518,1,229,29,258,5858,2021-01-27 08:18:11
5923,915,3,947,123,1070,5859,2021-01-27 12:59:36
5924,80,5,1825,237,2062,5860,2021-01-27 09:19:16
5925,514,3,1127,146,1273,5861,2021-01-27 13:51:52
5926,690,2,459,59,518,5862,2021-01-27 02:50:27
5927,260,3,1047,136,1183,5863,2021-01-26 22:27:38
5928,588,6,1974,256,2230,5864,2021-01-27 00:33:13
5929,781,2,898,116,1014,5865,2021-01-27 08:22:14
5930,183,2,329,42,371,5866,2021-01-27 03:06:13
5931,948,2,459,59,518,5867,2021-01-28 11:27:48
5932,42,2,498,64,562,5868,2021-01-28 11:39:15
5933,452,1,149,19,168,5869,2021-01-28 12:22:14
5934,195,3,808,105,913,5870,2021-01-28 03:36:20
5935,755,2,459,59,518,5871,2021-01-27 23:06:21
5936,698,2,659,85,744,5872,2021-01-27 13:48:39
5937,108,3,1247,162,1409,5873,2021-01-27 11:14:30
5938,412,2,429,55,484,5874,2021-01-27 16:44:30
5939,245,3,1327,172,1499,5875,2021-01-27 19:58:20
5940,113,5,1345,174,1519,5876,2021-01-27 21:00:32
5941,625,4,1246,161,1407,5877,2021-01-28 07:38:54
5942,44,3,1327,172,1499,5878,2021-01-28 10:34:28
5943,72,3,478,62,540,5879,2021-01-27 19:31:34
5944,644,3,528,68,596,5880,2021-01-28 02:00:12
5945,664,4,1096,142,1238,5881,2021-01-28 16:44:13
5946,901,2,798,103,901,5882,2021-01-28 11:33:20
5947,87,2,498,64,562,5883,2021-01-28 17:25:16
5948,328,2,459,59,518,5884,2021-01-28 15:48:50
5949,911,2,898,116,1014,5885,2021-01-28 17:08:54
5950,222,2,329,42,371,5886,2021-01-28 05:13:18
5951,420,3,428,55,483,5887,2021-01-28 23:32:10
5952,208,2,598,77,675,5888,2021-01-28 19:40:10
5953,535,1,229,29,258,5889,2021-01-28 09:24:13
5954,919,3,697,90,787,5890,2021-01-28 04:22:31
5955,135,1,229,29,258,5891,2021-01-27 00:57:53
5956,182,3,558,72,630,5892,2021-01-27 16:04:07
5957,532,3,528,68,596,5893,2021-01-27 10:53:47
5958,197,3,478,62,540,5894,2021-01-27 12:02:13
5959,897,3,558,72,630,5895,2021-01-27 08:58:20
5960,369,1,99,12,111,5896,2021-01-27 12:26:10
5961,759,2,598,77,675,5897,2021-01-27 14:46:22
5962,985,2,498,64,562,5898,2021-01-27 16:21:26
5963,866,6,1075,139,1214,5899,2021-01-27 21:23:46
5964,15,3,1127,146,1273,5900,2021-01-27 16:26:39
5965,523,3,608,79,687,5901,2021-01-28 00:30:54
5966,386,3,808,105,913,5902,2021-01-27 17:02:56
5967,836,2,598,77,675,5903,2021-01-27 17:42:14
5968,919,4,1426,185,1611,5904,2021-01-28 00:25:39
5969,175,1,599,77,676,5905,2021-01-28 01:20:54
5970,41,3,697,90,787,5906,2021-01-27 16:51:56
5971,424,2,659,85,744,5907,2021-01-27 23:12:35
5972,321,2,898,116,1014,5908,2021-01-27 22:14:44
5973,598,2,898,116,1014,5909,2021-01-27 09:34:25
5974,933,2,659,85,744,5910,2021-01-27 08:12:12
5975,817,3,997,129,1126,5911,2021-01-27 06:41:04
5976,947,2,928,120,1048,5912,2021-01-27 20:21:14
5977,670,5,1525,198,1723,5913,2021-01-27 23:18:08
5978,774,2,598,77,675,5914,2021-01-27 22:13:03
5979,698,3,747,97,844,5915,2021-01-27 13:38:00
5980,166,3,478,62,540,5916,2021-01-27 02:41:36
5981,398,3,558,72,630,5917,2021-01-26 18:56:26
5982,205,3,1327,172,1499,5918,2021-01-26 23:23:32
5983,21,3,697,90,787,5919,2021-01-26 23:31:45
5984,82,3,658,85,743,5920,2021-01-26 16:56:13
5985,610,2,659,85,744,5921,2021-01-26 22:03:00
5986,926,3,597,77,674,5922,2021-01-27 04:08:48
5987,336,3,597,77,674,5923,2021-01-27 01:27:20
5988,604,3,428,55,483,5924,2021-01-27 10:08:04
5989,567,3,758,98,856,5925,2021-01-27 15:01:53
5990,362,3,608,79,687,5926,2021-01-27 11:56:08
5991,755,2,898,116,1014,5927,2021-01-27 14:31:03
5992,676,3,808,105,913,5928,2021-01-27 04:56:03
5993,625,3,1047,136,1183,5929,2021-01-26 23:34:40
5994,944,3,747,97,844,5930,2021-01-27 01:56:00
5995,344,3,797,103,900,5931,2021-01-27 08:54:34
5996,467,5,1026,133,1159,5932,2021-01-27 05:39:35
5997,506,2,1098,142,1240,5933,2021-01-28 12:46:19
5998,516,5,1325,172,1497,5934,2021-01-28 13:18:38
5999,116,6,1285,167,1452,5935,2021-01-28 12:57:19
6000,661,4,1226,159,1385,5936,2021-01-28 04:52:03
6001,819,6,1694,220,1914,5937,2021-01-28 01:44:20
6002,658,3,428,55,483,5938,2021-01-27 16:13:50
6003,658,3,428,55,483,5938,2021-01-27 16:13:50
6004,199,3,808,105,913,5939,2021-01-27 13:29:29
6005,224,2,498,64,562,5940,2021-01-27 17:53:13
6006,381,4,1357,176,1533,5941,2021-01-27 20:18:48
6007,815,3,697,90,787,5942,2021-01-27 23:34:19
6008,353,3,797,103,900,5943,2021-01-28 10:21:25
6009,896,2,1098,142,1240,5944,2021-01-28 10:40:16
6010,693,5,1406,182,1588,5945,2021-01-27 21:18:56
6011,817,2,598,77,675,5946,2021-01-28 02:14:33
6012,337,2,528,68,596,5947,2021-01-28 17:46:21
6013,766,2,798,103,901,5948,2021-01-28 12:28:02
6014,17,4,1296,168,1464,5949,2021-01-28 19:54:44
6015,541,3,1197,155,1352,5950,2021-01-28 17:12:09
6016,695,3,1197,155,1352,5951,2021-01-28 18:09:14
6017,166,1,229,29,258,5952,2021-01-28 07:54:47
6018,308,5,1525,198,1723,5953,2021-01-29 00:51:28
6019,751,2,598,77,675,5954,2021-01-28 21:48:34
6020,345,3,1127,146,1273,5955,2021-01-28 09:46:37
6021,602,3,927,120,1047,5956,2021-01-28 06:13:42
6022,648,6,1086,141,1227,5957,2021-01-27 03:28:11
6023,416,3,747,97,844,5958,2021-01-27 18:50:23
6024,929,2,429,55,484,5959,2021-01-27 12:49:58
6025,510,2,1098,142,1240,5960,2021-01-27 13:08:18
6026,303,3,758,98,856,5961,2021-01-27 11:01:22
6027,304,4,1126,146,1272,5962,2021-01-27 14:04:47
6028,451,3,608,79,687,5963,2021-01-27 17:21:44
6029,986,3,758,98,856,5964,2021-01-27 16:51:14
6030,674,3,947,123,1070,5965,2021-01-27 23:49:29
6031,570,5,1356,176,1532,5966,2021-01-27 18:05:41
6032,103,5,1495,194,1689,5967,2021-01-28 01:11:02
6033,145,2,429,55,484,5968,2021-01-27 18:33:08
6034,2,2,698,90,788,5969,2021-01-27 19:24:02
6035,559,3,688,89,777,5970,2021-01-28 03:09:03
6036,47,2,329,42,371,5971,2021-01-28 03:33:11
6037,238,2,459,59,518,5972,2021-01-27 19:23:34
6038,950,2,798,103,901,5973,2021-01-27 23:12:41
6039,778,5,1106,143,1249,5974,2021-01-27 23:48:09
6040,571,3,697,90,787,5975,2021-01-27 10:21:23
6041,200,3,608,79,687,5976,2021-01-27 09:16:53
6042,97,3,747,97,844,5977,2021-01-27 07:19:40
6043,52,5,1186,154,1340,5978,2021-01-27 22:30:02
6044,861,2,329,42,371,5979,2021-01-28 00:11:01
6045,342,3,1047,136,1183,5980,2021-01-28 00:10:38
6046,841,3,658,85,743,5981,2021-01-27 16:17:46
6047,365,2,798,103,901,5982,2021-01-27 04:55:57
6048,629,2,648,84,732,5983,2021-01-26 19:56:51
6049,536,5,1425,185,1610,5984,2021-01-26 23:54:30
6050,321,2,329,42,371,5985,2021-01-27 01:23:54
6051,652,3,428,55,483,5986,2021-01-26 18:52:56
6052,940,2,898,116,1014,5987,2021-01-27 00:19:25
6053,31,1,499,64,563,5988,2021-01-27 05:47:40
6054,869,5,1795,233,2028,5989,2021-01-27 03:24:41
6055,166,2,798,103,901,5990,2021-01-27 10:17:14
6056,987,2,598,77,675,5991,2021-01-27 17:08:00
6057,677,4,1126,146,1272,5992,2021-01-27 13:20:05
6058,385,3,558,72,630,5993,2021-01-27 14:57:56
6059,582,2,329,42,371,5994,2021-01-27 04:59:06
6060,236,5,1695,220,1915,5995,2021-01-27 01:44:14
6061,9,3,997,129,1126,5996,2021-01-27 04:29:15
6062,866,3,528,68,596,5997,2021-01-27 09:42:54
6063,340,2,329,42,371,5998,2021-01-27 07:54:09
6064,709,5,1676,217,1893,5999,2021-01-28 13:30:49
6065,825,3,1027,133,1160,6000,2021-01-28 14:20:30
6066,362,2,648,84,732,6001,2021-01-28 13:43:02
6067,73,2,498,64,562,6002,2021-01-28 06:53:28
6068,95,3,528,68,596,6003,2021-01-28 01:53:45
6069,275,3,658,85,743,6004,2021-01-27 18:28:12
6070,481,3,478,62,540,6005,2021-01-27 17:10:29
6071,67,2,648,84,732,6006,2021-01-27 15:34:00
6072,778,3,597,77,674,6007,2021-01-27 19:20:21
6073,433,2,1098,142,1240,6008,2021-01-27 20:40:57
6074,410,3,1197,155,1352,6009,2021-01-27 23:56:04
6075,522,6,1954,254,2208,6010,2021-01-28 10:52:37
6076,834,5,1625,211,1836,6011,2021-01-28 12:19:22
6077,13,2,898,116,1014,6012,2021-01-27 22:05:00
6078,883,3,1027,133,1160,6013,2021-01-28 04:08:17
6079,950,3,688,89,777,6014,2021-01-28 19:15:37
6080,781,3,747,97,844,6015,2021-01-28 14:52:01
6081,728,2,698,90,788,6016,2021-01-28 20:36:08
6082,970,1,599,77,676,6017,2021-01-28 18:43:06
6083,189,2,659,85,744,6018,2021-01-28 18:37:31
6084,250,3,747,97,844,6019,2021-01-28 08:30:41
6085,993,2,798,103,901,6020,2021-01-29 01:08:19
6086,217,2,898,116,1014,6021,2021-01-28 22:29:56
6087,936,3,1047,136,1183,6022,2021-01-28 12:14:20
6088,80,2,659,85,744,6023,2021-01-28 08:07:37
6089,817,3,797,103,900,6024,2021-01-27 04:48:02
6090,558,2,329,42,371,6025,2021-01-27 19:31:36
6091,628,3,478,62,540,6026,2021-01-27 12:52:49
6092,407,2,429,55,484,6027,2021-01-27 14:31:14
6093,862,3,758,98,856,6028,2021-01-27 12:57:59
6094,768,6,1774,230,2004,6029,2021-01-27 16:38:01
6095,120,5,1547,201,1748,6030,2021-01-27 18:52:49
6096,110,5,2025,263,2288,6031,2021-01-27 17:45:46
6097,546,3,888,115,1003,6032,2021-01-28 01:56:53
6098,546,3,888,115,1003,6032,2021-01-28 01:56:53
6099,744,2,329,42,371,6033,2021-01-27 19:43:49
6100,537,2,498,64,562,6034,2021-01-28 01:34:31
6101,813,2,598,77,675,6035,2021-01-27 20:28:56
6102,992,3,688,89,777,6036,2021-01-27 20:18:43
6103,717,3,747,97,844,6037,2021-01-28 03:57:52
6104,278,3,947,123,1070,6038,2021-01-28 04:16:32
6105,479,1,99,12,111,6039,2021-01-27 19:55:23
6106,121,2,548,71,619,6040,2021-01-27 23:44:49
6107,473,3,827,107,934,6041,2021-01-28 02:33:31
6108,639,2,659,85,744,6042,2021-01-27 11:29:02
6109,621,5,1625,211,1836,6043,2021-01-27 11:17:16
6110,676,5,1256,163,1419,6044,2021-01-27 07:34:33
6111,660,5,1825,237,2062,6045,2021-01-28 00:10:51
6112,1000,2,659,85,744,6046,2021-01-28 00:55:04
6113,987,1,599,77,676,6047,2021-01-28 01:44:46
6114,101,3,1027,133,1160,6048,2021-01-27 17:03:49
6115,431,1,99,12,111,6049,2021-01-27 07:15:55
6116,468,1,99,12,111,6050,2021-01-26 19:56:58
6117,249,2,1098,142,1240,6051,2021-01-27 00:45:05
6118,132,3,1127,146,1273,6052,2021-01-27 02:27:39
6119,665,3,1127,146,1273,6053,2021-01-26 19:33:12
6120,449,3,1247,162,1409,6054,2021-01-27 02:21:51
6121,839,1,599,77,676,6055,2021-01-27 08:28:28
6122,147,2,598,77,675,6056,2021-01-27 04:23:55
6123,941,3,827,107,934,6057,2021-01-27 11:50:45
6124,956,3,747,97,844,6058,2021-01-27 17:52:14
6125,939,2,598,77,675,6059,2021-01-27 14:04:03
6126,669,4,2026,263,2289,6060,2021-01-27 16:47:52
6127,138,3,758,98,856,6061,2021-01-27 06:29:09
6128,708,1,399,51,450,6062,2021-01-27 03:41:45
6129,551,2,329,42,371,6063,2021-01-27 04:49:21
6130,331,3,1497,194,1691,6064,2021-01-27 12:24:25
6131,495,2,598,77,675,6065,2021-01-27 09:41:04
6132,887,3,927,120,1047,6066,2021-01-28 15:59:12
6133,73,5,1825,237,2062,6067,2021-01-28 15:52:59
6134,103,3,827,107,934,6068,2021-01-28 14:25:56
6135,197,1,599,77,676,6069,2021-01-28 08:24:04
6136,21,3,827,107,934,6070,2021-01-28 02:51:12
6137,164,3,1027,133,1160,6071,2021-01-27 18:33:13
6138,911,3,997,129,1126,6072,2021-01-27 17:28:19
6139,434,2,898,116,1014,6073,2021-01-27 15:45:21
6140,183,2,898,116,1014,6074,2021-01-27 22:01:54
6141,839,3,827,107,934,6075,2021-01-27 23:14:27
6142,882,4,1146,148,1294,6076,2021-01-28 02:04:21
6143,362,4,1157,150,1307,6077,2021-01-28 11:09:56
6144,945,3,647,84,731,6078,2021-01-28 14:15:41
6145,817,6,1805,234,2039,6079,2021-01-27 23:33:20
6146,217,3,558,72,630,6080,2021-01-28 05:36:51
6147,540,5,1645,213,1858,6081,2021-01-28 21:48:41
6148,437,3,697,90,787,6082,2021-01-28 15:24:33
6149,111,3,697,90,787,6083,2021-01-28 22:33:13
6150,206,3,688,89,777,6084,2021-01-28 19:19:38
6151,244,3,758,98,856,6085,2021-01-28 19:26:38
6152,57,3,478,62,540,6086,2021-01-28 10:54:05
6153,699,3,1197,155,1352,6087,2021-01-29 03:22:50
6154,717,3,947,123,1070,6088,2021-01-29 00:02:17
6155,293,5,2145,278,2423,6089,2021-01-28 14:46:38
6156,138,3,947,123,1070,6090,2021-01-28 08:30:28
6157,497,3,897,116,1013,6091,2021-01-27 05:51:21
6158,116,2,898,116,1014,6092,2021-01-27 21:22:05
6159,439,2,329,42,371,6093,2021-01-27 15:04:42
6160,230,3,1027,133,1160,6094,2021-01-27 16:29:27
6161,378,5,1395,181,1576,6095,2021-01-27 14:51:19
6162,751,3,808,105,913,6096,2021-01-27 17:22:35
6163,440,3,1327,172,1499,6097,2021-01-27 20:18:22
6164,254,2,659,85,744,6098,2021-01-27 18:03:11
6165,254,2,659,85,744,6098,2021-01-27 18:03:11
6166,13,2,798,103,901,6099,2021-01-28 02:09:10
6167,914,3,727,94,821,6100,2021-01-28 02:57:18
6168,101,5,1475,191,1666,6101,2021-01-27 20:52:39
6169,307,3,1127,146,1273,6102,2021-01-28 02:32:38
6170,883,6,1705,221,1926,6103,2021-01-27 21:47:48
6171,860,2,429,55,484,6104,2021-01-27 20:33:30
6172,267,2,1098,142,1240,6105,2021-01-28 06:19:26
6173,92,3,597,77,674,6106,2021-01-28 05:02:38
6174,917,2,898,116,1014,6107,2021-01-27 22:35:04
6175,489,2,898,116,1014,6108,2021-01-28 01:09:09
6176,100,5,1206,156,1362,6109,2021-01-28 04:37:55
6177,807,3,428,55,483,6110,2021-01-27 14:12:24
6178,772,1,229,29,258,6111,2021-01-27 13:33:52
6179,924,2,798,103,901,6112,2021-01-27 08:32:28
6180,98,2,329,42,371,6113,2021-01-28 00:19:29
6181,115,3,558,72,630,6114,2021-01-28 03:32:47
6182,841,3,1027,133,1160,6115,2021-01-28 02:47:53
6183,958,3,997,129,1126,6116,2021-01-27 18:15:05
6184,442,3,727,94,821,6117,2021-01-27 09:04:34
6185,205,3,827,107,934,6118,2021-01-26 20:28:32
6186,692,3,758,98,856,6119,2021-01-27 01:57:10
6187,272,2,598,77,675,6120,2021-01-27 04:53:49
6188,950,3,528,68,596,6121,2021-01-26 21:42:15
6189,529,3,997,129,1126,6122,2021-01-27 04:44:30
6190,856,3,647,84,731,6123,2021-01-27 10:05:09
6191,68,3,697,90,787,6124,2021-01-27 06:52:20
6192,797,2,898,116,1014,6125,2021-01-27 11:58:13
6193,221,5,1576,204,1780,6126,2021-01-27 18:52:58
6194,733,2,928,120,1048,6127,2021-01-27 15:06:24
6195,633,6,1994,259,2253,6128,2021-01-27 19:28:32
6196,605,5,1317,171,1488,6129,2021-01-27 07:09:58
6197,452,3,428,55,483,6130,2021-01-27 04:14:51
6198,263,3,747,97,844,6131,2021-01-27 04:50:39
6199,942,3,827,107,934,6132,2021-01-27 13:20:43
6200,417,5,1117,145,1262,6133,2021-01-27 11:20:07
6201,229,3,727,94,821,6134,2021-01-28 18:35:07
6202,808,5,1276,165,1441,6135,2021-01-28 16:40:06
6203,808,1,399,51,450,6136,2021-01-28 15:37:43
6204,969,3,697,90,787,6137,2021-01-28 10:13:41
6205,60,1,229,29,258,6138,2021-01-28 05:02:28
6206,994,2,798,103,901,6139,2021-01-27 19:00:20
6207,702,3,528,68,596,6140,2021-01-27 18:32:24
6208,789,3,647,84,731,6141,2021-01-27 17:59:22
6209,296,6,1366,177,1543,6142,2021-01-27 22:18:44
6210,379,3,1047,136,1183,6143,2021-01-28 01:14:53
6211,616,5,976,126,1102,6144,2021-01-28 03:19:39
6212,680,3,1127,146,1273,6145,2021-01-28 13:26:34
6213,902,3,927,120,1047,6146,2021-01-28 16:56:23
6214,222,3,1047,136,1183,6147,2021-01-28 01:19:09
6215,293,3,997,129,1126,6148,2021-01-28 05:38:41
6216,583,2,898,116,1014,6149,2021-01-28 22:10:17
6217,649,3,997,129,1126,6150,2021-01-28 15:33:54
6218,13,2,459,59,518,6151,2021-01-29 00:39:35
6219,201,3,1327,172,1499,6152,2021-01-28 20:54:54
6220,915,2,598,77,675,6153,2021-01-28 20:41:57
6221,644,3,927,120,1047,6154,2021-01-28 11:09:32
6222,961,2,798,103,901,6155,2021-01-29 03:30:57
6223,4,6,1874,243,2117,6156,2021-01-29 02:20:56
6224,106,5,1395,181,1576,6157,2021-01-28 15:12:37
6225,465,2,598,77,675,6158,2021-01-28 09:57:40
6226,722,5,1456,189,1645,6159,2021-01-27 08:05:18
6227,678,3,528,68,596,6160,2021-01-28 00:01:15
6228,64,3,688,89,777,6161,2021-01-27 15:32:43
6229,30,3,1127,146,1273,6162,2021-01-27 16:40:34
6230,990,3,747,97,844,6163,2021-01-27 16:25:47
6231,622,3,688,89,777,6164,2021-01-27 18:09:54
6232,967,1,99,12,111,6165,2021-01-27 22:09:41
6233,441,3,528,68,596,6166,2021-01-27 18:57:02
6234,117,2,548,71,619,6167,2021-01-27 20:36:35
6235,375,2,828,107,935,6168,2021-01-28 03:17:11
6236,544,6,1974,256,2230,6169,2021-01-28 03:20:36
6237,17,2,528,68,596,6170,2021-01-27 22:14:17
6238,625,3,927,120,1047,6171,2021-01-28 04:35:59
6239,99,3,897,116,1013,6172,2021-01-27 23:58:20
6240,442,2,898,116,1014,6173,2021-01-27 20:48:01
6241,885,3,897,116,1013,6174,2021-01-28 07:07:46
6242,766,3,528,68,596,6175,2021-01-28 05:28:17
6243,795,4,1396,181,1577,6176,2021-01-28 00:22:21
6244,700,2,329,42,371,6177,2021-01-28 01:20:45
6245,73,6,1425,185,1610,6178,2021-01-28 06:06:30
6246,602,3,1047,136,1183,6179,2021-01-27 14:31:12
6247,95,3,747,97,844,6180,2021-01-27 15:40:50
6248,949,3,997,129,1126,6181,2021-01-27 10:32:55
6249,949,3,997,129,1126,6181,2021-01-27 10:32:55
6250,13,2,748,97,845,6182,2021-01-28 02:26:34
6251,531,5,1845,239,2084,6183,2021-01-28 04:15:00
6252,398,2,798,103,901,6184,2021-01-28 03:28:39
6253,13,3,647,84,731,6185,2021-01-27 20:40:30
6254,218,3,947,123,1070,6186,2021-01-27 09:09:49
6255,11,3,597,77,674,6187,2021-01-26 21:45:43
6256,948,1,229,29,258,6188,2021-01-27 03:44:34
6257,895,2,598,77,675,6189,2021-01-27 06:12:09
6258,839,6,1255,163,1418,6190,2021-01-26 22:37:56
6259,571,2,528,68,596,6191,2021-01-27 06:53:35
6260,188,2,1098,142,1240,6192,2021-01-27 11:30:00
6261,801,3,727,94,821,6193,2021-01-27 07:12:42
6262,273,1,499,64,563,6194,2021-01-27 13:06:11
6263,974,3,608,79,687,6195,2021-01-27 21:38:20
6264,37,3,697,90,787,6196,2021-01-27 15:28:27
6265,254,4,1946,252,2198,6197,2021-01-27 21:41:45
6266,266,2,598,77,675,6198,2021-01-27 07:35:53
6267,778,2,728,94,822,6199,2021-01-27 06:30:04
6268,553,3,647,84,731,6200,2021-01-27 07:20:10
6269,971,3,758,98,856,6201,2021-01-27 13:29:32
6270,953,2,329,42,371,6202,2021-01-27 12:59:51
6271,533,4,1346,174,1520,6203,2021-01-28 19:41:37
6272,975,2,698,90,788,6204,2021-01-28 16:45:04
6273,889,3,847,110,957,6205,2021-01-28 16:36:49
6274,528,2,798,103,901,6206,2021-01-28 11:03:35
6275,197,2,898,116,1014,6207,2021-01-28 05:06:15
6276,736,3,658,85,743,6208,2021-01-27 21:12:17
6277,460,6,1186,154,1340,6209,2021-01-27 20:30:27
6278,989,3,797,103,900,6210,2021-01-27 18:15:11
6279,173,3,658,85,743,6211,2021-01-28 01:00:50
6280,401,3,558,72,630,6212,2021-01-28 02:22:12
6281,919,3,808,105,913,6213,2021-01-28 04:27:43
6282,592,2,648,84,732,6214,2021-01-28 14:05:46
6283,711,2,728,94,822,6215,2021-01-28 19:29:09
6284,663,3,747,97,844,6216,2021-01-28 02:51:41
6285,796,2,698,90,788,6217,2021-01-28 06:20:08
6286,330,3,747,97,844,6218,2021-01-29 00:39:39
6287,25,3,608,79,687,6219,2021-01-28 18:04:59
6288,762,2,648,84,732,6220,2021-01-29 01:15:46
6289,95,3,997,129,1126,6221,2021-01-28 20:54:57
6290,346,4,1096,142,1238,6222,2021-01-28 21:39:56
6291,778,2,648,84,732,6223,2021-01-28 13:21:08
6292,350,2,329,42,371,6224,2021-01-29 06:15:27
6293,854,3,528,68,596,6225,2021-01-29 04:34:19
6294,107,2,898,116,1014,6226,2021-01-28 16:04:25
6295,800,2,928,120,1048,6227,2021-01-28 11:32:35
6296,706,3,847,110,957,6228,2021-01-27 10:11:49
6297,437,6,1385,180,1565,6229,2021-01-28 00:47:14
6298,339,3,658,85,743,6230,2021-01-27 18:06:03
6299,835,2,498,64,562,6231,2021-01-27 17:56:27
6300,910,1,499,64,563,6232,2021-01-27 18:17:14
6301,722,1,149,19,168,6233,2021-01-27 20:05:00
6302,931,3,797,103,900,6234,2021-01-27 22:27:50
6303,337,3,578,75,653,6235,2021-01-27 21:20:16
6304,265,2,329,42,371,6236,2021-01-27 22:28:51
6305,387,3,827,107,934,6237,2021-01-28 05:57:06
6306,387,3,827,107,934,6237,2021-01-28 05:57:06
6307,664,3,947,123,1070,6238,2021-01-28 04:03:51
6308,118,2,548,71,619,6239,2021-01-27 23:15:05
6309,118,2,548,71,619,6239,2021-01-27 23:15:05
6310,18,3,1047,136,1183,6240,2021-01-28 05:25:19
6311,253,3,997,129,1126,6241,2021-01-28 02:19:32
6312,786,3,808,105,913,6242,2021-01-27 22:47:38
6313,187,2,698,90,788,6243,2021-01-28 07:55:15
6314,508,3,697,90,787,6244,2021-01-28 05:28:43
6315,866,3,888,115,1003,6245,2021-01-28 01:00:46
6316,749,3,1027,133,1160,6246,2021-01-28 03:42:38
6317,267,3,1127,146,1273,6247,2021-01-28 06:19:10
6318,280,5,1076,139,1215,6248,2021-01-27 16:00:29
6319,326,3,558,72,630,6249,2021-01-27 18:13:51
6320,915,3,797,103,900,6250,2021-01-27 11:19:22
6321,343,3,1127,146,1273,6251,2021-01-27 11:29:58
6322,457,6,1474,191,1665,6252,2021-01-28 02:31:25
6323,365,2,429,55,484,6253,2021-01-28 04:19:42
6324,29,3,897,116,1013,6254,2021-01-28 03:58:43
6325,865,3,428,55,483,6255,2021-01-27 23:08:38
6326,953,2,1098,142,1240,6256,2021-01-27 09:20:19
6327,33,3,1197,155,1352,6257,2021-01-26 22:32:05
6328,905,2,659,85,744,6258,2021-01-27 06:01:34
6329,49,2,498,64,562,6259,2021-01-27 06:31:10
6330,842,6,1155,150,1305,6260,2021-01-26 22:43:44
6331,893,2,898,116,1014,6261,2021-01-27 09:15:17
6332,69,2,798,103,901,6262,2021-01-27 13:11:38
6333,11,2,659,85,744,6263,2021-01-27 08:02:16
6334,872,3,1327,172,1499,6264,2021-01-27 13:34:38
6335,12,6,1874,243,2117,6265,2021-01-27 23:37:20
6336,795,2,698,90,788,6266,2021-01-27 17:53:49
6337,943,3,1127,146,1273,6267,2021-01-27 23:39:29
6338,575,2,498,64,562,6268,2021-01-27 08:46:18
6339,798,6,986,128,1114,6269,2021-01-27 09:13:48
6340,774,3,597,77,674,6270,2021-01-27 09:49:30
6341,847,1,699,90,789,6271,2021-01-27 14:42:11
6342,184,3,1247,162,1409,6272,2021-01-27 13:41:07
6343,341,3,727,94,821,6273,2021-01-28 20:09:01
6344,739,3,528,68,596,6274,2021-01-28 17:06:58
6345,517,2,828,107,935,6275,2021-01-28 18:27:03
6346,776,2,898,116,1014,6276,2021-01-28 13:26:33
6347,4,4,1127,146,1273,6277,2021-01-28 07:36:15
6348,184,3,1247,162,1409,6278,2021-01-27 23:46:10
6349,802,5,1486,193,1679,6279,2021-01-27 21:25:15
6350,983,3,727,94,821,6280,2021-01-27 20:22:14
6351,135,2,1098,142,1240,6281,2021-01-28 02:30:03
6352,601,3,658,85,743,6282,2021-01-28 03:49:36
6353,551,3,697,90,787,6283,2021-01-28 05:01:26
6354,796,3,647,84,731,6284,2021-01-28 14:43:35
6355,608,3,758,98,856,6285,2021-01-28 21:01:34
6356,518,5,1545,200,1745,6286,2021-01-28 04:17:55
6357,380,3,747,97,844,6287,2021-01-28 07:27:47
6358,755,2,329,42,371,6288,2021-01-29 01:14:31
6359,421,3,727,94,821,6289,2021-01-28 18:52:41
6360,783,3,697,90,787,6290,2021-01-29 02:27:36
6361,737,3,697,90,787,6291,2021-01-28 23:15:35
6362,349,3,997,129,1126,6292,2021-01-28 22:21:36
6363,559,3,827,107,934,6293,2021-01-28 14:40:52
6364,2,2,429,55,484,6294,2021-01-29 07:53:34
6365,882,3,1247,162,1409,6295,2021-01-29 06:35:18
6366,12,3,888,115,1003,6296,2021-01-28 16:13:02
6367,656,2,598,77,675,6297,2021-01-28 12:56:53
6368,259,2,698,90,788,6298,2021-01-27 10:15:31
6369,596,3,888,115,1003,6299,2021-01-28 02:01:53
6370,545,3,1247,162,1409,6300,2021-01-27 18:44:59
6371,440,3,478,62,540,6301,2021-01-27 18:16:29
6372,385,3,847,110,957,6302,2021-01-27 20:35:07
6373,959,3,1327,172,1499,6303,2021-01-27 21:51:01
6374,421,2,429,55,484,6304,2021-01-27 22:31:15
6375,481,2,598,77,675,6305,2021-01-27 22:52:14
6376,940,5,1945,252,2197,6306,2021-01-28 01:03:21
6377,824,1,99,12,111,6307,2021-01-28 06:51:58
6378,846,2,448,58,506,6308,2021-01-28 08:25:12
6379,875,3,808,105,913,6309,2021-01-28 04:44:10
6380,102,3,608,79,687,6310,2021-01-28 00:28:21
6381,548,2,698,90,788,6311,2021-01-27 23:18:46
6382,80,2,598,77,675,6312,2021-01-28 07:56:54
6383,162,3,847,110,957,6313,2021-01-28 02:33:04
6384,669,3,1247,162,1409,6314,2021-01-28 00:31:38
6385,371,2,459,59,518,6315,2021-01-28 09:17:49
6386,521,5,1545,200,1745,6316,2021-01-28 05:52:57
6387,895,2,659,85,744,6317,2021-01-28 03:27:59
6388,148,2,728,94,822,6318,2021-01-28 05:46:07
6389,517,2,329,42,371,6319,2021-01-28 07:22:45
6390,812,2,698,90,788,6320,2021-01-27 17:14:04
6391,393,3,558,72,630,6321,2021-01-27 18:53:13
6392,506,3,697,90,787,6322,2021-01-27 12:04:57
6393,259,2,898,116,1014,6323,2021-01-27 12:56:34
6394,469,1,599,77,676,6324,2021-01-28 04:16:58
6395,474,1,229,29,258,6325,2021-01-28 06:46:23
6396,73,3,478,62,540,6326,2021-01-28 05:56:19
6397,545,3,1247,162,1409,6327,2021-01-27 23:21:30
6398,833,3,888,115,1003,6328,2021-01-27 11:37:30
6399,223,3,947,123,1070,6329,2021-01-26 23:44:50
6400,347,3,478,62,540,6330,2021-01-27 08:35:57
6401,431,1,229,29,258,6331,2021-01-27 08:38:30
6402,172,2,598,77,675,6332,2021-01-27 00:04:38
6403,94,2,698,90,788,6333,2021-01-27 10:46:18
6404,507,2,628,81,709,6334,2021-01-27 13:56:56
6405,400,6,1446,187,1633,6335,2021-01-27 08:14:39
6406,5,3,1127,146,1273,6336,2021-01-27 15:31:25
6407,451,3,758,98,856,6337,2021-01-28 02:20:24
6408,18,3,578,75,653,6338,2021-01-27 20:28:21
6409,170,3,578,75,653,6339,2021-01-27 23:45:48
6410,740,3,1027,133,1160,6340,2021-01-27 09:03:04
6411,711,3,827,107,934,6341,2021-01-27 09:40:05
6412,405,3,578,75,653,6342,2021-01-27 12:11:47
6413,394,3,797,103,900,6343,2021-01-27 16:30:08
6414,26,3,1127,146,1273,6344,2021-01-27 15:46:50
6415,623,6,2044,265,2309,6345,2021-01-28 22:44:12
6416,978,1,699,90,789,6346,2021-01-28 17:34:10
6417,38,3,578,75,653,6347,2021-01-28 18:32:22
6418,315,3,478,62,540,6348,2021-01-28 15:30:09
6419,224,3,997,129,1126,6349,2021-01-28 08:41:56
6420,623,3,528,68,596,6350,2021-01-28 01:53:56
6421,527,2,598,77,675,6351,2021-01-27 22:02:57
6422,942,1,399,51,450,6352,2021-01-27 21:16:14
6423,519,6,1305,169,1474,6353,2021-01-28 04:30:51
6424,607,2,459,59,518,6354,2021-01-28 04:02:15
6425,329,3,608,79,687,6355,2021-01-28 07:08:45
6426,356,2,898,116,1014,6356,2021-01-28 15:11:19
6427,634,4,1346,174,1520,6357,2021-01-28 22:57:40
6428,450,5,1256,163,1419,6358,2021-01-28 05:12:26
6429,996,3,1127,146,1273,6359,2021-01-28 09:03:57
6430,747,1,699,90,789,6360,2021-01-29 01:26:43
6431,657,3,1197,155,1352,6361,2021-01-28 20:13:34
6432,544,3,1327,172,1499,6362,2021-01-29 04:10:13
6433,942,1,399,51,450,6363,2021-01-28 23:39:36
6434,618,3,797,103,900,6364,2021-01-29 01:00:11
6435,497,3,1047,136,1183,6365,2021-01-28 15:48:11
6436,412,3,1127,146,1273,6366,2021-01-29 09:05:16
6437,257,3,1327,172,1499,6367,2021-01-29 07:40:16
6438,754,4,1007,130,1137,6368,2021-01-28 17:01:15
6439,802,3,1047,136,1183,6369,2021-01-28 15:11:27
6440,614,6,1505,195,1700,6370,2021-01-27 13:00:12
6441,134,3,597,77,674,6371,2021-01-28 04:10:47
6442,411,3,758,98,856,6372,2021-01-27 21:12:07
6443,908,3,1197,155,1352,6373,2021-01-27 19:16:57
6444,555,3,1247,162,1409,6374,2021-01-27 21:00:53
6445,329,3,808,105,913,6375,2021-01-27 22:18:03
6446,602,3,478,62,540,6376,2021-01-27 23:36:04
6447,602,3,478,62,540,6376,2021-01-27 23:36:04
6448,62,6,1555,202,1757,6377,2021-01-28 00:36:21
6449,56,3,578,75,653,6378,2021-01-28 02:42:33
6450,848,2,329,42,371,6379,2021-01-28 08:19:21
6451,730,3,578,75,653,6380,2021-01-28 10:38:09
6452,394,3,1047,136,1183,6381,2021-01-28 06:07:52
6453,411,5,1895,246,2141,6382,2021-01-28 01:13:57
6454,24,2,329,42,371,6383,2021-01-28 00:44:03
6455,151,3,947,123,1070,6384,2021-01-28 08:19:34
6456,201,3,997,129,1126,6385,2021-01-28 03:44:59
6457,205,3,747,97,844,6386,2021-01-28 02:09:44
6458,744,5,1126,146,1272,6387,2021-01-28 09:22:34
6459,640,3,808,105,913,6388,2021-01-28 08:27:39
6460,875,1,499,64,563,6389,2021-01-28 03:58:11
6461,33,3,1027,133,1160,6390,2021-01-28 07:57:08
6462,399,3,558,72,630,6391,2021-01-28 09:30:15
6463,425,3,1027,133,1160,6392,2021-01-27 19:15:45
6464,194,3,727,94,821,6393,2021-01-27 19:39:05
6465,749,2,429,55,484,6394,2021-01-27 14:00:11
6466,450,2,498,64,562,6395,2021-01-27 15:08:06
6467,91,2,429,55,484,6396,2021-01-28 05:32:29
6468,14,4,1457,189,1646,6397,2021-01-28 09:24:03
6469,799,2,548,71,619,6398,2021-01-28 08:29:39
6470,716,3,1047,136,1183,6399,2021-01-28 01:54:26
6471,440,5,1295,168,1463,6400,2021-01-27 12:20:25
6472,750,2,598,77,675,6401,2021-01-27 01:23:26
6473,983,2,698,90,788,6402,2021-01-27 10:28:46
6474,331,3,558,72,630,6403,2021-01-27 09:09:09
6475,994,2,628,81,709,6404,2021-01-27 00:35:17
6476,971,3,688,89,777,6405,2021-01-27 11:58:00
6477,183,2,598,77,675,6406,2021-01-27 14:16:59
6478,477,5,1226,159,1385,6407,2021-01-27 10:27:02
6479,502,3,1197,155,1352,6408,2021-01-27 15:49:29
6480,647,3,1047,136,1183,6409,2021-01-28 02:30:38
6481,273,3,897,116,1013,6410,2021-01-27 22:52:03
6482,916,3,997,129,1126,6411,2021-01-27 23:52:04
6483,802,3,1247,162,1409,6412,2021-01-27 10:12:10
6484,782,2,798,103,901,6413,2021-01-27 10:52:51
6485,789,3,1327,172,1499,6414,2021-01-27 12:59:29
6486,593,6,1305,169,1474,6415,2021-01-27 19:00:08
6487,499,3,688,89,777,6416,2021-01-27 17:46:12
6488,928,2,598,77,675,6417,2021-01-28 23:30:54
6489,117,2,528,68,596,6418,2021-01-28 18:01:58
6490,682,6,1874,243,2117,6419,2021-01-28 18:42:05
6491,641,2,598,77,675,6420,2021-01-28 17:21:17
6492,371,3,1327,172,1499,6421,2021-01-28 10:24:24
6493,325,2,898,116,1014,6422,2021-01-28 03:11:09
6494,443,3,797,103,900,6423,2021-01-27 22:54:44
6495,890,2,659,85,744,6424,2021-01-27 23:03:30
6496,878,2,459,59,518,6425,2021-01-28 07:03:58
6497,801,6,2024,263,2287,6426,2021-01-28 05:04:32
6498,656,2,459,59,518,6427,2021-01-28 08:49:33
6499,888,3,758,98,856,6428,2021-01-28 17:49:51
6500,191,3,578,75,653,6429,2021-01-29 01:07:54
6501,785,5,1026,133,1159,6430,2021-01-28 05:17:52
6502,376,2,628,81,709,6431,2021-01-28 10:02:59
6503,865,3,1247,162,1409,6432,2021-01-29 03:17:30
6504,354,2,548,71,619,6433,2021-01-28 21:39:57
6505,50,2,429,55,484,6434,2021-01-29 04:40:30
6506,400,3,688,89,777,6435,2021-01-28 23:43:05
6507,122,4,1088,141,1229,6436,2021-01-29 03:41:59
6508,703,6,1824,237,2061,6437,2021-01-28 18:29:09
6509,500,3,797,103,900,6438,2021-01-29 11:50:31
6510,457,2,798,103,901,6439,2021-01-29 07:57:23
6511,308,3,827,107,934,6440,2021-01-28 18:41:41
6512,828,3,528,68,596,6441,2021-01-28 17:02:58
6513,154,2,429,55,484,6442,2021-01-27 13:07:28
6514,15,4,1157,150,1307,6443,2021-01-28 06:17:48
6515,306,6,1086,141,1227,6444,2021-01-27 21:39:05
6516,797,3,1197,155,1352,6445,2021-01-27 20:46:26
6517,490,6,1225,159,1384,6446,2021-01-27 21:20:48
6518,916,3,947,123,1070,6447,2021-01-27 22:59:51
6519,237,3,888,115,1003,6448,2021-01-28 00:21:55
6520,408,3,808,105,913,6449,2021-01-28 02:11:07
6521,349,2,1098,142,1240,6450,2021-01-28 01:17:29
6522,814,3,888,115,1003,6451,2021-01-28 04:28:04
6523,198,3,697,90,787,6452,2021-01-28 10:15:00
6524,445,3,697,90,787,6453,2021-01-28 13:09:13
6525,493,3,797,103,900,6454,2021-01-28 07:36:31
6526,14,6,1844,239,2083,6455,2021-01-28 02:54:17
6527,229,2,429,55,484,6456,2021-01-28 03:06:21
6528,841,3,1197,155,1352,6457,2021-01-28 09:11:47
6529,748,3,428,55,483,6458,2021-01-28 04:22:34
6530,168,1,229,29,258,6459,2021-01-28 03:44:07
6531,213,1,299,38,337,6460,2021-01-28 11:53:34
6532,721,2,698,90,788,6461,2021-01-28 10:58:19
6533,373,3,597,77,674,6462,2021-01-28 06:09:04
6534,533,2,698,90,788,6463,2021-01-28 08:30:56
6535,717,2,429,55,484,6464,2021-01-28 10:08:55
6536,722,3,947,123,1070,6465,2021-01-27 19:37:04
6537,971,1,399,51,450,6466,2021-01-27 21:21:11
6538,179,3,1027,133,1160,6467,2021-01-27 16:37:29
6539,535,3,997,129,1126,6468,2021-01-27 15:57:44
6540,970,2,898,116,1014,6469,2021-01-28 06:59:44
6541,173,2,548,71,619,6470,2021-01-28 12:02:18
6542,539,2,928,120,1048,6471,2021-01-28 11:10:28
6543,665,3,758,98,856,6472,2021-01-28 02:37:04
6544,497,2,548,71,619,6473,2021-01-27 12:46:05
6545,367,3,608,79,687,6474,2021-01-27 03:33:56
6546,334,1,399,51,450,6475,2021-01-27 13:06:45
6547,568,2,448,58,506,6476,2021-01-27 11:05:29
6548,51,2,659,85,744,6477,2021-01-27 02:58:40
6549,930,3,997,129,1126,6478,2021-01-27 13:53:08
6550,111,3,1327,172,1499,6479,2021-01-27 15:40:51
6551,195,2,898,116,1014,6480,2021-01-27 12:33:44
6552,356,3,727,94,821,6481,2021-01-27 18:16:23
6553,324,3,797,103,900,6482,2021-01-28 04:01:56
6554,368,3,428,55,483,6483,2021-01-28 01:18:01
6555,399,1,229,29,258,6484,2021-01-28 00:27:35
6556,606,2,459,59,518,6485,2021-01-27 12:51:42
6557,377,3,1127,146,1273,6486,2021-01-27 12:35:04
6558,845,5,1575,204,1779,6487,2021-01-27 14:33:32
6559,759,3,688,89,777,6488,2021-01-27 19:28:07
6560,609,3,1127,146,1273,6489,2021-01-27 19:07:37
6561,5,3,997,129,1126,6490,2021-01-28 23:57:53
6562,776,3,688,89,777,6491,2021-01-28 18:29:08
6563,30,3,1047,136,1183,6492,2021-01-28 21:23:29
6564,44,3,997,129,1126,6493,2021-01-28 18:51:14
6565,200,2,498,64,562,6494,2021-01-28 13:08:00
6566,492,2,898,116,1014,6495,2021-01-28 05:32:59
6567,693,1,399,51,450,6496,2021-01-28 00:15:33
6568,23,3,947,123,1070,6497,2021-01-27 23:31:23
6569,295,6,1885,245,2130,6498,2021-01-28 07:36:09
6570,764,2,698,90,788,6499,2021-01-28 06:09:16
6571,526,2,498,64,562,6500,2021-01-28 10:32:55
6572,575,4,1296,168,1464,6501,2021-01-28 19:18:43
6573,951,3,897,116,1013,6502,2021-01-29 03:39:35
6574,80,3,747,97,844,6503,2021-01-28 06:19:47
6575,975,3,658,85,743,6504,2021-01-28 12:48:17
6576,804,5,1656,215,1871,6505,2021-01-29 05:13:13
6577,975,6,1844,239,2083,6506,2021-01-28 23:48:34
6578,860,4,1176,152,1328,6507,2021-01-29 06:44:33
6579,111,2,1098,142,1240,6508,2021-01-29 00:23:07
6580,729,2,548,71,619,6509,2021-01-29 05:32:55
6581,818,3,697,90,787,6510,2021-01-28 18:43:51
6582,476,3,1127,146,1273,6511,2021-01-29 13:41:16
6583,171,2,698,90,788,6512,2021-01-29 09:30:16
6584,325,3,997,129,1126,6513,2021-01-28 18:44:28
6585,60,2,429,55,484,6514,2021-01-28 18:28:44
6586,904,2,698,90,788,6515,2021-01-27 13:37:50
6587,843,3,558,72,630,6516,2021-01-28 06:26:59
6588,855,4,1126,146,1272,6517,2021-01-27 23:48:54
6589,232,1,399,51,450,6518,2021-01-27 22:05:14
6590,40,5,1545,200,1745,6519,2021-01-27 23:45:05
6591,721,3,727,94,821,6520,2021-01-27 23:47:07
6592,606,3,747,97,844,6521,2021-01-28 02:57:41
6593,416,2,598,77,675,6522,2021-01-28 03:36:28
6594,590,3,947,123,1070,6523,2021-01-28 02:50:00
6595,288,2,659,85,744,6524,2021-01-28 05:56:14
6596,6,5,1326,172,1498,6525,2021-01-28 12:55:27
6597,961,3,1097,142,1239,6526,2021-01-28 15:36:13
6598,832,3,847,110,957,6527,2021-01-28 08:58:14
6599,718,3,727,94,821,6528,2021-01-28 04:07:49
6600,731,3,1127,146,1273,6529,2021-01-28 05:37:49
6601,42,2,598,77,675,6530,2021-01-28 10:17:10
6602,832,3,888,115,1003,6531,2021-01-28 06:14:23
6603,736,3,897,116,1013,6532,2021-01-28 03:45:00
6604,540,1,699,90,789,6533,2021-01-28 13:08:50
6605,781,2,598,77,675,6534,2021-01-28 13:37:43
6606,739,3,558,72,630,6535,2021-01-28 08:17:47
6607,79,3,428,55,483,6536,2021-01-28 09:16:52
6608,369,2,659,85,744,6537,2021-01-28 11:13:55
6609,265,3,1327,172,1499,6538,2021-01-27 22:04:02
6610,270,3,827,107,934,6539,2021-01-27 21:36:47
6611,787,3,897,116,1013,6540,2021-01-27 18:18:26
6612,200,2,628,81,709,6541,2021-01-27 17:29:25
6613,362,3,747,97,844,6542,2021-01-28 07:42:39
6614,345,3,797,103,900,6543,2021-01-28 12:56:28
6615,700,6,1415,183,1598,6544,2021-01-28 11:27:32
6616,136,5,1267,164,1431,6545,2021-01-28 02:42:45
6617,5,6,1954,254,2208,6546,2021-01-27 15:09:56
6618,722,6,1874,243,2117,6547,2021-01-27 05:25:52
6619,909,3,478,62,540,6548,2021-01-27 13:42:20
6620,761,3,758,98,856,6549,2021-01-27 13:23:06
6621,904,1,499,64,563,6550,2021-01-27 03:11:40
6622,411,3,997,129,1126,6551,2021-01-27 15:05:05
6623,779,5,1645,213,1858,6552,2021-01-27 17:18:42
6624,87,2,798,103,901,6553,2021-01-27 14:54:12
6625,389,2,598,77,675,6554,2021-01-27 20:01:17
6626,957,3,997,129,1126,6555,2021-01-28 06:43:15
6627,42,3,688,89,777,6556,2021-01-28 03:35:42
6628,560,2,659,85,744,6557,2021-01-28 01:19:38
6629,90,3,578,75,653,6558,2021-01-27 13:47:09
6630,52,3,797,103,900,6559,2021-01-27 13:26:20
6631,77,3,608,79,687,6560,2021-01-27 15:52:24
6632,151,4,1246,161,1407,6561,2021-01-27 19:46:52
6633,190,2,459,59,518,6562,2021-01-27 20:42:50
6634,216,3,1047,136,1183,6563,2021-01-29 01:25:24
6635,16,3,997,129,1126,6564,2021-01-28 19:17:26
6636,843,1,229,29,258,6565,2021-01-28 21:33:50
6637,388,2,398,51,449,6566,2021-01-28 21:15:50
6638,287,3,1047,136,1183,6567,2021-01-28 13:54:39
6639,810,1,299,38,337,6568,2021-01-28 06:27:40
6640,930,2,1098,142,1240,6569,2021-01-28 01:30:46
6641,784,3,1047,136,1183,6570,2021-01-28 01:29:55
6642,402,3,747,97,844,6571,2021-01-28 08:39:03
6643,492,3,927,120,1047,6572,2021-01-28 08:31:54
6644,344,3,1197,155,1352,6573,2021-01-28 11:37:09
6645,910,2,628,81,709,6574,2021-01-28 21:39:15
6646,860,2,1098,142,1240,6575,2021-01-29 05:47:42
6647,679,3,758,98,856,6576,2021-01-28 06:52:56
6648,634,3,688,89,777,6577,2021-01-28 14:13:07
6649,100,5,1406,182,1588,6578,2021-01-29 07:32:21
6650,966,3,1327,172,1499,6579,2021-01-29 01:53:55
6651,786,3,697,90,787,6580,2021-01-29 08:58:30
6652,821,3,428,55,483,6581,2021-01-29 02:26:14
6653,298,3,727,94,821,6582,2021-01-29 05:33:49
6654,696,3,478,62,540,6583,2021-01-28 19:49:41
6655,718,2,598,77,675,6584,2021-01-29 14:14:46
6656,712,2,798,103,901,6585,2021-01-29 12:10:57
6657,263,2,548,71,619,6586,2021-01-28 20:08:18
6658,302,2,429,55,484,6587,2021-01-28 20:08:12
6659,289,3,947,123,1070,6588,2021-01-27 14:13:03
6660,285,2,898,116,1014,6589,2021-01-28 06:35:30
6661,91,3,888,115,1003,6590,2021-01-28 02:28:17
6662,454,2,598,77,675,6591,2021-01-27 23:50:17
6663,780,2,798,103,901,6592,2021-01-28 01:04:02
6664,971,2,798,103,901,6593,2021-01-28 00:46:42
6665,733,2,498,64,562,6594,2021-01-28 05:27:07
6666,226,3,697,90,787,6595,2021-01-28 03:55:04
6667,538,5,1126,146,1272,6596,2021-01-28 05:06:08
6668,811,3,808,105,913,6597,2021-01-28 08:02:08
6669,214,3,688,89,777,6598,2021-01-28 14:03:46
6670,696,3,997,129,1126,6599,2021-01-28 16:33:08
6671,880,6,1944,252,2196,6600,2021-01-28 10:28:53
6672,290,3,1127,146,1273,6601,2021-01-28 06:16:07
6673,330,2,648,84,732,6602,2021-01-28 07:01:29
6674,828,1,499,64,563,6603,2021-01-28 12:41:02
6675,858,3,1047,136,1183,6604,2021-01-28 06:47:24
6676,231,3,747,97,844,6605,2021-01-28 06:28:09
6677,153,3,647,84,731,6606,2021-01-28 14:56:09
6678,363,3,658,85,743,6607,2021-01-28 15:46:22
6679,55,3,697,90,787,6608,2021-01-28 09:30:37
6680,47,3,1047,136,1183,6609,2021-01-28 11:26:16
6681,715,3,727,94,821,6610,2021-01-28 13:58:10
6682,639,3,608,79,687,6611,2021-01-27 22:43:00
6683,409,2,459,59,518,6612,2021-01-27 21:38:48
6684,631,3,1027,133,1160,6613,2021-01-27 18:50:16
6685,757,3,1247,162,1409,6614,2021-01-27 18:00:50
6686,652,5,1186,154,1340,6615,2021-01-28 09:47:25
6687,82,6,1525,198,1723,6616,2021-01-28 14:11:44
6688,670,3,597,77,674,6617,2021-01-28 13:18:17
6689,417,2,498,64,562,6618,2021-01-28 03:56:42
6690,646,2,329,42,371,6619,2021-01-27 16:32:20
6691,165,3,697,90,787,6620,2021-01-27 06:06:04
6692,582,3,597,77,674,6621,2021-01-27 14:07:07
6693,108,3,727,94,821,6622,2021-01-27 14:15:51
6694,775,3,1127,146,1273,6623,2021-01-27 04:44:33
6695,214,2,648,84,732,6624,2021-01-27 17:36:22
6696,214,2,648,84,732,6624,2021-01-27 17:36:22
6697,764,2,429,55,484,6625,2021-01-27 19:31:26
6698,318,5,1256,163,1419,6626,2021-01-27 15:21:17
6699,905,3,947,123,1070,6627,2021-01-27 21:21:34
6700,38,3,558,72,630,6628,2021-01-28 08:44:33
6701,204,3,947,123,1070,6629,2021-01-28 05:29:38
6702,971,2,659,85,744,6630,2021-01-28 03:22:13
6703,989,4,1346,174,1520,6631,2021-01-27 13:50:38
6704,944,2,1098,142,1240,6632,2021-01-27 15:08:39
6705,10,3,888,115,1003,6633,2021-01-27 15:54:48
6706,524,3,888,115,1003,6634,2021-01-27 20:55:29
6707,483,3,888,115,1003,6635,2021-01-27 20:59:20
6708,226,3,1327,172,1499,6636,2021-01-29 02:02:29
6709,226,3,1327,172,1499,6636,2021-01-29 02:02:29
6710,228,3,697,90,787,6637,2021-01-28 19:37:41
6711,504,3,578,75,653,6638,2021-01-28 22:02:35
6712,431,3,647,84,731,6639,2021-01-28 23:25:08
6713,336,6,2244,291,2535,6640,2021-01-28 14:41:32
6714,944,2,598,77,675,6641,2021-01-28 07:07:51
6715,259,3,727,94,821,6642,2021-01-28 03:56:27
6716,241,3,827,107,934,6643,2021-01-28 04:07:26
6717,709,3,578,75,653,6644,2021-01-28 10:45:26
6718,776,3,1247,162,1409,6645,2021-01-28 10:19:26
6719,495,2,459,59,518,6646,2021-01-28 13:42:06
6720,662,5,1495,194,1689,6647,2021-01-29 00:15:15
6721,845,3,997,129,1126,6648,2021-01-29 06:24:18
6722,836,3,1047,136,1183,6649,2021-01-28 07:01:25
6723,624,3,597,77,674,6650,2021-01-28 15:05:41
6724,618,3,888,115,1003,6651,2021-01-29 08:31:22
6725,567,2,598,77,675,6652,2021-01-29 04:40:15
6726,725,3,597,77,674,6653,2021-01-29 08:58:30
6727,57,3,578,75,653,6654,2021-01-29 04:05:22
6728,899,5,1626,211,1837,6655,2021-01-29 07:55:16
6729,431,5,1625,211,1836,6656,2021-01-28 21:29:40
6730,466,2,798,103,901,6657,2021-01-29 15:56:27
6731,78,3,1127,146,1273,6658,2021-01-29 13:05:56
6732,237,3,697,90,787,6659,2021-01-28 20:53:13
6733,710,2,429,55,484,6660,2021-01-28 21:38:44
6734,211,2,928,120,1048,6661,2021-01-27 16:12:01
6735,561,1,599,77,676,6662,2021-01-28 09:03:28
6736,142,3,747,97,844,6663,2021-01-28 04:36:25
6737,275,3,927,120,1047,6664,2021-01-27 23:57:50
6738,467,3,808,105,913,6665,2021-01-28 01:18:20
6739,852,3,1047,136,1183,6666,2021-01-28 02:13:35
6740,133,3,558,72,630,6667,2021-01-28 06:37:06
6741,911,5,1586,206,1792,6668,2021-01-28 05:04:23
6742,598,3,947,123,1070,6669,2021-01-28 06:32:10
6743,755,2,1098,142,1240,6670,2021-01-28 10:16:45
6744,314,2,329,42,371,6671,2021-01-28 15:03:51
6745,421,2,698,90,788,6672,2021-01-28 17:55:05
6746,441,4,1196,155,1351,6673,2021-01-28 10:56:19
6747,989,1,699,90,789,6674,2021-01-28 06:42:59
6748,12,5,2145,278,2423,6675,2021-01-28 09:36:11
6749,558,3,747,97,844,6676,2021-01-28 15:00:50
6750,281,6,2324,302,2626,6677,2021-01-28 07:49:45
6751,1000,2,898,116,1014,6678,2021-01-28 08:29:19
6752,976,3,1247,162,1409,6679,2021-01-28 17:16:16
6753,155,2,659,85,744,6680,2021-01-28 18:09:42
6754,323,2,628,81,709,6681,2021-01-28 11:24:42
6755,720,3,1127,146,1273,6682,2021-01-28 12:50:54
6756,798,3,927,120,1047,6683,2021-01-28 15:21:27
6757,447,3,558,72,630,6684,2021-01-28 01:11:42
6758,450,2,698,90,788,6685,2021-01-27 22:16:07
6759,357,1,299,38,337,6686,2021-01-27 19:38:43
6760,490,5,1406,182,1588,6687,2021-01-27 19:08:52
6761,172,3,478,62,540,6688,2021-01-28 12:17:06
6762,990,1,99,12,111,6689,2021-01-28 16:42:45
6763,393,5,1845,239,2084,6690,2021-01-28 14:36:07
6764,656,3,697,90,787,6691,2021-01-28 04:21:40
6765,366,3,827,107,934,6692,2021-01-27 17:00:24
6766,244,1,699,90,789,6693,2021-01-27 07:31:52
6767,648,5,1445,187,1632,6694,2021-01-27 14:42:37
6768,837,3,927,120,1047,6695,2021-01-27 14:36:19
6769,325,3,578,75,653,6696,2021-01-27 06:03:03
6770,795,6,2224,289,2513,6697,2021-01-27 17:38:07
6771,137,3,528,68,596,6698,2021-01-27 19:30:25
6772,573,3,428,55,483,6699,2021-01-27 22:16:46
6773,732,2,548,71,619,6700,2021-01-27 15:24:24
6774,836,2,898,116,1014,6701,2021-01-27 23:31:16
6775,88,3,697,90,787,6702,2021-01-28 09:52:26
6776,858,3,1047,136,1183,6703,2021-01-28 05:50:59
6777,50,5,1325,172,1497,6704,2021-01-28 04:50:58
6778,912,2,698,90,788,6705,2021-01-27 14:19:32
6779,663,4,1296,168,1464,6706,2021-01-27 17:44:56
6780,708,2,329,42,371,6707,2021-01-27 18:07:35
6781,104,3,1247,162,1409,6708,2021-01-27 22:48:35
6782,982,3,1047,136,1183,6709,2021-01-27 22:00:34
6783,702,3,478,62,540,6710,2021-01-29 03:43:37
6784,845,3,558,72,630,6711,2021-01-29 02:47:25
6785,967,2,598,77,675,6712,2021-01-28 22:20:47
6786,348,5,1486,193,1679,6713,2021-01-29 00:14:56
6787,204,2,798,103,901,6714,2021-01-29 00:23:58
6788,681,3,608,79,687,6715,2021-01-28 15:49:17
6789,840,2,498,64,562,6716,2021-01-28 09:52:24
6790,27,3,1327,172,1499,6717,2021-01-28 04:36:55
6791,217,2,798,103,901,6718,2021-01-28 04:16:08
6792,804,2,548,71,619,6719,2021-01-28 10:56:52
6793,30,5,1575,204,1779,6720,2021-01-28 12:05:15
6794,248,3,847,110,957,6721,2021-01-28 14:19:03
6795,189,2,329,42,371,6722,2021-01-29 02:50:15
6796,350,3,558,72,630,6723,2021-01-29 08:18:33
6797,80,3,1127,146,1273,6724,2021-01-28 09:35:04
6798,569,3,888,115,1003,6725,2021-01-28 16:53:30
6799,519,5,1226,159,1385,6726,2021-01-29 11:08:40
6800,718,3,1127,146,1273,6727,2021-01-29 07:05:09
6801,345,2,698,90,788,6728,2021-01-29 10:42:18
6802,431,3,1127,146,1273,6729,2021-01-29 04:37:50
6803,582,3,1327,172,1499,6730,2021-01-29 10:38:47
6804,380,6,1924,250,2174,6731,2021-01-28 23:15:03
6805,389,3,897,116,1013,6732,2021-01-29 18:20:02
6806,426,3,827,107,934,6733,2021-01-29 14:03:27
6807,98,4,1257,163,1420,6734,2021-01-28 21:27:17
6808,679,5,1825,237,2062,6735,2021-01-28 23:43:40
6809,141,4,1146,148,1294,6736,2021-01-27 18:20:56
6810,421,3,428,55,483,6737,2021-01-28 10:31:24
6811,461,3,847,110,957,6738,2021-01-28 05:05:02
6812,711,5,1706,221,1927,6739,2021-01-28 02:30:24
6813,815,3,997,129,1126,6740,2021-01-28 02:48:13
6814,984,4,1257,163,1420,6741,2021-01-28 02:30:35
6815,579,2,1098,142,1240,6742,2021-01-28 07:19:35
6816,359,6,1644,213,1857,6743,2021-01-28 07:07:18
6817,125,3,997,129,1126,6744,2021-01-28 07:39:56
6818,243,2,448,58,506,6745,2021-01-28 10:17:16
6819,528,3,1197,155,1352,6746,2021-01-28 16:39:25
6820,200,3,597,77,674,6747,2021-01-28 18:56:08
6821,621,3,1127,146,1273,6748,2021-01-28 13:10:48
6822,628,3,827,107,934,6749,2021-01-28 06:52:25
6823,975,3,927,120,1047,6750,2021-01-28 11:24:14
6824,398,2,1098,142,1240,6751,2021-01-28 15:25:59
6825,228,2,598,77,675,6752,2021-01-28 08:04:07
6826,999,3,578,75,653,6753,2021-01-28 09:47:57
6827,794,2,429,55,484,6754,2021-01-28 18:49:55
6828,95,3,658,85,743,6755,2021-01-28 18:47:55
6829,349,2,848,110,958,6756,2021-01-28 14:06:18
6830,486,6,1455,189,1644,6757,2021-01-28 13:57:44
6831,491,2,598,77,675,6758,2021-01-28 17:46:09
6832,46,3,647,84,731,6759,2021-01-28 01:31:26
6833,370,2,598,77,675,6760,2021-01-27 22:19:23
6834,835,3,727,94,821,6761,2021-01-27 20:19:53
6835,134,2,459,59,518,6762,2021-01-27 21:21:02
6836,777,3,428,55,483,6763,2021-01-28 12:45:43
6837,616,1,399,51,450,6764,2021-01-28 18:55:33
6838,480,3,827,107,934,6765,2021-01-28 16:00:05
6839,491,3,1197,155,1352,6766,2021-01-28 05:46:32
6840,771,5,1555,202,1757,6767,2021-01-27 17:32:00
6841,670,3,927,120,1047,6768,2021-01-27 09:00:33
6842,551,3,1327,172,1499,6769,2021-01-27 16:27:00
6843,481,2,329,42,371,6770,2021-01-27 15:02:20
6844,424,2,429,55,484,6771,2021-01-27 06:11:00
6845,27,3,697,90,787,6772,2021-01-27 18:24:00
6846,605,2,459,59,518,6773,2021-01-27 20:04:02
6847,627,3,997,129,1126,6774,2021-01-28 00:34:43
6848,702,3,727,94,821,6775,2021-01-27 16:02:50
6849,766,4,1596,207,1803,6776,2021-01-28 00:33:58
6850,675,6,1974,256,2230,6777,2021-01-28 10:15:56
6851,1,3,1327,172,1499,6778,2021-01-28 06:14:51
6852,567,1,499,64,563,6779,2021-01-28 06:47:11
6853,486,3,897,116,1013,6780,2021-01-27 15:12:02
6854,340,2,898,116,1014,6781,2021-01-27 18:01:01
6855,62,1,149,19,168,6782,2021-01-27 19:54:32
6856,234,5,1495,194,1689,6783,2021-01-28 01:08:21
6857,426,3,697,90,787,6784,2021-01-27 23:01:47
6858,682,4,1257,163,1420,6785,2021-01-29 05:01:38
6859,145,2,598,77,675,6786,2021-01-29 05:08:29
6860,138,3,897,116,1013,6787,2021-01-28 22:50:56
6861,287,3,847,110,957,6788,2021-01-29 01:22:46
6862,521,5,1376,178,1554,6789,2021-01-29 02:46:26
6863,87,3,758,98,856,6790,2021-01-28 16:28:31
6864,935,2,698,90,788,6791,2021-01-28 10:50:17
6865,475,1,99,12,111,6792,2021-01-28 06:23:22
6866,217,2,898,116,1014,6793,2021-01-28 05:52:56
6867,681,3,727,94,821,6794,2021-01-28 13:29:43
6868,120,3,747,97,844,6795,2021-01-28 14:49:58
6869,275,2,498,64,562,6796,2021-01-28 17:01:23
6870,312,2,798,103,901,6797,2021-01-29 03:15:33
6871,374,3,1027,133,1160,6798,2021-01-29 10:57:33
6872,686,1,99,12,111,6799,2021-01-28 12:02:53
6873,853,4,1646,213,1859,6800,2021-01-28 17:46:07
6874,185,4,1177,153,1330,6801,2021-01-29 13:34:06
6875,630,2,628,81,709,6802,2021-01-29 07:37:12
6876,475,3,747,97,844,6803,2021-01-29 13:24:38
6877,365,3,658,85,743,6804,2021-01-29 05:25:13
6878,132,3,1047,136,1183,6805,2021-01-29 12:13:54
6879,851,2,898,116,1014,6806,2021-01-29 01:19:33
6880,534,3,1047,136,1183,6807,2021-01-29 19:58:30
6881,367,3,658,85,743,6808,2021-01-29 14:12:20
6882,152,1,99,12,111,6809,2021-01-29 00:12:42
6883,332,4,1446,187,1633,6810,2021-01-29 02:02:38
6884,214,3,697,90,787,6811,2021-01-27 20:04:45
6885,3,3,1047,136,1183,6812,2021-01-28 11:15:38
6886,597,2,498,64,562,6813,2021-01-28 07:15:41
6887,505,3,1127,146,1273,6814,2021-01-28 04:23:59
6888,370,3,827,107,934,6815,2021-01-28 05:30:33
6889,441,1,99,12,111,6816,2021-01-28 02:59:32
6890,935,2,659,85,744,6817,2021-01-28 09:09:13
6891,38,2,898,116,1014,6818,2021-01-28 08:46:38
6892,678,3,428,55,483,6819,2021-01-28 09:53:41
6893,730,2,598,77,675,6820,2021-01-28 10:25:52
6894,454,2,659,85,744,6821,2021-01-28 18:55:17
6895,514,3,888,115,1003,6822,2021-01-28 20:07:47
6896,293,2,329,42,371,6823,2021-01-28 14:18:28
6897,854,3,747,97,844,6824,2021-01-28 06:58:12
6898,76,3,578,75,653,6825,2021-01-28 12:04:57
6899,93,2,1098,142,1240,6826,2021-01-28 16:14:27
6900,388,2,329,42,371,6827,2021-01-28 10:37:47
6901,926,3,558,72,630,6828,2021-01-28 12:27:21
6902,918,2,598,77,675,6829,2021-01-28 19:54:09
6903,877,3,997,129,1126,6830,2021-01-28 19:57:14
6904,451,3,428,55,483,6831,2021-01-28 16:03:14
6905,181,3,558,72,630,6832,2021-01-28 14:52:10
6906,384,4,1526,198,1724,6833,2021-01-28 19:26:18
6907,65,5,1325,172,1497,6834,2021-01-28 02:29:46
6908,454,3,808,105,913,6835,2021-01-28 00:24:09
6909,734,3,697,90,787,6836,2021-01-27 21:24:19
6910,98,1,499,64,563,6837,2021-01-27 22:38:34
6911,184,3,1047,136,1183,6838,2021-01-28 13:41:25
6912,693,3,647,84,731,6839,2021-01-28 19:16:32
6913,137,2,698,90,788,6840,2021-01-28 16:08:40
6914,298,3,847,110,957,6841,2021-01-28 05:48:15
6915,128,3,827,107,934,6842,2021-01-27 17:45:35
6916,305,3,558,72,630,6843,2021-01-27 10:48:40
6917,758,4,877,114,991,6844,2021-01-27 16:59:20
6918,619,3,1327,172,1499,6845,2021-01-27 16:40:52
6919,912,5,1026,133,1159,6846,2021-01-27 06:17:39
6920,459,3,697,90,787,6847,2021-01-27 18:50:13
6921,148,3,747,97,844,6848,2021-01-27 21:50:55
6922,860,2,598,77,675,6849,2021-01-28 02:28:39
6923,241,3,688,89,777,6850,2021-01-27 17:09:50
6924,257,3,827,107,934,6851,2021-01-28 01:20:05
6925,391,3,1327,172,1499,6852,2021-01-28 12:02:22
6926,31,3,1197,155,1352,6853,2021-01-28 08:47:36
6927,804,3,897,116,1013,6854,2021-01-28 08:02:57
6928,412,3,1327,172,1499,6855,2021-01-27 16:15:01
6929,546,3,797,103,900,6856,2021-01-27 18:18:26
6930,861,3,808,105,913,6857,2021-01-27 20:48:58
6931,394,3,558,72,630,6858,2021-01-28 02:59:58
6932,375,4,1596,207,1803,6859,2021-01-27 23:52:01
6933,120,4,1396,181,1577,6860,2021-01-29 07:19:58
6934,674,2,698,90,788,6861,2021-01-29 06:37:07
6935,215,4,1037,134,1171,6862,2021-01-29 01:21:06
6936,829,6,1505,195,1700,6863,2021-01-29 01:24:11
6937,533,2,1098,142,1240,6864,2021-01-29 04:32:38
6938,481,3,927,120,1047,6865,2021-01-28 18:20:15
6939,756,3,578,75,653,6866,2021-01-28 13:28:58
6940,931,2,429,55,484,6867,2021-01-28 07:49:34
6941,768,3,797,103,900,6868,2021-01-28 08:13:34
6942,249,2,659,85,744,6869,2021-01-28 15:45:29
6943,578,3,1027,133,1160,6870,2021-01-28 16:21:28
6944,414,1,229,29,258,6871,2021-01-28 17:05:25
6945,13,3,597,77,674,6872,2021-01-29 04:08:14
6946,796,3,1247,162,1409,6873,2021-01-29 11:19:20
6947,998,3,758,98,856,6874,2021-01-28 13:11:05
6948,67,3,647,84,731,6875,2021-01-28 18:26:52
6949,101,2,429,55,484,6876,2021-01-29 13:34:08
6950,795,5,1525,198,1723,6877,2021-01-29 07:58:50
6951,27,3,797,103,900,6878,2021-01-29 14:27:21
6952,1000,2,659,85,744,6879,2021-01-29 07:25:49
6953,1000,2,659,85,744,6879,2021-01-29 07:25:49
6954,719,5,1126,146,1272,6880,2021-01-29 14:18:51
6955,671,2,498,64,562,6881,2021-01-29 01:51:24
6956,106,2,598,77,675,6882,2021-01-29 21:08:37
6957,800,4,1556,202,1758,6883,2021-01-29 14:26:58
6958,959,3,558,72,630,6884,2021-01-29 01:32:35
6959,188,6,1794,233,2027,6885,2021-01-29 04:05:05
6960,197,3,997,129,1126,6886,2021-01-27 21:56:44
6961,181,3,1047,136,1183,6887,2021-01-28 13:43:27
6962,516,6,1685,219,1904,6888,2021-01-28 08:27:38
6963,47,2,1098,142,1240,6889,2021-01-28 05:46:28
6964,151,3,1027,133,1160,6890,2021-01-28 07:09:21
6965,110,6,986,128,1114,6891,2021-01-28 04:32:11
6966,702,2,898,116,1014,6892,2021-01-28 09:41:08
6967,707,2,498,64,562,6893,2021-01-28 08:47:10
6968,493,3,558,72,630,6894,2021-01-28 11:48:20
6969,856,2,498,64,562,6895,2021-01-28 13:00:29
6970,611,3,688,89,777,6896,2021-01-28 20:29:42
6971,620,4,1057,137,1194,6897,2021-01-28 21:51:04
6972,720,2,429,55,484,6898,2021-01-28 16:25:43
6973,994,3,947,123,1070,6899,2021-01-28 09:27:26
6974,32,3,1197,155,1352,6900,2021-01-28 14:29:39
6975,962,3,558,72,630,6901,2021-01-28 17:54:53
6976,98,2,598,77,675,6902,2021-01-28 12:05:58
6977,247,3,827,107,934,6903,2021-01-28 14:20:29
6978,215,3,428,55,483,6904,2021-01-28 22:37:46
6979,632,1,99,12,111,6905,2021-01-28 21:49:28
6980,102,2,498,64,562,6906,2021-01-28 18:42:34
6981,195,3,1047,136,1183,6907,2021-01-28 16:09:11
6982,958,3,1127,146,1273,6908,2021-01-28 21:55:01
6983,282,3,997,129,1126,6909,2021-01-28 03:03:34
6984,47,3,747,97,844,6910,2021-01-28 02:27:44
6985,336,3,658,85,743,6911,2021-01-27 22:40:40
6986,980,3,528,68,596,6912,2021-01-27 22:59:31
6987,658,3,747,97,844,6913,2021-01-28 16:21:18
6988,239,3,758,98,856,6914,2021-01-28 21:06:41
6989,466,3,1347,175,1522,6915,2021-01-28 17:57:34
6990,480,3,997,129,1126,6916,2021-01-28 08:04:47
6991,118,3,578,75,653,6917,2021-01-27 19:34:44
6992,315,3,597,77,674,6918,2021-01-27 12:11:24
6993,198,3,827,107,934,6919,2021-01-27 19:14:35
6994,707,2,429,55,484,6920,2021-01-27 17:03:58
6995,217,3,1127,146,1273,6921,2021-01-27 07:35:46
6996,520,2,659,85,744,6922,2021-01-27 18:55:40
6997,834,2,548,71,619,6923,2021-01-27 22:39:28
6998,98,2,898,116,1014,6924,2021-01-28 03:21:40
6999,543,3,428,55,483,6925,2021-01-27 18:46:27
7000,423,6,1455,189,1644,6926,2021-01-28 01:33:32
7001,157,3,478,62,540,6927,2021-01-28 12:58:46
7002,12,4,796,103,899,6928,2021-01-28 10:22:49
7003,186,3,1047,136,1183,6929,2021-01-28 09:05:28
7004,304,4,1696,220,1916,6930,2021-01-27 18:05:18
7005,812,3,697,90,787,6931,2021-01-27 18:38:15
7006,332,2,598,77,675,6932,2021-01-27 23:30:57
7007,574,3,827,107,934,6933,2021-01-28 04:14:59
7008,419,4,1396,181,1577,6934,2021-01-27 23:59:33
7009,42,2,898,116,1014,6935,2021-01-29 08:57:07
7010,133,3,727,94,821,6936,2021-01-29 08:08:42
7011,604,3,797,103,900,6937,2021-01-29 03:08:17
7012,670,3,1047,136,1183,6938,2021-01-29 01:57:00
7013,8,3,1027,133,1160,6939,2021-01-29 05:24:33
7014,236,3,578,75,653,6940,2021-01-28 18:32:12
7015,480,6,1824,237,2061,6941,2021-01-28 13:47:13
7016,696,3,428,55,483,6942,2021-01-28 08:53:05
7017,113,3,747,97,844,6943,2021-01-28 10:32:57
7018,279,3,1127,146,1273,6944,2021-01-28 16:27:17
7019,120,3,827,107,934,6945,2021-01-28 18:37:24
7020,723,3,997,129,1126,6946,2021-01-28 18:37:36
7021,527,6,2354,306,2660,6947,2021-01-29 04:42:09
7022,395,3,1197,155,1352,6948,2021-01-29 12:23:28
7023,196,3,927,120,1047,6949,2021-01-28 14:05:21
7024,609,4,1326,172,1498,6950,2021-01-28 19:49:59
7025,150,5,1945,252,2197,6951,2021-01-29 16:11:29
7026,293,3,808,105,913,6952,2021-01-29 10:09:09
7027,623,2,828,107,935,6953,2021-01-29 14:38:06
7028,856,2,329,42,371,6954,2021-01-29 09:58:07
7029,928,2,498,64,562,6955,2021-01-29 09:00:17
7030,791,3,797,103,900,6956,2021-01-29 14:29:44
7031,791,3,797,103,900,6956,2021-01-29 14:29:44
7032,240,3,1047,136,1183,6957,2021-01-29 03:47:43
7033,137,2,898,116,1014,6958,2021-01-29 22:19:05
7034,715,5,1276,165,1441,6959,2021-01-29 16:35:32
7035,404,3,808,105,913,6960,2021-01-29 03:47:14
7036,500,2,698,90,788,6961,2021-01-29 05:19:50
7037,109,6,1755,228,1983,6962,2021-01-27 23:14:58
7038,321,3,1127,146,1273,6963,2021-01-28 15:20:03
7039,671,3,658,85,743,6964,2021-01-28 09:54:49
7040,359,2,459,59,518,6965,2021-01-28 06:41:17
7041,458,5,1345,174,1519,6966,2021-01-28 08:14:09
7042,886,5,1625,211,1836,6967,2021-01-28 05:24:44
7043,506,1,149,19,168,6968,2021-01-28 09:51:50
7044,463,3,1047,136,1183,6969,2021-01-28 10:52:35
7045,612,3,1247,162,1409,6970,2021-01-28 12:41:21
7046,60,2,598,77,675,6971,2021-01-28 15:39:34
7047,979,3,697,90,787,6972,2021-01-28 20:59:28
7048,388,2,598,77,675,6973,2021-01-28 22:50:52
7049,331,3,847,110,957,6974,2021-01-28 19:00:43
7050,269,2,398,51,449,6975,2021-01-28 10:18:16
7051,446,4,1296,168,1464,6976,2021-01-28 14:54:41
7052,456,3,827,107,934,6977,2021-01-28 19:22:47
7053,894,3,1247,162,1409,6978,2021-01-28 12:13:29
7054,23,6,1324,172,1496,6979,2021-01-28 15:43:53
7055,748,1,699,90,789,6980,2021-01-28 22:48:30
7056,405,3,1047,136,1183,6981,2021-01-28 23:04:18
7057,642,2,1098,142,1240,6982,2021-01-28 20:12:46
7058,52,3,478,62,540,6983,2021-01-28 17:14:15
7059,478,3,478,62,540,6984,2021-01-28 22:41:42
7060,998,2,898,116,1014,6985,2021-01-28 05:23:31
7061,717,2,898,116,1014,6986,2021-01-28 03:22:13
7062,101,6,1935,251,2186,6987,2021-01-28 00:39:02
7063,519,3,697,90,787,6988,2021-01-27 23:40:26
7064,737,6,1935,251,2186,6989,2021-01-28 17:19:13
7065,95,5,1226,159,1385,6990,2021-01-28 21:29:53
7066,130,3,1047,136,1183,6991,2021-01-28 18:24:02
7067,831,2,459,59,518,6992,2021-01-28 10:32:51
7068,552,3,747,97,844,6993,2021-01-27 20:56:52
7069,848,4,1596,207,1803,6994,2021-01-27 14:47:02
7070,788,3,688,89,777,6995,2021-01-27 21:57:29
7071,90,4,1257,163,1420,6996,2021-01-27 18:14:30
7072,889,3,1127,146,1273,6997,2021-01-27 09:39:59
7073,889,3,1197,155,1352,6998,2021-01-27 19:04:40
7074,757,2,329,42,371,6999,2021-01-27 23:29:28
7075,438,1,149,19,168,7000,2021-01-28 04:12:13
7076,869,3,1327,172,1499,7001,2021-01-27 18:46:58
7077,182,3,428,55,483,7002,2021-01-28 02:38:41
7078,337,6,1116,145,1261,7003,2021-01-28 15:22:56
7079,941,5,1156,150,1306,7004,2021-01-28 11:24:18
7080,984,2,598,77,675,7005,2021-01-28 09:36:50
7081,369,3,597,77,674,7006,2021-01-27 19:13:30
7082,707,3,1127,146,1273,7007,2021-01-27 21:15:27
7083,51,1,99,12,111,7008,2021-01-28 00:07:08
7084,822,3,478,62,540,7009,2021-01-28 04:51:09
7085,91,2,598,77,675,7010,2021-01-28 01:33:54
7086,792,2,898,116,1014,7011,2021-01-29 11:19:16
7087,79,3,558,72,630,7012,2021-01-29 09:43:14
7088,260,1,599,77,676,7013,2021-01-29 04:05:03
7089,785,3,847,110,957,7014,2021-01-29 03:29:24
7090,445,3,697,90,787,7015,2021-01-29 05:29:22
7091,225,3,847,110,957,7016,2021-01-28 21:12:49
7092,408,1,399,51,450,7017,2021-01-28 14:26:36
7093,500,2,698,90,788,7018,2021-01-28 09:07:39
7094,641,2,659,85,744,7019,2021-01-28 11:48:31
7095,677,2,429,55,484,7020,2021-01-28 17:09:49
7096,613,2,598,77,675,7021,2021-01-28 19:26:41
7097,51,3,747,97,844,7022,2021-01-28 19:52:44
7098,210,3,578,75,653,7023,2021-01-29 04:54:00
7099,24,2,498,64,562,7024,2021-01-29 13:49:25
7100,507,3,888,115,1003,7025,2021-01-28 15:58:21
7101,758,4,1396,181,1577,7026,2021-01-28 22:13:54
7102,300,3,558,72,630,7027,2021-01-29 18:54:45
7103,423,3,1297,168,1465,7028,2021-01-29 12:41:38
7104,232,2,329,42,371,7029,2021-01-29 17:24:43
7105,486,3,558,72,630,7030,2021-01-29 12:13:48
7106,37,3,1047,136,1183,7031,2021-01-29 09:26:56
7107,286,3,1027,133,1160,7032,2021-01-29 14:54:13
7108,886,3,558,72,630,7033,2021-01-29 15:53:14
7109,42,3,997,129,1126,7034,2021-01-29 04:58:10
7110,29,3,528,68,596,7035,2021-01-30 00:14:39
7111,978,2,659,85,744,7036,2021-01-29 16:37:31
7112,370,3,428,55,483,7037,2021-01-29 03:54:30
7113,807,3,608,79,687,7038,2021-01-29 05:59:52
7114,148,3,847,110,957,7039,2021-01-28 01:24:54
7115,682,3,997,129,1126,7040,2021-01-28 16:36:21
7116,413,1,699,90,789,7041,2021-01-28 12:36:36
7117,869,5,1575,204,1779,7042,2021-01-28 09:27:10
7118,695,3,927,120,1047,7043,2021-01-28 08:29:38
7119,763,3,947,123,1070,7044,2021-01-28 06:01:21
7120,195,4,1296,168,1464,7045,2021-01-28 11:22:31
7121,374,2,1098,142,1240,7046,2021-01-28 12:32:48
7122,245,3,758,98,856,7047,2021-01-28 14:58:48
7123,157,3,558,72,630,7048,2021-01-28 15:57:37
7124,768,2,459,59,518,7049,2021-01-28 22:54:10
7125,480,3,897,116,1013,7050,2021-01-28 23:43:19
7126,564,2,548,71,619,7051,2021-01-28 19:10:10
7127,731,2,429,55,484,7052,2021-01-28 11:16:49
7128,468,3,478,62,540,7053,2021-01-28 15:08:06
7129,558,3,1247,162,1409,7054,2021-01-28 21:28:00
7130,976,5,1745,226,1971,7055,2021-01-28 13:27:45
7131,692,3,697,90,787,7056,2021-01-28 16:30:08
7132,357,3,808,105,913,7057,2021-01-29 00:16:42
7133,727,3,528,68,596,7058,2021-01-29 00:59:38
7134,15,5,1286,167,1453,7059,2021-01-28 21:59:31
7135,409,3,827,107,934,7060,2021-01-28 19:43:09
7136,437,3,647,84,731,7061,2021-01-29 01:20:59
7137,53,1,499,64,563,7062,2021-01-28 06:37:10
7138,743,2,748,97,845,7063,2021-01-28 05:22:42
7139,694,3,888,115,1003,7064,2021-01-28 02:46:45
7140,691,3,927,120,1047,7065,2021-01-28 02:11:30
7141,695,3,558,72,630,7066,2021-01-28 17:36:20
7142,772,2,659,85,744,7067,2021-01-28 23:40:20
7143,408,2,498,64,562,7068,2021-01-28 19:49:27
7144,714,3,578,75,653,7069,2021-01-28 11:28:15
7145,234,2,598,77,675,7070,2021-01-27 22:37:18
7146,443,2,698,90,788,7071,2021-01-27 15:10:45
7147,707,2,598,77,675,7072,2021-01-27 23:32:57
7148,413,2,598,77,675,7073,2021-01-27 19:14:00
7149,840,3,827,107,934,7074,2021-01-27 10:39:41
7150,185,3,1327,172,1499,7075,2021-01-27 21:12:57
7151,868,3,808,105,913,7076,2021-01-28 01:43:05
7152,758,3,608,79,687,7077,2021-01-28 05:54:58
7153,608,2,728,94,822,7078,2021-01-27 20:53:32
7154,722,3,697,90,787,7079,2021-01-28 03:03:48
7155,249,6,1355,176,1531,7080,2021-01-28 15:53:41
7156,510,2,459,59,518,7081,2021-01-28 13:14:07
7157,763,3,428,55,483,7082,2021-01-28 09:52:02
7158,763,3,428,55,483,7082,2021-01-28 09:52:02
7159,611,3,1247,162,1409,7083,2021-01-27 20:59:32
7160,736,2,1098,142,1240,7084,2021-01-27 21:25:50
7161,124,3,1197,155,1352,7085,2021-01-28 01:50:32
7162,255,2,598,77,675,7086,2021-01-28 05:22:01
7163,160,3,797,103,900,7087,2021-01-28 01:48:49
7164,536,3,597,77,674,7088,2021-01-29 13:09:33
7165,116,3,897,116,1013,7089,2021-01-29 11:32:26
7166,984,3,1047,136,1183,7090,2021-01-29 05:37:16
7167,176,5,1725,224,1949,7091,2021-01-29 03:34:42
7168,953,3,697,90,787,7092,2021-01-29 07:00:58
7169,404,2,459,59,518,7093,2021-01-28 23:34:22
7170,968,3,1197,155,1352,7094,2021-01-28 15:48:13
7171,901,1,599,77,676,7095,2021-01-28 10:36:25
7172,398,5,1456,189,1645,7096,2021-01-28 13:36:19
7173,735,3,1197,155,1352,7097,2021-01-28 19:16:41
7174,655,3,1247,162,1409,7098,2021-01-28 19:36:08
7175,249,3,1047,136,1183,7099,2021-01-28 20:41:26
7176,1,3,478,62,540,7100,2021-01-29 05:26:24
7177,247,2,598,77,675,7101,2021-01-29 14:30:45
7178,66,2,628,81,709,7102,2021-01-28 16:55:41
7179,242,1,599,77,676,7103,2021-01-28 22:37:26
7180,331,3,847,110,957,7104,2021-01-29 18:55:41
7181,400,2,698,90,788,7105,2021-01-29 13:45:44
7182,78,3,1247,162,1409,7106,2021-01-29 20:05:54
7183,8,3,697,90,787,7107,2021-01-29 12:54:59
7184,252,3,597,77,674,7108,2021-01-29 09:32:56
7185,828,6,1355,176,1531,7109,2021-01-29 16:12:57
7186,577,3,647,84,731,7110,2021-01-29 18:14:02
7187,554,3,608,79,687,7111,2021-01-29 07:20:40
7188,147,3,597,77,674,7112,2021-01-30 02:51:13
7189,164,3,808,105,913,7113,2021-01-29 18:01:59
7190,283,3,478,62,540,7114,2021-01-29 06:04:36
7191,142,3,758,98,856,7115,2021-01-29 06:15:59
7192,451,3,1327,172,1499,7116,2021-01-28 02:59:45
7193,733,3,1027,133,1160,7117,2021-01-28 18:27:40
7194,97,2,329,42,371,7118,2021-01-28 15:18:58
7195,31,2,698,90,788,7119,2021-01-28 11:06:43
7196,140,2,898,116,1014,7120,2021-01-28 11:06:16
7197,173,3,1197,155,1352,7121,2021-01-28 08:03:11
7198,370,1,229,29,258,7122,2021-01-28 12:36:19
7199,693,3,997,129,1126,7123,2021-01-28 12:47:21
7200,830,3,1127,146,1273,7124,2021-01-28 15:53:54
7201,919,3,597,77,674,7125,2021-01-28 16:39:12
7202,48,3,578,75,653,7126,2021-01-29 01:32:03
7203,948,3,727,94,821,7127,2021-01-29 02:23:13
7204,419,3,1247,162,1409,7128,2021-01-28 21:28:30
7205,15,3,727,94,821,7129,2021-01-28 13:46:40
7206,23,3,747,97,844,7130,2021-01-28 17:28:51
7207,702,3,897,116,1013,7131,2021-01-28 22:24:01
7208,227,2,659,85,744,7132,2021-01-28 14:02:46
7209,828,2,329,42,371,7133,2021-01-28 18:55:17
7210,525,5,1286,167,1453,7134,2021-01-29 01:16:48
7211,29,4,1396,181,1577,7135,2021-01-29 03:14:14
7212,966,3,558,72,630,7136,2021-01-28 23:02:46
7213,990,3,947,123,1070,7137,2021-01-28 20:38:05
7214,462,3,1127,146,1273,7138,2021-01-29 03:12:14
7215,509,1,99,12,111,7139,2021-01-28 09:12:12
7216,843,6,1394,181,1575,7140,2021-01-28 07:03:07
7217,750,3,997,129,1126,7141,2021-01-28 02:46:54
7218,839,3,1027,133,1160,7142,2021-01-28 02:17:59
7219,738,3,578,75,653,7143,2021-01-28 19:26:58
7220,135,2,598,77,675,7144,2021-01-29 01:10:06
7221,205,2,698,90,788,7145,2021-01-28 22:04:22
7222,328,1,599,77,676,7146,2021-01-28 13:40:57
7223,753,3,558,72,630,7147,2021-01-27 23:22:15
7224,954,5,807,104,911,7148,2021-01-27 15:35:32
7225,729,3,747,97,844,7149,2021-01-28 00:01:27
7226,169,1,229,29,258,7150,2021-01-27 21:44:57
7227,879,5,1137,147,1284,7151,2021-01-27 10:48:09
7228,563,2,698,90,788,7152,2021-01-27 22:35:46
7229,728,2,898,116,1014,7153,2021-01-28 04:05:10
7230,124,2,698,90,788,7154,2021-01-28 07:40:03
7231,493,2,798,103,901,7155,2021-01-27 21:08:10
7232,30,3,747,97,844,7156,2021-01-28 05:42:07
7233,850,3,947,123,1070,7157,2021-01-28 15:57:15
7234,736,2,628,81,709,7158,2021-01-28 13:53:48
7235,765,3,797,103,900,7159,2021-01-28 12:17:42
7236,87,3,647,84,731,7160,2021-01-28 11:06:15
7237,355,2,329,42,371,7161,2021-01-27 22:45:03
7238,753,3,697,90,787,7162,2021-01-27 23:19:31
7239,247,2,659,85,744,7163,2021-01-28 02:12:06
7240,338,3,647,84,731,7164,2021-01-28 06:46:09
7241,447,3,697,90,787,7165,2021-01-28 02:54:04
7242,602,4,1426,185,1611,7166,2021-01-29 15:17:37
7243,621,3,658,85,743,7167,2021-01-29 11:59:50
7244,79,5,2095,272,2367,7168,2021-01-29 07:26:14
7245,896,3,478,62,540,7169,2021-01-29 05:38:59
7246,189,3,897,116,1013,7170,2021-01-29 07:48:30
7247,966,2,498,64,562,7171,2021-01-29 00:52:45
7248,596,2,598,77,675,7172,2021-01-28 17:56:24
7249,655,5,1137,147,1284,7173,2021-01-28 11:44:40
7250,48,2,1098,142,1240,7174,2021-01-28 14:59:15
7251,885,2,898,116,1014,7175,2021-01-28 19:25:15
7252,219,2,598,77,675,7176,2021-01-28 19:45:31
7253,391,2,898,116,1014,7177,2021-01-28 22:47:33
7254,874,3,608,79,687,7178,2021-01-29 07:43:52
7255,731,5,1995,259,2254,7179,2021-01-29 16:25:44
7256,571,3,1127,146,1273,7180,2021-01-28 19:02:45
7257,740,3,1127,146,1273,7181,2021-01-28 23:24:48
7258,887,2,728,94,822,7182,2021-01-29 19:54:28
7259,826,3,1197,155,1352,7183,2021-01-29 15:28:20
7260,491,3,797,103,900,7184,2021-01-29 22:15:41
7261,222,4,1396,181,1577,7185,2021-01-29 15:23:03
7262,36,3,697,90,787,7186,2021-01-29 09:35:01
7263,570,3,597,77,674,7187,2021-01-29 17:18:55
7264,613,2,698,90,788,7188,2021-01-29 19:14:11
7265,891,3,428,55,483,7189,2021-01-29 09:21:56
7266,475,3,997,129,1126,7190,2021-01-30 04:26:30
7267,169,2,598,77,675,7191,2021-01-29 20:04:49
7268,656,3,827,107,934,7192,2021-01-29 08:27:01
7269,851,4,1696,220,1916,7193,2021-01-29 06:24:03
7270,805,2,728,94,822,7194,2021-01-28 05:19:54
7271,112,2,548,71,619,7195,2021-01-28 20:44:48
7272,670,2,498,64,562,7196,2021-01-28 17:45:11
7273,926,3,1327,172,1499,7197,2021-01-28 13:41:21
7274,2,2,728,94,822,7198,2021-01-28 13:38:25
7275,362,3,1247,162,1409,7199,2021-01-28 08:24:55
7276,330,3,1047,136,1183,7200,2021-01-28 14:19:26
7277,991,2,459,59,518,7201,2021-01-28 15:20:46
7278,963,2,628,81,709,7202,2021-01-28 17:13:53
7279,664,3,827,107,934,7203,2021-01-28 19:04:45
7280,150,3,797,103,900,7204,2021-01-29 03:00:57
7281,207,3,697,90,787,7205,2021-01-29 03:37:24
7282,26,1,99,12,111,7206,2021-01-28 23:36:58
7283,315,3,1047,136,1183,7207,2021-01-28 15:10:04
7284,641,2,828,107,935,7208,2021-01-28 18:52:27
7285,757,3,1127,146,1273,7209,2021-01-28 23:37:28
7286,941,3,897,116,1013,7210,2021-01-28 16:32:25
7287,941,3,897,116,1013,7210,2021-01-28 16:32:25
7288,320,3,558,72,630,7211,2021-01-28 21:17:50
7289,584,3,1047,136,1183,7212,2021-01-29 01:33:54
7290,829,2,898,116,1014,7213,2021-01-29 04:10:40
7291,104,2,429,55,484,7214,2021-01-28 23:04:20
7292,475,2,659,85,744,7215,2021-01-28 21:37:32
7293,101,3,947,123,1070,7216,2021-01-29 04:39:54
7294,262,3,897,116,1013,7217,2021-01-28 11:25:02
7295,483,3,697,90,787,7218,2021-01-28 07:03:16
7296,266,5,1345,174,1519,7219,2021-01-28 03:49:31
7297,22,3,428,55,483,7220,2021-01-28 02:40:33
7298,164,3,808,105,913,7221,2021-01-28 20:08:32
7299,625,3,1047,136,1183,7222,2021-01-29 01:44:16
7300,773,3,647,84,731,7223,2021-01-29 00:09:54
7301,773,3,647,84,731,7223,2021-01-29 00:09:54
7302,2,3,428,55,483,7224,2021-01-28 14:27:34
7303,291,2,598,77,675,7225,2021-01-28 01:43:44
7304,474,2,898,116,1014,7226,2021-01-27 16:27:33
7305,139,2,598,77,675,7227,2021-01-28 00:28:22
7306,148,2,659,85,744,7228,2021-01-27 22:15:26
7307,55,2,598,77,675,7229,2021-01-27 12:49:52
7308,338,3,658,85,743,7230,2021-01-27 23:45:06
7309,694,2,598,77,675,7231,2021-01-28 04:38:17
7310,143,3,747,97,844,7232,2021-01-28 08:45:28
7311,153,2,928,120,1048,7233,2021-01-27 23:21:07
7312,184,5,1187,154,1341,7234,2021-01-28 07:49:34
7313,318,3,597,77,674,7235,2021-01-28 16:12:55
7314,78,2,648,84,732,7236,2021-01-28 14:53:18
7315,235,2,429,55,484,7237,2021-01-28 13:39:55
7316,640,1,399,51,450,7238,2021-01-28 13:03:17
7317,938,5,1226,159,1385,7239,2021-01-28 00:31:39
7318,259,3,947,123,1070,7240,2021-01-27 23:26:23
7319,337,3,1027,133,1160,7241,2021-01-28 03:07:35
7320,376,5,1786,232,2018,7242,2021-01-28 06:48:53
7321,755,3,558,72,630,7243,2021-01-28 04:12:31
7322,786,3,947,123,1070,7244,2021-01-29 16:42:54
7323,960,4,1626,211,1837,7245,2021-01-29 12:03:59
7324,444,3,827,107,934,7246,2021-01-29 08:58:00
7325,35,3,1247,162,1409,7247,2021-01-29 07:41:22
7326,829,3,947,123,1070,7248,2021-01-29 08:45:29
7327,388,3,808,105,913,7249,2021-01-29 01:29:40
7328,253,2,648,84,732,7250,2021-01-28 20:11:20
7329,61,2,698,90,788,7251,2021-01-28 14:23:28
7330,388,3,558,72,630,7252,2021-01-28 15:42:25
7331,889,5,1345,174,1519,7253,2021-01-28 21:05:00
7332,721,3,727,94,821,7254,2021-01-28 22:29:57
7333,407,3,1127,146,1273,7255,2021-01-29 01:34:10
7334,561,5,1186,154,1340,7256,2021-01-29 08:59:50
7335,18,2,448,58,506,7257,2021-01-29 17:36:47
7336,215,3,997,129,1126,7258,2021-01-28 21:25:28
7337,233,3,747,97,844,7259,2021-01-29 01:07:21
7338,707,3,888,115,1003,7260,2021-01-29 22:31:02
7339,248,2,659,85,744,7261,2021-01-29 17:28:07
7340,542,6,1744,226,1970,7262,2021-01-30 00:02:28
7341,844,3,888,115,1003,7263,2021-01-29 15:34:10
7342,8,2,848,110,958,7264,2021-01-29 11:38:01
7343,352,3,727,94,821,7265,2021-01-29 17:26:59
7344,733,3,688,89,777,7266,2021-01-29 19:49:36
7345,498,3,847,110,957,7267,2021-01-29 09:34:25
7346,640,3,578,75,653,7268,2021-01-30 05:40:57
7347,164,3,1027,133,1160,7269,2021-01-29 22:07:39
7348,894,3,647,84,731,7270,2021-01-29 10:43:13
7349,528,5,1786,232,2018,7271,2021-01-29 08:19:30
7350,776,3,888,115,1003,7272,2021-01-28 06:41:16
7351,507,3,997,129,1126,7273,2021-01-28 21:13:48
7352,102,3,558,72,630,7274,2021-01-28 20:09:35
7353,467,2,898,116,1014,7275,2021-01-28 16:27:54
7354,471,3,747,97,844,7276,2021-01-28 16:13:29
7355,435,3,888,115,1003,7277,2021-01-28 10:33:13
7356,435,3,888,115,1003,7277,2021-01-28 10:33:13
7357,726,5,1356,176,1532,7278,2021-01-28 15:37:17
7358,690,3,797,103,900,7279,2021-01-28 16:27:35
7359,235,2,628,81,709,7280,2021-01-28 18:13:32
7360,241,3,1127,146,1273,7281,2021-01-28 19:07:44
7361,590,3,897,116,1013,7282,2021-01-29 03:23:49
7362,27,1,149,19,168,7283,2021-01-29 05:18:52
7363,83,3,528,68,596,7284,2021-01-29 00:57:51
7364,23,3,697,90,787,7285,2021-01-28 15:34:51
7365,941,2,598,77,675,7286,2021-01-28 19:39:41
7366,165,2,528,68,596,7287,2021-01-29 01:55:56
7367,877,5,1156,150,1306,7288,2021-01-28 17:35:17
7368,532,3,827,107,934,7289,2021-01-28 17:03:48
7369,669,3,927,120,1047,7290,2021-01-28 23:11:09
7370,66,3,827,107,934,7291,2021-01-29 03:50:51
7371,409,2,659,85,744,7292,2021-01-29 05:07:13
7372,522,5,1226,159,1385,7293,2021-01-29 00:39:40
7373,737,3,847,110,957,7294,2021-01-28 23:55:41
7374,245,4,1226,159,1385,7295,2021-01-29 06:19:45
7375,215,1,99,12,111,7296,2021-01-28 11:42:42
7376,514,3,797,103,900,7297,2021-01-28 07:41:23
7377,749,4,758,98,856,7298,2021-01-28 05:19:18
7378,49,5,1376,178,1554,7299,2021-01-28 03:59:03
7379,770,3,578,75,653,7300,2021-01-28 22:32:45
7380,730,3,1047,136,1183,7301,2021-01-29 04:12:44
7381,857,3,608,79,687,7302,2021-01-29 02:52:31
7382,498,6,1485,193,1678,7303,2021-01-29 00:52:09
7383,643,6,1594,207,1801,7304,2021-01-28 17:05:53
7384,734,3,1297,168,1465,7305,2021-01-28 03:02:49
7385,499,3,478,62,540,7306,2021-01-27 17:39:48
7386,512,3,997,129,1126,7307,2021-01-28 01:53:50
7387,370,2,898,116,1014,7308,2021-01-28 00:56:44
7388,370,2,898,116,1014,7308,2021-01-28 00:56:44
7389,105,3,1127,146,1273,7309,2021-01-27 14:37:55
7390,899,1,699,90,789,7310,2021-01-28 00:18:50
7391,179,3,1047,136,1183,7311,2021-01-28 07:15:28
7392,61,3,478,62,540,7312,2021-01-28 09:44:28
7393,9,1,699,90,789,7313,2021-01-28 01:38:30
7394,461,3,927,120,1047,7314,2021-01-28 09:45:42
7395,564,3,1027,133,1160,7315,2021-01-28 17:28:29
7396,321,3,947,123,1070,7316,2021-01-28 16:11:45
7397,699,3,758,98,856,7317,2021-01-28 15:55:06
7398,987,3,747,97,844,7318,2021-01-28 15:41:48
7399,521,2,498,64,562,7319,2021-01-28 02:47:05
7400,573,3,647,84,731,7320,2021-01-28 01:22:01
7401,367,3,758,98,856,7321,2021-01-28 04:43:27
7402,113,3,827,107,934,7322,2021-01-28 07:28:17
7403,508,3,1247,162,1409,7323,2021-01-28 04:48:15
7404,744,2,598,77,675,7324,2021-01-29 16:51:55
7405,31,5,1325,172,1497,7325,2021-01-29 12:20:20
7406,838,3,997,129,1126,7326,2021-01-29 09:21:47
7407,570,3,1027,133,1160,7327,2021-01-29 09:24:40
7408,864,2,528,68,596,7328,2021-01-29 09:11:25
7409,763,3,747,97,844,7329,2021-01-29 03:18:11
7410,994,3,997,129,1126,7330,2021-01-28 21:40:31
7411,624,3,797,103,900,7331,2021-01-28 14:33:42
7412,208,5,1226,159,1385,7332,2021-01-28 17:39:36
7413,638,3,758,98,856,7333,2021-01-28 22:14:39
7414,930,3,558,72,630,7334,2021-01-28 22:58:15
7415,721,1,499,64,563,7335,2021-01-29 02:37:33
7416,874,2,1098,142,1240,7336,2021-01-29 11:39:16
7417,992,3,1247,162,1409,7337,2021-01-29 18:44:50
7418,386,2,1098,142,1240,7338,2021-01-28 23:23:37
7419,751,3,608,79,687,7339,2021-01-29 03:49:04
7420,757,3,1127,146,1273,7340,2021-01-29 22:33:06
7421,68,3,578,75,653,7341,2021-01-29 17:28:13
7422,474,3,688,89,777,7342,2021-01-30 02:03:48
7423,469,3,827,107,934,7343,2021-01-29 17:39:45
7424,925,2,798,103,901,7344,2021-01-29 13:50:14
7425,486,3,727,94,821,7345,2021-01-29 18:05:52
7426,486,3,727,94,821,7345,2021-01-29 18:05:52
7427,105,2,459,59,518,7346,2021-01-29 22:24:44
7428,214,5,1195,155,1350,7347,2021-01-29 11:36:21
7429,27,1,149,19,168,7348,2021-01-30 07:10:19
7430,851,3,1127,146,1273,7349,2021-01-30 00:05:52
7431,19,2,898,116,1014,7350,2021-01-29 11:21:47
7432,93,3,1197,155,1352,7351,2021-01-29 09:39:12
7433,236,3,697,90,787,7352,2021-01-28 07:11:18
7434,555,3,797,103,900,7353,2021-01-28 21:14:55
7435,973,2,548,71,619,7354,2021-01-28 22:35:51
7436,982,3,927,120,1047,7355,2021-01-28 18:45:20
7437,887,3,897,116,1013,7356,2021-01-28 17:05:07
7438,591,3,1047,136,1183,7357,2021-01-28 12:58:34
7439,638,6,1855,241,2096,7358,2021-01-28 11:39:32
7440,265,3,727,94,821,7359,2021-01-28 16:13:48
7441,262,2,459,59,518,7360,2021-01-28 17:00:30
7442,262,2,459,59,518,7360,2021-01-28 17:00:30
7443,340,1,399,51,450,7361,2021-01-28 19:31:37
7444,855,4,1307,169,1476,7362,2021-01-28 19:56:51
7445,245,2,598,77,675,7363,2021-01-29 05:24:46
7446,411,2,429,55,484,7364,2021-01-29 07:26:39
7447,725,3,897,116,1013,7365,2021-01-29 03:42:35
7448,639,4,1246,161,1407,7366,2021-01-28 16:06:09
7449,837,5,1325,172,1497,7367,2021-01-28 21:20:48
7450,111,2,898,116,1014,7368,2021-01-29 04:13:04
7451,703,6,1106,143,1249,7369,2021-01-28 17:36:29
7452,456,3,688,89,777,7370,2021-01-28 17:28:22
7453,624,3,747,97,844,7371,2021-01-29 00:10:34
7454,160,2,648,84,732,7372,2021-01-29 06:14:57
7455,800,3,1197,155,1352,7373,2021-01-29 06:03:17
7456,63,3,727,94,821,7374,2021-01-29 01:40:35
7457,888,3,997,129,1126,7375,2021-01-29 02:27:34
7458,32,2,598,77,675,7376,2021-01-29 07:36:02
7459,322,6,1574,204,1778,7377,2021-01-28 11:52:07
7460,712,3,528,68,596,7378,2021-01-28 08:21:14
7461,452,3,658,85,743,7379,2021-01-28 07:23:59
7462,847,3,1247,162,1409,7380,2021-01-28 04:53:17
7463,117,3,528,68,596,7381,2021-01-28 23:44:29
7464,52,3,658,85,743,7382,2021-01-29 04:57:55
7465,642,3,1127,146,1273,7383,2021-01-29 04:42:57
7466,910,2,659,85,744,7384,2021-01-29 03:01:56
7467,469,3,597,77,674,7385,2021-01-28 18:20:02
7468,551,2,459,59,518,7386,2021-01-28 04:23:20
7469,620,2,848,110,958,7387,2021-01-27 18:37:32
7470,928,1,99,12,111,7388,2021-01-28 04:21:28
7471,394,5,1875,243,2118,7389,2021-01-28 02:24:22
7472,131,2,898,116,1014,7390,2021-01-28 01:02:39
7473,807,5,1226,159,1385,7391,2021-01-27 16:43:09
7474,635,3,747,97,844,7392,2021-01-28 02:51:30
7475,37,2,628,81,709,7393,2021-01-28 08:28:44
7476,923,2,648,84,732,7394,2021-01-28 09:50:07
7477,2,3,1027,133,1160,7395,2021-01-28 01:39:10
7478,4,2,598,77,675,7396,2021-01-28 10:38:44
7479,470,2,659,85,744,7397,2021-01-28 18:29:13
7480,711,2,798,103,901,7398,2021-01-28 16:27:34
7481,297,1,99,12,111,7399,2021-01-28 16:52:12
7482,770,3,888,115,1003,7400,2021-01-28 17:09:02
7483,991,2,598,77,675,7401,2021-01-28 05:32:14
7484,961,3,747,97,844,7402,2021-01-28 03:03:10
7485,454,3,1197,155,1352,7403,2021-01-28 05:59:31
7486,806,5,1795,233,2028,7404,2021-01-28 07:58:45
7487,87,5,887,115,1002,7405,2021-01-28 06:26:39
7488,680,2,548,71,619,7406,2021-01-29 17:43:56
7489,854,3,1027,133,1160,7407,2021-01-29 14:29:39
7490,948,5,1226,159,1385,7408,2021-01-29 09:50:25
7491,378,3,1047,136,1183,7409,2021-01-29 11:52:56
7492,655,4,1207,156,1363,7410,2021-01-29 10:17:07
7493,618,3,1047,136,1183,7411,2021-01-29 05:38:02
7494,643,3,888,115,1003,7412,2021-01-28 22:06:24
7495,557,2,548,71,619,7413,2021-01-28 16:06:15
7496,400,3,697,90,787,7414,2021-01-28 19:31:34
7497,905,3,808,105,913,7415,2021-01-28 23:56:35
7498,16,2,498,64,562,7416,2021-01-29 00:04:47
7499,245,3,597,77,674,7417,2021-01-29 05:06:35
7500,53,2,329,42,371,7418,2021-01-29 14:17:42
7501,834,3,658,85,743,7419,2021-01-29 19:00:50
7502,993,3,578,75,653,7420,2021-01-29 01:25:05
7503,601,3,1197,155,1352,7421,2021-01-29 06:00:37
7504,208,3,1047,136,1183,7422,2021-01-29 22:54:58
7505,533,3,1127,146,1273,7423,2021-01-29 18:43:19
7506,776,3,697,90,787,7424,2021-01-30 04:28:50
7507,969,2,1098,142,1240,7425,2021-01-29 19:15:02
7508,385,6,1805,234,2039,7426,2021-01-29 14:59:55
7509,429,3,747,97,844,7427,2021-01-29 18:28:55
7510,53,3,947,123,1070,7428,2021-01-29 20:41:31
7511,920,4,1257,163,1420,7429,2021-01-29 23:42:48
7512,291,2,459,59,518,7430,2021-01-29 13:28:24
7513,272,3,688,89,777,7431,2021-01-30 07:35:42
7514,249,2,798,103,901,7432,2021-01-30 01:48:21
7515,554,4,926,120,1046,7433,2021-01-29 12:52:48
7516,588,3,597,77,674,7434,2021-01-29 12:24:00
7517,113,3,697,90,787,7435,2021-01-28 08:05:42
7518,106,2,398,51,449,7436,2021-01-28 22:19:11
7519,326,3,597,77,674,7437,2021-01-29 00:56:33
7520,350,2,659,85,744,7438,2021-01-28 18:51:00
7521,903,2,1098,142,1240,7439,2021-01-28 19:33:56
7522,304,5,1206,156,1362,7440,2021-01-28 13:11:57
7523,366,3,758,98,856,7441,2021-01-28 13:56:47
7524,252,1,149,19,168,7442,2021-01-28 18:37:58
7525,766,2,659,85,744,7443,2021-01-28 17:41:06
7526,619,3,947,123,1070,7444,2021-01-28 17:59:13
7527,667,2,728,94,822,7445,2021-01-28 21:48:43
7528,215,1,149,19,168,7446,2021-01-28 22:34:58
7529,994,2,659,85,744,7447,2021-01-29 06:56:46
7530,358,3,1327,172,1499,7448,2021-01-29 08:52:53
7531,98,5,1345,174,1519,7449,2021-01-29 05:54:08
7532,923,5,1495,194,1689,7450,2021-01-28 16:40:52
7533,232,3,927,120,1047,7451,2021-01-28 23:02:14
7534,83,3,827,107,934,7452,2021-01-29 06:35:13
7535,407,4,1726,224,1950,7453,2021-01-28 19:22:16
7536,826,2,698,90,788,7454,2021-01-28 18:56:38
7537,146,3,558,72,630,7455,2021-01-29 02:12:46
7538,386,2,329,42,371,7456,2021-01-29 08:19:16
7539,67,4,1327,172,1499,7457,2021-01-29 08:20:43
7540,885,3,1127,146,1273,7458,2021-01-29 01:54:35
7541,294,2,548,71,619,7459,2021-01-29 03:35:44
7542,709,2,429,55,484,7460,2021-01-29 09:16:40
7543,260,3,997,129,1126,7461,2021-01-28 13:38:53
7544,897,3,747,97,844,7462,2021-01-28 09:32:54
7545,996,1,299,38,337,7463,2021-01-28 09:43:09
7546,332,3,808,105,913,7464,2021-01-28 05:46:54
7547,583,2,898,116,1014,7465,2021-01-29 01:57:09
7548,43,2,798,103,901,7466,2021-01-29 06:08:35
7549,43,2,798,103,901,7466,2021-01-29 06:08:35
7550,925,3,727,94,821,7467,2021-01-29 05:10:54
7551,562,3,727,94,821,7468,2021-01-29 04:30:35
7552,38,3,647,84,731,7469,2021-01-28 19:38:23
7553,988,1,229,29,258,7470,2021-01-28 05:17:19
7554,242,2,898,116,1014,7471,2021-01-27 19:13:35
7555,711,3,747,97,844,7472,2021-01-28 05:24:06
7556,425,3,597,77,674,7473,2021-01-28 03:28:48
7557,331,1,99,12,111,7474,2021-01-28 02:41:17
7558,615,3,1127,146,1273,7475,2021-01-27 19:10:28
7559,555,3,597,77,674,7476,2021-01-28 03:49:57
7560,209,2,459,59,518,7477,2021-01-28 11:03:35
7561,522,2,698,90,788,7478,2021-01-28 12:24:47
7562,625,2,728,94,822,7479,2021-01-28 02:56:17
7563,565,2,648,84,732,7480,2021-01-28 12:53:13
7564,642,2,598,77,675,7481,2021-01-28 21:08:11
7565,546,3,747,97,844,7482,2021-01-28 19:11:48
7566,314,3,697,90,787,7483,2021-01-28 17:47:34
7567,920,2,598,77,675,7484,2021-01-28 17:24:28
7568,768,2,1098,142,1240,7485,2021-01-28 05:35:18
7569,963,3,897,116,1013,7486,2021-01-28 04:08:38
7570,356,2,598,77,675,7487,2021-01-28 08:29:15
7571,627,3,478,62,540,7488,2021-01-28 08:38:21
7572,80,2,1098,142,1240,7489,2021-01-28 07:10:03
7573,75,6,1255,163,1418,7490,2021-01-29 17:53:03
7574,531,2,429,55,484,7491,2021-01-29 16:48:41
7575,752,3,658,85,743,7492,2021-01-29 11:31:53
7576,323,2,329,42,371,7493,2021-01-29 13:13:41
7577,811,3,528,68,596,7494,2021-01-29 10:49:07
7578,111,2,628,81,709,7495,2021-01-29 06:33:26
7579,470,3,827,107,934,7496,2021-01-29 00:15:12
7580,95,3,528,68,596,7497,2021-01-28 17:17:41
7581,837,3,608,79,687,7498,2021-01-28 19:41:40
7582,532,2,798,103,901,7499,2021-01-29 00:53:25
7583,59,2,898,116,1014,7500,2021-01-29 02:27:47
7584,188,3,747,97,844,7501,2021-01-29 05:57:13
7585,912,3,797,103,900,7502,2021-01-29 16:06:31
7586,410,3,1127,146,1273,7503,2021-01-29 19:42:14
7587,780,2,598,77,675,7504,2021-01-29 01:33:57
7588,502,3,1127,146,1273,7505,2021-01-29 07:17:18
7589,884,3,528,68,596,7506,2021-01-29 23:32:23
7590,389,3,897,116,1013,7507,2021-01-29 20:26:39
7591,340,3,688,89,777,7508,2021-01-30 05:47:55
7592,196,2,698,90,788,7509,2021-01-29 19:57:51
7593,495,3,578,75,653,7510,2021-01-29 17:15:51
7594,223,3,1027,133,1160,7511,2021-01-29 20:01:27
7595,411,2,448,58,506,7512,2021-01-29 21:42:20
7596,635,2,498,64,562,7513,2021-01-30 01:39:06
7597,366,2,498,64,562,7514,2021-01-29 15:30:40
7598,931,3,1127,146,1273,7515,2021-01-30 09:25:26
7599,116,3,747,97,844,7516,2021-01-30 04:32:06
7600,754,3,847,110,957,7517,2021-01-29 15:22:25
7601,360,3,727,94,821,7518,2021-01-29 14:42:08
7602,197,3,1127,146,1273,7519,2021-01-28 09:30:32
7603,759,3,827,107,934,7520,2021-01-28 23:50:46
7604,393,2,698,90,788,7521,2021-01-29 02:11:00
7605,427,3,597,77,674,7522,2021-01-28 19:35:57
7606,194,3,997,129,1126,7523,2021-01-28 19:36:21
7607,822,3,997,129,1126,7524,2021-01-28 15:32:22
7608,739,5,1775,230,2005,7525,2021-01-28 14:54:21
7609,913,3,1047,136,1183,7526,2021-01-28 20:46:03
7610,952,3,1127,146,1273,7527,2021-01-28 17:57:52
7611,240,3,608,79,687,7528,2021-01-28 19:38:24
7612,492,3,897,116,1013,7529,2021-01-29 00:35:03
7613,817,3,697,90,787,7530,2021-01-28 22:40:06
7614,144,5,2095,272,2367,7531,2021-01-29 07:47:12
7615,151,3,688,89,777,7532,2021-01-29 10:48:31
7616,194,3,658,85,743,7533,2021-01-29 05:58:02
7617,924,3,1327,172,1499,7534,2021-01-28 18:22:30
7618,945,5,1725,224,1949,7535,2021-01-29 00:41:41
7619,859,3,747,97,844,7536,2021-01-29 07:29:36
7620,859,3,747,97,844,7536,2021-01-29 07:29:36
7621,265,6,1524,198,1722,7537,2021-01-28 20:17:48
7622,768,2,898,116,1014,7538,2021-01-28 19:04:01
7623,616,5,1006,130,1136,7539,2021-01-29 03:16:34
7624,71,2,398,51,449,7540,2021-01-29 09:21:11
7625,674,3,758,98,856,7541,2021-01-29 08:39:02
7626,35,3,1027,133,1160,7542,2021-01-29 03:34:38
7627,660,2,798,103,901,7543,2021-01-29 05:41:55
7628,478,2,429,55,484,7544,2021-01-29 10:42:33
7629,164,3,1247,162,1409,7545,2021-01-28 15:35:36
7630,884,5,1426,185,1611,7546,2021-01-28 09:55:47
7631,772,3,947,123,1070,7547,2021-01-28 09:46:48
7632,80,3,558,72,630,7548,2021-01-28 06:48:55
7633,856,3,997,129,1126,7549,2021-01-29 03:30:14
7634,856,3,997,129,1126,7549,2021-01-29 03:30:14
7635,541,3,808,105,913,7550,2021-01-29 08:26:43
7636,995,3,997,129,1126,7551,2021-01-29 07:34:59
7637,176,3,528,68,596,7552,2021-01-29 06:43:58
7638,40,3,827,107,934,7553,2021-01-29 06:02:08
7639,423,3,808,105,913,7554,2021-01-28 20:15:14
7640,17,3,827,107,934,7555,2021-01-28 06:53:37
7641,192,3,997,129,1126,7556,2021-01-27 20:30:07
7642,358,2,898,116,1014,7557,2021-01-28 06:06:16
7643,136,5,1186,154,1340,7558,2021-01-28 06:01:06
7644,834,3,808,105,913,7559,2021-01-28 04:21:48
7645,881,3,578,75,653,7560,2021-01-27 19:47:38
7646,786,2,698,90,788,7561,2021-01-28 04:17:43
7647,749,2,659,85,744,7562,2021-01-28 13:44:45
7648,483,6,1255,163,1418,7563,2021-01-28 13:04:17
7649,161,2,598,77,675,7564,2021-01-28 03:11:36
7650,623,6,1155,150,1305,7565,2021-01-28 14:01:46
7651,990,3,927,120,1047,7566,2021-01-28 22:27:25
7652,950,3,947,123,1070,7567,2021-01-28 21:50:09
7653,918,3,747,97,844,7568,2021-01-28 17:49:06
7654,153,3,428,55,483,7569,2021-01-28 19:34:09
7655,453,5,1356,176,1532,7570,2021-01-28 07:14:09
7656,975,2,748,97,845,7571,2021-01-28 05:06:55
7657,216,3,758,98,856,7572,2021-01-28 09:25:30
7658,727,3,697,90,787,7573,2021-01-28 10:23:15
7659,154,3,997,129,1126,7574,2021-01-28 08:03:02
7660,241,2,659,85,744,7575,2021-01-29 18:50:59
7661,213,3,697,90,787,7576,2021-01-29 19:22:07
7662,386,2,698,90,788,7577,2021-01-29 13:31:47
7663,317,3,808,105,913,7578,2021-01-29 13:22:15
7664,582,3,1027,133,1160,7579,2021-01-29 11:12:00
7665,170,3,688,89,777,7580,2021-01-29 06:40:16
7666,629,3,647,84,731,7581,2021-01-29 01:41:19
7667,17,5,1506,195,1701,7582,2021-01-28 17:27:13
7668,373,3,1047,136,1183,7583,2021-01-28 22:10:22
7669,860,2,398,51,449,7584,2021-01-29 02:36:30
7670,496,2,898,116,1014,7585,2021-01-29 03:34:38
7671,106,2,329,42,371,7586,2021-01-29 08:25:33
7672,964,2,329,42,371,7587,2021-01-29 17:56:22
7673,762,3,597,77,674,7588,2021-01-29 21:00:52
7674,701,1,299,38,337,7589,2021-01-29 03:56:16
7675,767,3,997,129,1126,7590,2021-01-29 08:51:49
7676,876,3,847,110,957,7591,2021-01-30 00:38:29
7677,481,2,548,71,619,7592,2021-01-29 21:33:01
7678,324,2,598,77,675,7593,2021-01-30 06:56:33
7679,263,2,898,116,1014,7594,2021-01-29 22:14:13
7680,41,2,459,59,518,7595,2021-01-29 18:30:33
7681,491,3,727,94,821,7596,2021-01-29 21:44:49
7682,555,3,558,72,630,7597,2021-01-30 00:28:11
7683,860,3,1127,146,1273,7598,2021-01-30 03:10:36
7684,142,3,1127,146,1273,7599,2021-01-29 15:47:49
7685,858,3,647,84,731,7600,2021-01-30 09:28:36
7686,783,3,808,105,913,7601,2021-01-30 06:20:36
7687,613,2,429,55,484,7602,2021-01-29 15:56:27
7688,960,3,847,110,957,7603,2021-01-29 14:54:53
7689,435,3,578,75,653,7604,2021-01-28 10:50:26
7690,496,5,1725,224,1949,7605,2021-01-29 01:31:45
7691,319,2,798,103,901,7606,2021-01-29 03:46:56
7692,663,3,827,107,934,7607,2021-01-28 21:59:52
7693,656,3,1247,162,1409,7608,2021-01-28 20:26:38
7694,345,3,597,77,674,7609,2021-01-28 17:47:58
7695,233,5,1706,221,1927,7610,2021-01-28 16:42:11
7696,392,3,697,90,787,7611,2021-01-28 20:52:36
7697,721,3,827,107,934,7612,2021-01-28 19:42:02
7698,69,2,429,55,484,7613,2021-01-28 21:40:59
7699,933,3,747,97,844,7614,2021-01-29 02:01:36
7700,74,3,997,129,1126,7615,2021-01-28 23:25:13
7701,868,3,797,103,900,7616,2021-01-29 10:25:22
7702,852,1,399,51,450,7617,2021-01-29 12:38:51
7703,547,2,698,90,788,7618,2021-01-29 06:47:29
7704,612,3,808,105,913,7619,2021-01-28 20:35:56
7705,570,3,808,105,913,7620,2021-01-29 01:03:43
7706,106,3,808,105,913,7621,2021-01-29 09:33:03
7707,839,2,748,97,845,7622,2021-01-29 10:08:30
7708,342,3,558,72,630,7623,2021-01-28 23:02:05
7709,966,3,827,107,934,7624,2021-01-28 20:22:00
7710,946,2,548,71,619,7625,2021-01-29 05:16:44
7711,160,3,808,105,913,7626,2021-01-29 09:22:04
7712,945,3,758,98,856,7627,2021-01-29 09:35:01
7713,837,3,1127,146,1273,7628,2021-01-29 04:18:02
7714,808,3,697,90,787,7629,2021-01-29 05:45:59
7715,147,3,997,129,1126,7630,2021-01-29 11:52:45
7716,888,2,598,77,675,7631,2021-01-28 16:56:39
7717,465,2,598,77,675,7632,2021-01-28 12:24:16
7718,752,3,797,103,900,7633,2021-01-28 10:01:38
7719,576,4,1287,167,1454,7634,2021-01-28 09:24:43
7720,159,3,997,129,1126,7635,2021-01-29 05:30:21
7721,150,3,997,129,1126,7636,2021-01-29 04:37:40
7722,673,3,997,129,1126,7637,2021-01-29 11:09:23
7723,957,2,598,77,675,7638,2021-01-29 08:08:43
7724,217,3,697,90,787,7639,2021-01-29 07:39:16
7725,328,2,798,103,901,7640,2021-01-29 07:44:09
7726,213,4,1326,172,1498,7641,2021-01-28 20:42:07
7727,299,3,478,62,540,7642,2021-01-28 07:18:55
7728,785,3,658,85,743,7643,2021-01-27 23:15:41
7729,975,3,827,107,934,7644,2021-01-28 06:09:58
7730,655,3,1197,155,1352,7645,2021-01-28 06:36:03
7731,103,2,1098,142,1240,7646,2021-01-28 06:47:19
7732,191,5,1995,259,2254,7647,2021-01-27 20:47:16
7733,543,2,898,116,1014,7648,2021-01-28 04:56:49
7734,170,1,299,38,337,7649,2021-01-28 16:17:17
7735,526,2,659,85,744,7650,2021-01-28 14:23:50
7736,372,4,1157,150,1307,7651,2021-01-28 03:16:02
7737,961,3,897,116,1013,7652,2021-01-28 16:34:48
7738,896,2,1098,142,1240,7653,2021-01-28 23:08:12
7739,810,2,898,116,1014,7654,2021-01-28 22:51:57
7740,712,3,1047,136,1183,7655,2021-01-28 19:30:11
7741,125,3,428,55,483,7656,2021-01-28 20:45:59
7742,772,3,1197,155,1352,7657,2021-01-28 09:09:08
7743,771,3,658,85,743,7658,2021-01-28 07:14:38
7744,188,3,808,105,913,7659,2021-01-28 10:03:12
7745,110,3,997,129,1126,7660,2021-01-28 12:44:24
7746,272,3,1247,162,1409,7661,2021-01-28 10:48:51
7747,561,2,898,116,1014,7662,2021-01-29 21:25:34
7748,522,3,697,90,787,7663,2021-01-29 19:39:26
7749,93,1,599,77,676,7664,2021-01-29 13:58:37
7750,137,1,499,64,563,7665,2021-01-29 15:56:15
7751,297,3,997,129,1126,7666,2021-01-29 13:51:49
7752,358,2,628,81,709,7667,2021-01-29 06:44:48
7753,849,3,997,129,1126,7668,2021-01-29 02:51:31
7754,515,3,658,85,743,7669,2021-01-28 18:10:05
7755,392,2,898,116,1014,7670,2021-01-29 00:34:06
7756,487,3,827,107,934,7671,2021-01-29 02:49:04
7757,695,3,808,105,913,7672,2021-01-29 05:23:34
7758,383,3,997,129,1126,7673,2021-01-29 11:02:27
7759,838,2,698,90,788,7674,2021-01-29 19:08:42
7760,851,2,598,77,675,7675,2021-01-29 21:37:44
7761,591,2,429,55,484,7676,2021-01-29 05:25:30
7762,77,2,398,51,449,7677,2021-01-29 10:48:12
7763,257,2,659,85,744,7678,2021-01-30 01:00:15
7764,839,2,898,116,1014,7679,2021-01-29 23:12:27
7765,431,5,1795,233,2028,7680,2021-01-30 09:14:03
7766,261,1,499,64,563,7681,2021-01-30 00:19:42
7767,780,4,1096,142,1238,7682,2021-01-29 18:36:11
7768,437,3,647,84,731,7683,2021-01-29 22:55:58
7769,292,3,1327,172,1499,7684,2021-01-30 01:23:47
7770,612,2,528,68,596,7685,2021-01-30 04:17:32
7771,174,3,758,98,856,7686,2021-01-29 18:21:37
7772,75,3,647,84,731,7687,2021-01-30 10:54:52
7773,867,3,558,72,630,7688,2021-01-30 08:44:34
7774,119,3,697,90,787,7689,2021-01-29 17:07:32
7775,303,3,927,120,1047,7690,2021-01-29 15:01:35
7776,230,5,1425,185,1610,7691,2021-01-28 13:10:17
7777,585,2,798,103,901,7692,2021-01-29 02:07:26
7778,294,2,898,116,1014,7693,2021-01-29 04:25:06
7779,273,6,1894,246,2140,7694,2021-01-29 00:45:55
7780,311,5,1575,204,1779,7695,2021-01-28 22:26:09
7781,56,3,1047,136,1183,7696,2021-01-28 19:39:24
7782,60,3,597,77,674,7697,2021-01-28 18:34:06
7783,350,2,459,59,518,7698,2021-01-28 21:27:18
7784,159,3,808,105,913,7699,2021-01-28 22:13:08
7785,283,2,898,116,1014,7700,2021-01-28 21:56:41
7786,520,2,698,90,788,7701,2021-01-29 04:29:13
7787,26,2,598,77,675,7702,2021-01-29 01:27:56
7788,474,2,598,77,675,7703,2021-01-29 10:41:49
7789,313,3,697,90,787,7704,2021-01-29 14:43:19
7790,742,2,898,116,1014,7705,2021-01-29 07:57:16
7791,555,3,997,129,1126,7706,2021-01-28 22:30:37
7792,303,2,1098,142,1240,7707,2021-01-29 03:26:15
7793,553,3,797,103,900,7708,2021-01-29 11:51:17
7794,200,2,798,103,901,7709,2021-01-29 11:51:02
7795,698,3,688,89,777,7710,2021-01-29 01:00:12
7796,784,3,827,107,934,7711,2021-01-28 22:11:51
7797,415,3,647,84,731,7712,2021-01-29 07:07:22
7798,587,3,847,110,957,7713,2021-01-29 09:56:36
7799,404,6,1525,198,1723,7714,2021-01-29 12:01:45
7800,621,3,747,97,844,7715,2021-01-29 05:47:35
7801,960,3,897,116,1013,7716,2021-01-29 06:41:51
7802,788,3,827,107,934,7717,2021-01-29 14:27:38
7803,368,3,997,129,1126,7718,2021-01-28 19:32:00
7804,957,2,728,94,822,7719,2021-01-28 12:47:13
7805,848,2,459,59,518,7720,2021-01-28 11:03:17
7806,918,5,1725,224,1949,7721,2021-01-28 09:53:36
7807,694,5,1556,202,1758,7722,2021-01-29 08:01:17
7808,580,3,1327,172,1499,7723,2021-01-29 06:23:55
7809,103,3,658,85,743,7724,2021-01-29 11:34:49
7810,549,2,598,77,675,7725,2021-01-29 10:11:30
7811,599,3,758,98,856,7726,2021-01-29 10:06:08
7812,386,3,597,77,674,7727,2021-01-29 07:47:07
7813,400,3,428,55,483,7728,2021-01-28 21:00:04
7814,804,2,598,77,675,7729,2021-01-28 08:20:25
7815,881,3,808,105,913,7730,2021-01-28 01:51:08
7816,400,3,1027,133,1160,7731,2021-01-28 08:10:26
7817,965,3,797,103,900,7732,2021-01-28 07:24:10
7818,722,5,1076,139,1215,7733,2021-01-28 09:19:40
7819,420,3,927,120,1047,7734,2021-01-27 21:53:23
7820,712,5,976,126,1102,7735,2021-01-28 05:56:17
7821,497,2,1098,142,1240,7736,2021-01-28 18:42:58
7822,89,3,897,116,1013,7737,2021-01-28 15:59:59
7823,738,2,898,116,1014,7738,2021-01-28 04:13:51
7824,80,2,659,85,744,7739,2021-01-28 17:10:35
7825,335,3,558,72,630,7740,2021-01-29 00:13:18
7826,453,5,2425,315,2740,7741,2021-01-28 23:59:40
7827,980,3,1047,136,1183,7742,2021-01-28 20:18:59
7828,431,2,459,59,518,7743,2021-01-28 21:07:20
7829,308,3,847,110,957,7744,2021-01-28 10:38:05
7830,977,3,578,75,653,7745,2021-01-28 07:59:14
7831,952,3,827,107,934,7746,2021-01-28 12:43:56
7832,534,2,528,68,596,7747,2021-01-28 13:09:19
7833,488,2,1098,142,1240,7748,2021-01-28 11:57:04
7834,146,4,1126,146,1272,7749,2021-01-29 22:29:48
7835,739,3,758,98,856,7750,2021-01-29 21:57:55
7836,75,3,1127,146,1273,7751,2021-01-29 16:39:16
7837,323,2,498,64,562,7752,2021-01-29 16:50:58
7838,74,3,747,97,844,7753,2021-01-29 16:29:48
7839,563,2,459,59,518,7754,2021-01-29 08:49:00
7840,51,2,598,77,675,7755,2021-01-29 04:36:05
7841,281,2,598,77,675,7756,2021-01-28 19:19:43
7842,601,6,1924,250,2174,7757,2021-01-29 02:48:56
7843,996,2,798,103,901,7758,2021-01-29 05:10:47
7844,328,2,598,77,675,7759,2021-01-29 06:51:58
7845,287,6,1955,254,2209,7760,2021-01-29 13:28:45
7846,840,3,827,107,934,7761,2021-01-29 19:44:23
7847,903,2,659,85,744,7762,2021-01-29 23:43:13
7848,552,3,997,129,1126,7763,2021-01-29 06:18:07
7849,684,1,699,90,789,7764,2021-01-29 11:51:48
7850,996,3,947,123,1070,7765,2021-01-30 01:43:52
7851,187,3,1247,162,1409,7766,2021-01-29 23:51:18
7852,91,2,898,116,1014,7767,2021-01-30 10:28:49
7853,19,3,558,72,630,7768,2021-01-30 01:42:53
7854,640,5,1456,189,1645,7769,2021-01-29 21:01:51
7855,122,3,747,97,844,7770,2021-01-30 00:40:32
7856,316,3,808,105,913,7771,2021-01-30 03:58:55
7857,305,3,888,115,1003,7772,2021-01-30 04:41:11
7858,191,2,1098,142,1240,7773,2021-01-29 19:44:15
7859,145,3,827,107,934,7774,2021-01-30 13:16:09
7860,117,5,1625,211,1836,7775,2021-01-30 09:30:07
7861,995,3,1197,155,1352,7776,2021-01-29 18:55:06
7862,742,5,1626,211,1837,7777,2021-01-29 15:52:24
7863,226,3,608,79,687,7778,2021-01-28 15:20:59
7864,381,3,947,123,1070,7779,2021-01-29 02:29:29
7865,997,3,1127,146,1273,7780,2021-01-29 05:01:22
7866,376,2,429,55,484,7781,2021-01-29 01:56:41
7867,431,3,478,62,540,7782,2021-01-28 23:02:38
7868,221,2,598,77,675,7783,2021-01-28 20:57:48
7869,849,3,727,94,821,7784,2021-01-28 18:57:44
7870,402,3,1047,136,1183,7785,2021-01-28 23:20:46
7871,576,5,1326,172,1498,7786,2021-01-28 23:52:18
7872,962,4,956,124,1080,7787,2021-01-29 00:12:42
7873,159,4,907,117,1024,7788,2021-01-29 05:11:26
7874,384,3,1047,136,1183,7789,2021-01-29 02:53:51
7875,819,5,1256,163,1419,7790,2021-01-29 10:48:50
7876,726,3,1247,162,1409,7791,2021-01-29 16:46:59
7877,778,5,1106,143,1249,7792,2021-01-29 08:50:29
7878,448,2,848,110,958,7793,2021-01-28 23:27:20
7879,605,3,688,89,777,7794,2021-01-29 05:54:20
7880,191,2,1098,142,1240,7795,2021-01-29 12:21:45
7881,372,3,597,77,674,7796,2021-01-29 14:12:09
7882,7,2,459,59,518,7797,2021-01-29 03:08:16
7883,475,2,498,64,562,7798,2021-01-28 23:04:36
7884,670,2,898,116,1014,7799,2021-01-29 07:36:02
7885,908,3,428,55,483,7800,2021-01-29 11:51:35
7886,690,6,1854,241,2095,7801,2021-01-29 13:46:16
7887,627,3,478,62,540,7802,2021-01-29 05:56:25
7888,997,3,997,129,1126,7803,2021-01-29 09:21:41
7889,767,1,699,90,789,7804,2021-01-29 15:18:21
7890,642,2,798,103,901,7805,2021-01-28 20:02:43
7891,477,3,1127,146,1273,7806,2021-01-28 14:58:04
7892,388,3,558,72,630,7807,2021-01-28 12:34:55
7893,597,3,428,55,483,7808,2021-01-28 10:21:43
7894,710,2,329,42,371,7809,2021-01-29 09:14:30
7895,411,2,698,90,788,7810,2021-01-29 08:34:09
7896,696,2,698,90,788,7811,2021-01-29 12:53:08
7897,578,2,648,84,732,7812,2021-01-29 12:03:13
7898,36,2,698,90,788,7813,2021-01-29 11:23:47
7899,664,2,498,64,562,7814,2021-01-29 09:30:17
7900,44,5,1475,191,1666,7815,2021-01-28 21:48:47
7901,749,3,1027,133,1160,7816,2021-01-28 09:31:50
7902,673,4,837,108,945,7817,2021-01-28 03:22:41
7903,67,1,99,12,111,7818,2021-01-28 10:27:16
7904,235,2,798,103,901,7819,2021-01-28 09:11:31
7905,373,2,898,116,1014,7820,2021-01-28 10:10:38
7906,373,2,628,81,709,7821,2021-01-27 23:09:35
7907,553,3,758,98,856,7822,2021-01-28 06:27:35
7908,324,3,647,84,731,7823,2021-01-28 20:58:52
7909,406,5,976,126,1102,7824,2021-01-28 17:56:02
7910,268,2,598,77,675,7825,2021-01-28 06:14:07
7911,462,2,648,84,732,7826,2021-01-28 19:01:29
7912,573,3,608,79,687,7827,2021-01-29 02:44:56
7913,691,6,2194,285,2479,7828,2021-01-29 02:27:29
7914,703,5,1606,208,1814,7829,2021-01-28 20:20:30
7915,371,2,898,116,1014,7830,2021-01-28 21:26:42
7916,910,2,459,59,518,7831,2021-01-28 12:17:03
7917,625,2,429,55,484,7832,2021-01-28 08:59:54
7918,453,3,608,79,687,7833,2021-01-28 15:16:56
7919,512,3,608,79,687,7834,2021-01-28 13:17:57
7920,224,2,798,103,901,7835,2021-01-28 13:03:34
7921,524,3,528,68,596,7836,2021-01-30 00:12:06
7922,890,1,229,29,258,7837,2021-01-29 23:51:05
7923,125,3,528,68,596,7838,2021-01-29 18:44:03
7924,268,3,528,68,596,7839,2021-01-29 17:37:14
7925,56,1,299,38,337,7840,2021-01-29 19:01:50
7926,26,3,658,85,743,7841,2021-01-29 09:33:28
7927,279,3,747,97,844,7842,2021-01-29 05:51:41
7928,572,5,1695,220,1915,7843,2021-01-28 22:01:17
7929,608,1,399,51,450,7844,2021-01-29 04:42:00
7930,705,2,429,55,484,7845,2021-01-29 06:35:23
7931,74,2,598,77,675,7846,2021-01-29 09:38:30
7932,926,2,659,85,744,7847,2021-01-29 14:03:07
7933,298,3,597,77,674,7848,2021-01-29 20:22:02
7934,926,3,758,98,856,7849,2021-01-30 00:53:17
7935,296,2,498,64,562,7850,2021-01-29 08:04:02
7936,921,3,597,77,674,7851,2021-01-29 12:49:38
7937,241,2,498,64,562,7852,2021-01-30 04:02:10
7938,387,3,947,123,1070,7853,2021-01-30 00:58:42
7939,929,3,827,107,934,7854,2021-01-30 12:14:42
7940,97,2,628,81,709,7855,2021-01-30 04:14:01
7941,343,5,1725,224,1949,7856,2021-01-29 22:29:39
7942,363,2,598,77,675,7857,2021-01-30 02:18:15
7943,835,4,1646,213,1859,7858,2021-01-30 04:21:40
7944,20,3,747,97,844,7859,2021-01-30 06:50:42
7945,440,3,528,68,596,7860,2021-01-29 21:56:54
7946,631,3,997,129,1126,7861,2021-01-30 14:33:40
7947,822,5,1026,133,1159,7862,2021-01-30 11:32:48
7948,151,3,478,62,540,7863,2021-01-29 20:18:53
7949,482,2,698,90,788,7864,2021-01-29 18:24:50
7950,341,2,898,116,1014,7865,2021-01-28 16:12:27
7951,260,3,1047,136,1183,7866,2021-01-29 04:02:42
7952,52,3,997,129,1126,7867,2021-01-29 07:13:03
7953,785,2,798,103,901,7868,2021-01-29 04:41:10
7954,184,2,459,59,518,7869,2021-01-28 23:06:11
7955,493,3,827,107,934,7870,2021-01-28 21:18:11
7956,414,3,997,129,1126,7871,2021-01-28 21:37:34
7957,549,2,659,85,744,7872,2021-01-29 01:18:21
7958,922,2,429,55,484,7873,2021-01-29 00:33:32
7959,667,3,478,62,540,7874,2021-01-29 00:43:10
7960,683,3,727,94,821,7875,2021-01-29 05:48:47
7961,166,3,947,123,1070,7876,2021-01-29 05:33:28
7962,855,3,1197,155,1352,7877,2021-01-29 12:27:21
7963,985,3,727,94,821,7878,2021-01-29 17:07:48
7964,281,5,1456,189,1645,7879,2021-01-29 09:40:26
7965,456,2,698,90,788,7880,2021-01-29 00:11:54
7966,753,3,808,105,913,7881,2021-01-29 06:21:47
7967,957,3,758,98,856,7882,2021-01-29 14:18:17
7968,564,3,827,107,934,7883,2021-01-29 14:52:05
7969,278,3,997,129,1126,7884,2021-01-29 05:41:58
7970,508,1,299,38,337,7885,2021-01-29 00:26:24
7971,872,2,329,42,371,7886,2021-01-29 09:07:50
7972,345,1,149,19,168,7887,2021-01-29 14:21:59
7973,592,3,747,97,844,7888,2021-01-29 14:01:36
7974,952,3,727,94,821,7889,2021-01-29 08:34:21
7975,1,2,498,64,562,7890,2021-01-29 09:59:45
7976,234,2,498,64,562,7891,2021-01-29 16:42:33
7977,882,3,697,90,787,7892,2021-01-28 22:38:45
7978,188,2,329,42,371,7893,2021-01-28 15:30:39
7979,314,3,697,90,787,7894,2021-01-28 13:16:52
7980,500,3,758,98,856,7895,2021-01-28 12:42:56
7981,642,3,697,90,787,7896,2021-01-29 09:38:02
7982,230,5,1156,150,1306,7897,2021-01-29 09:57:11
7983,867,2,598,77,675,7898,2021-01-29 15:33:22
7984,494,2,798,103,901,7899,2021-01-29 12:49:51
7985,13,3,997,129,1126,7900,2021-01-29 12:30:27
7986,134,3,558,72,630,7901,2021-01-29 11:35:17
7987,570,3,428,55,483,7902,2021-01-28 23:10:24
7988,459,1,299,38,337,7903,2021-01-28 10:46:42
7989,879,3,897,116,1013,7904,2021-01-28 05:59:30
7990,703,3,827,107,934,7905,2021-01-28 13:04:35
7991,852,3,1047,136,1183,7906,2021-01-28 09:29:10
7992,978,3,747,97,844,7907,2021-01-28 12:09:04
7993,571,2,798,103,901,7908,2021-01-28 01:27:56
7994,985,3,847,110,957,7909,2021-01-28 07:03:17
7995,689,3,1127,146,1273,7910,2021-01-28 22:26:11
7996,326,3,827,107,934,7911,2021-01-28 18:11:36
7997,892,2,659,85,744,7912,2021-01-28 08:17:06
7998,362,6,1844,239,2083,7913,2021-01-28 20:14:32
7999,931,3,827,107,934,7914,2021-01-29 04:43:15
8000,449,2,898,116,1014,7915,2021-01-29 04:54:24
8001,796,2,498,64,562,7916,2021-01-28 20:51:07
8002,162,3,727,94,821,7917,2021-01-28 22:57:16
8003,126,5,887,115,1002,7918,2021-01-28 13:11:46
8004,559,2,598,77,675,7919,2021-01-28 09:09:32
8005,25,3,558,72,630,7920,2021-01-28 16:39:43
8006,585,3,827,107,934,7921,2021-01-28 15:03:25
8007,86,2,498,64,562,7922,2021-01-28 15:28:37
8008,400,2,498,64,562,7923,2021-01-30 00:50:18
8009,278,3,1327,172,1499,7924,2021-01-30 02:22:19
8010,923,2,498,64,562,7925,2021-01-29 19:31:03
8011,612,2,898,116,1014,7926,2021-01-29 19:49:20
8012,339,6,1225,159,1384,7927,2021-01-29 20:49:37
8013,457,3,827,107,934,7928,2021-01-29 11:44:29
8014,238,3,1127,146,1273,7929,2021-01-29 06:26:23
8015,782,3,827,107,934,7930,2021-01-28 23:49:15
8016,138,3,578,75,653,7931,2021-01-29 06:05:08
8017,8,5,1356,176,1532,7932,2021-01-29 07:29:46
8018,465,4,946,122,1068,7933,2021-01-29 10:06:49
8019,7,1,699,90,789,7934,2021-01-29 15:33:10
8020,61,3,747,97,844,7935,2021-01-29 20:28:46
8021,657,3,1047,136,1183,7936,2021-01-30 02:56:26
8022,769,3,578,75,653,7937,2021-01-29 10:32:02
8023,919,3,897,116,1013,7938,2021-01-29 13:40:29
8024,774,5,1825,237,2062,7939,2021-01-30 05:24:00
8025,317,3,1197,155,1352,7940,2021-01-30 01:25:53
8026,730,2,459,59,518,7941,2021-01-30 14:29:38
8027,970,3,808,105,913,7942,2021-01-30 05:37:23
8028,237,3,888,115,1003,7943,2021-01-30 00:32:59
8029,706,2,598,77,675,7944,2021-01-30 04:32:02
8030,632,2,1098,142,1240,7945,2021-01-30 05:18:19
8031,435,3,997,129,1126,7946,2021-01-30 06:52:50
8032,110,3,658,85,743,7947,2021-01-29 22:44:13
8033,558,3,947,123,1070,7948,2021-01-30 15:10:21
8034,337,3,1197,155,1352,7949,2021-01-30 12:46:16
8035,195,5,1775,230,2005,7950,2021-01-29 22:32:54
8036,105,3,758,98,856,7951,2021-01-29 20:27:10
8037,264,3,997,129,1126,7952,2021-01-28 16:28:34
8038,787,2,498,64,562,7953,2021-01-29 04:14:21
8039,238,2,659,85,744,7954,2021-01-29 09:50:11
8040,57,3,997,129,1126,7955,2021-01-29 06:03:46
8041,66,5,1126,146,1272,7956,2021-01-28 23:34:36
8042,104,2,598,77,675,7957,2021-01-28 23:07:48
8043,825,3,1047,136,1183,7958,2021-01-28 22:07:18
8044,695,3,897,116,1013,7959,2021-01-29 03:21:09
8045,123,2,459,59,518,7960,2021-01-29 02:19:56
8046,235,2,798,103,901,7961,2021-01-29 01:49:35
8047,50,2,329,42,371,7962,2021-01-29 07:26:22
8048,873,3,428,55,483,7963,2021-01-29 08:00:11
8049,267,5,926,120,1046,7964,2021-01-29 14:14:08
8050,858,1,399,51,450,7965,2021-01-29 17:40:40
8051,487,3,1027,133,1160,7966,2021-01-29 11:03:32
8052,906,2,598,77,675,7967,2021-01-29 02:40:20
8053,842,2,429,55,484,7968,2021-01-29 08:16:52
8054,221,5,1725,224,1949,7969,2021-01-29 15:36:05
8055,808,3,1027,133,1160,7970,2021-01-29 17:19:46
8056,486,1,229,29,258,7971,2021-01-29 07:03:28
8057,145,2,429,55,484,7972,2021-01-29 02:33:03
8058,309,2,698,90,788,7973,2021-01-29 10:07:16
8059,479,3,697,90,787,7974,2021-01-29 16:04:53
8060,772,2,598,77,675,7975,2021-01-29 14:19:57
8061,436,3,747,97,844,7976,2021-01-29 08:57:46
8062,902,3,428,55,483,7977,2021-01-29 12:19:21
8063,895,2,459,59,518,7978,2021-01-29 19:07:25
8064,823,1,399,51,450,7979,2021-01-29 00:49:21
8065,315,3,797,103,900,7980,2021-01-28 17:15:29
8066,333,3,927,120,1047,7981,2021-01-28 15:07:31
8067,942,3,478,62,540,7982,2021-01-28 13:11:42
8068,182,3,747,97,844,7983,2021-01-29 11:05:20
8069,162,2,528,68,596,7984,2021-01-29 11:10:36
8070,57,3,747,97,844,7985,2021-01-29 16:14:48
8071,126,3,478,62,540,7986,2021-01-29 14:33:47
8072,1000,3,688,89,777,7987,2021-01-29 13:44:32
8073,76,3,688,89,777,7988,2021-01-29 13:31:19
8074,86,1,229,29,258,7989,2021-01-28 23:56:31
8075,528,6,1355,176,1531,7990,2021-01-28 12:13:44
8076,27,3,997,129,1126,7991,2021-01-28 07:00:08
8077,827,3,558,72,630,7992,2021-01-28 15:01:12
8078,218,3,558,72,630,7993,2021-01-28 10:03:22
8079,432,3,478,62,540,7994,2021-01-28 13:16:52
8080,617,1,399,51,450,7995,2021-01-28 03:26:38
8081,281,3,888,115,1003,7996,2021-01-28 08:37:42
8082,809,3,727,94,821,7997,2021-01-29 01:07:44
8083,568,2,798,103,901,7998,2021-01-28 18:29:05
8084,215,2,698,90,788,7999,2021-01-28 10:21:57
8085,215,2,698,90,788,7999,2021-01-28 10:21:57
8086,913,3,528,68,596,8000,2021-01-28 21:38:28
8087,780,3,727,94,821,8001,2021-01-29 05:31:36
8088,804,3,478,62,540,8002,2021-01-29 06:48:12
8089,577,5,1945,252,2197,8003,2021-01-28 20:56:21
8090,68,3,608,79,687,8004,2021-01-29 00:06:50
8091,586,3,697,90,787,8005,2021-01-28 15:01:48
8092,627,2,1098,142,1240,8006,2021-01-28 09:56:15
8093,514,3,1127,146,1273,8007,2021-01-28 17:04:33
8094,462,2,329,42,371,8008,2021-01-28 17:20:51
8095,467,3,658,85,743,8009,2021-01-28 17:06:04
8096,527,3,1027,133,1160,8010,2021-01-30 03:30:05
8097,255,2,459,59,518,8011,2021-01-30 04:04:48
8098,671,3,747,97,844,8012,2021-01-29 21:57:04
8099,902,2,698,90,788,8013,2021-01-29 20:57:57
8100,942,2,598,77,675,8014,2021-01-29 23:20:49
8101,721,3,597,77,674,8015,2021-01-29 12:18:52
8102,590,5,1156,150,1306,8016,2021-01-29 08:26:47
8103,925,5,1026,133,1159,8017,2021-01-29 01:01:08
8104,520,3,727,94,821,8018,2021-01-29 07:55:25
8105,717,3,747,97,844,8019,2021-01-29 08:32:04
8106,959,3,1047,136,1183,8020,2021-01-29 10:43:59
8107,819,2,329,42,371,8021,2021-01-29 16:05:32
8108,451,2,429,55,484,8022,2021-01-29 23:11:43
8109,958,5,1356,176,1532,8023,2021-01-30 04:39:21
8110,407,3,747,97,844,8024,2021-01-29 13:01:02
8111,428,3,947,123,1070,8025,2021-01-29 14:26:54
8112,17,2,728,94,822,8026,2021-01-30 05:56:25
8113,414,2,448,58,506,8027,2021-01-30 03:21:53
8114,211,2,698,90,788,8028,2021-01-30 14:41:24
8115,932,2,498,64,562,8029,2021-01-30 07:08:02
8116,91,3,927,120,1047,8030,2021-01-30 01:11:45
8117,313,6,2024,263,2287,8031,2021-01-30 06:38:23
8118,97,2,498,64,562,8032,2021-01-30 07:22:24
8119,727,4,977,127,1104,8033,2021-01-30 07:26:53
8120,602,2,628,81,709,8034,2021-01-29 22:53:04
8121,950,2,598,77,675,8035,2021-01-30 16:16:33
8122,639,3,727,94,821,8036,2021-01-30 14:36:56
8123,376,1,499,64,563,8037,2021-01-30 00:17:40
8124,32,3,997,129,1126,8038,2021-01-29 20:48:59
8125,728,2,1098,142,1240,8039,2021-01-28 17:58:03
8126,17,5,1706,221,1927,8040,2021-01-29 07:00:56
8127,944,2,1098,142,1240,8041,2021-01-29 11:55:07
8128,682,5,1525,198,1723,8042,2021-01-29 08:40:07
8129,521,3,597,77,674,8043,2021-01-28 23:58:57
8130,631,2,448,58,506,8044,2021-01-28 23:17:54
8131,410,5,1906,247,2153,8045,2021-01-28 22:12:14
8132,205,2,598,77,675,8046,2021-01-29 04:07:34
8133,24,2,429,55,484,8047,2021-01-29 04:21:40
8134,352,3,578,75,653,8048,2021-01-29 02:07:35
8135,968,2,1098,142,1240,8049,2021-01-29 10:08:47
8136,177,2,659,85,744,8050,2021-01-29 10:44:51
8137,370,2,598,77,675,8051,2021-01-29 14:24:56
8138,1000,2,329,42,371,8052,2021-01-29 18:21:35
8139,280,3,558,72,630,8053,2021-01-29 11:43:01
8140,683,3,597,77,674,8054,2021-01-29 03:23:25
8141,97,2,659,85,744,8055,2021-01-29 10:03:41
8142,802,2,548,71,619,8056,2021-01-29 17:59:18
8143,834,2,628,81,709,8057,2021-01-29 18:45:42
8144,487,4,1096,142,1238,8058,2021-01-29 08:18:41
8145,902,3,558,72,630,8059,2021-01-29 03:57:26
8146,565,3,1247,162,1409,8060,2021-01-29 12:09:35
8147,310,1,499,64,563,8061,2021-01-29 18:35:16
8148,81,2,698,90,788,8062,2021-01-29 14:44:17
8149,650,3,797,103,900,8063,2021-01-29 09:10:09
8150,87,2,698,90,788,8064,2021-01-29 13:23:54
8151,261,3,478,62,540,8065,2021-01-29 20:54:31
8152,903,2,898,116,1014,8066,2021-01-29 01:00:28
8153,826,3,758,98,856,8067,2021-01-28 17:58:48
8154,626,3,997,129,1126,8068,2021-01-28 15:19:30
8155,906,4,1146,148,1294,8069,2021-01-28 15:53:40
8156,673,3,558,72,630,8070,2021-01-29 12:02:06
8157,282,2,798,103,901,8071,2021-01-29 12:18:18
8158,188,3,847,110,957,8072,2021-01-29 17:17:27
8159,900,3,428,55,483,8073,2021-01-29 16:11:38
8160,547,3,997,129,1126,8074,2021-01-29 14:32:43
8161,653,2,1098,142,1240,8075,2021-01-29 16:12:31
8162,477,3,897,116,1013,8076,2021-01-29 02:16:44
8163,362,3,827,107,934,8077,2021-01-28 14:52:29
8164,325,2,498,64,562,8078,2021-01-28 08:55:15
8165,942,2,598,77,675,8079,2021-01-28 17:46:16
8166,308,3,578,75,653,8080,2021-01-28 11:01:15
8167,226,3,797,103,900,8081,2021-01-28 14:30:36
8168,904,2,898,116,1014,8082,2021-01-28 05:46:58
8169,608,2,659,85,744,8083,2021-01-28 09:17:17
8170,729,3,927,120,1047,8084,2021-01-29 02:06:20
8171,545,2,798,103,901,8085,2021-01-28 19:57:28
8172,933,3,1047,136,1183,8086,2021-01-28 11:56:51
8173,425,2,598,77,675,8087,2021-01-28 11:38:05
8174,320,2,898,116,1014,8088,2021-01-28 23:11:04
8175,479,2,329,42,371,8089,2021-01-29 06:05:39
8176,796,2,498,64,562,8090,2021-01-29 09:09:22
8177,254,4,946,122,1068,8091,2021-01-28 21:35:53
8178,620,3,558,72,630,8092,2021-01-29 02:23:47
8179,171,4,1296,168,1464,8093,2021-01-28 15:48:15
8180,58,2,459,59,518,8094,2021-01-28 11:11:52
8181,492,5,1506,195,1701,8095,2021-01-28 17:11:44
8182,502,3,478,62,540,8096,2021-01-28 19:31:21
8183,473,2,1098,142,1240,8097,2021-01-28 19:27:53
8184,862,2,659,85,744,8098,2021-01-30 03:53:21
8185,52,2,698,90,788,8099,2021-01-30 05:39:06
8186,419,5,1356,176,1532,8100,2021-01-30 00:18:05
8187,92,2,498,64,562,8101,2021-01-29 23:05:08
8188,285,3,658,85,743,8102,2021-01-30 00:02:27
8189,404,3,1047,136,1183,8103,2021-01-29 13:24:37
8190,517,2,798,103,901,8104,2021-01-29 10:16:21
8191,408,3,927,120,1047,8105,2021-01-29 03:30:31
8192,375,3,1027,133,1160,8106,2021-01-29 08:38:00
8193,518,3,997,129,1126,8107,2021-01-29 08:45:09
8194,149,1,399,51,450,8108,2021-01-29 12:13:10
8195,159,6,1316,171,1487,8109,2021-01-29 18:03:50
8196,297,5,1845,239,2084,8110,2021-01-30 01:42:19
8197,984,2,498,64,562,8111,2021-01-30 05:02:22
8198,159,6,1785,232,2017,8112,2021-01-29 15:12:18
8199,775,3,428,55,483,8113,2021-01-29 15:57:13
8200,498,3,697,90,787,8114,2021-01-30 06:50:42
8201,672,3,888,115,1003,8115,2021-01-30 03:51:37
8202,650,4,658,85,743,8116,2021-01-30 15:58:41
8203,807,1,99,12,111,8117,2021-01-30 08:05:17
8204,85,5,1575,204,1779,8118,2021-01-30 01:25:01
8205,388,3,927,120,1047,8119,2021-01-30 08:01:56
8206,50,3,558,72,630,8120,2021-01-30 09:06:18
8207,227,2,429,55,484,8121,2021-01-30 10:13:05
8208,46,1,299,38,337,8122,2021-01-30 00:09:56
8209,371,2,598,77,675,8123,2021-01-30 16:28:38
8210,599,2,459,59,518,8124,2021-01-30 16:18:03
8211,461,3,797,103,900,8125,2021-01-30 01:39:09
8212,964,3,1047,136,1183,8126,2021-01-29 22:47:12
8213,465,3,808,105,913,8127,2021-01-28 20:37:22
8214,893,3,758,98,856,8128,2021-01-29 08:08:48
8215,765,2,498,64,562,8129,2021-01-29 14:16:25
8216,901,3,897,116,1013,8130,2021-01-29 09:06:54
8217,416,3,758,98,856,8131,2021-01-29 00:56:49
8218,66,3,688,89,777,8132,2021-01-28 23:18:38
8219,921,3,1127,146,1273,8133,2021-01-29 00:11:49
8220,184,2,498,64,562,8134,2021-01-29 06:22:53
8221,827,2,459,59,518,8135,2021-01-29 04:25:08
8222,447,3,758,98,856,8136,2021-01-29 03:54:51
8223,895,3,827,107,934,8137,2021-01-29 12:27:47
8224,518,1,399,51,450,8138,2021-01-29 11:13:39
8225,204,6,1515,196,1711,8139,2021-01-29 15:44:54
8226,204,6,1515,196,1711,8139,2021-01-29 15:44:54
8227,46,2,659,85,744,8140,2021-01-29 19:33:57
8228,377,4,1376,178,1554,8141,2021-01-29 13:25:21
8229,751,2,598,77,675,8142,2021-01-29 06:04:11
8230,634,3,827,107,934,8143,2021-01-29 12:20:04
8231,565,2,898,116,1014,8144,2021-01-29 20:40:36
8232,583,3,478,62,540,8145,2021-01-29 19:27:43
8233,590,2,598,77,675,8146,2021-01-29 08:51:17
8234,367,3,797,103,900,8147,2021-01-29 05:16:28
8235,362,2,459,59,518,8148,2021-01-29 14:11:32
8236,897,3,827,107,934,8149,2021-01-29 20:26:14
8237,84,3,647,84,731,8150,2021-01-29 14:44:26
8238,996,3,727,94,821,8151,2021-01-29 10:16:20
8239,84,3,428,55,483,8152,2021-01-29 15:28:21
8240,799,3,558,72,630,8153,2021-01-29 21:28:33
8241,674,3,947,123,1070,8154,2021-01-29 01:39:50
8242,353,3,797,103,900,8155,2021-01-28 20:06:08
8243,204,5,1276,165,1441,8156,2021-01-28 15:32:00
8244,835,2,459,59,518,8157,2021-01-28 15:54:04
8245,870,3,797,103,900,8158,2021-01-29 13:24:20
8246,505,3,428,55,483,8159,2021-01-29 14:35:20
8247,163,3,808,105,913,8160,2021-01-29 18:06:33
8248,791,1,399,51,450,8161,2021-01-29 18:51:17
8249,441,3,758,98,856,8162,2021-01-29 15:51:07
8250,799,3,1047,136,1183,8163,2021-01-29 16:27:06
8251,610,1,299,38,337,8164,2021-01-29 02:41:09
8252,958,6,986,128,1114,8165,2021-01-28 15:59:45
8253,16,2,459,59,518,8166,2021-01-28 09:05:13
8254,631,1,149,19,168,8167,2021-01-28 19:17:31
8255,324,2,329,42,371,8168,2021-01-28 11:26:58
8256,48,5,1256,163,1419,8169,2021-01-28 14:58:11
8257,810,2,798,103,901,8170,2021-01-28 07:22:32
8258,588,5,926,120,1046,8171,2021-01-28 11:28:20
8259,944,3,1127,146,1273,8172,2021-01-29 02:56:38
8260,934,3,1247,162,1409,8173,2021-01-28 22:06:55
8261,491,2,798,103,901,8174,2021-01-28 13:19:39
8262,123,2,598,77,675,8175,2021-01-28 13:05:05
8263,612,4,1296,168,1464,8176,2021-01-29 00:53:17
8264,949,3,697,90,787,8177,2021-01-29 07:28:30
8265,335,1,499,64,563,8178,2021-01-29 11:30:17
8266,832,1,599,77,676,8179,2021-01-29 00:20:48
8267,145,3,1127,146,1273,8180,2021-01-29 02:26:45
8268,555,5,1595,207,1802,8181,2021-01-28 17:08:14
8269,830,3,558,72,630,8182,2021-01-28 12:13:07
8270,700,2,429,55,484,8183,2021-01-28 19:18:39
8271,219,3,927,120,1047,8184,2021-01-28 20:00:49
8272,574,3,847,110,957,8185,2021-01-28 19:47:37
8273,886,3,1047,136,1183,8186,2021-01-30 05:14:13
8274,117,2,429,55,484,8187,2021-01-30 06:01:48
8275,168,2,498,64,562,8188,2021-01-30 01:37:14
8276,120,5,1345,174,1519,8189,2021-01-30 00:19:32
8277,898,3,578,75,653,8190,2021-01-30 01:50:40
8278,16,1,299,38,337,8191,2021-01-29 15:02:31
8279,977,3,1497,194,1691,8192,2021-01-29 12:30:02
8280,176,5,1145,148,1293,8193,2021-01-29 05:10:00
8281,828,2,898,116,1014,8194,2021-01-29 09:38:42
8282,947,6,2374,308,2682,8195,2021-01-29 08:50:14
8283,184,2,459,59,518,8196,2021-01-29 13:18:05
8284,717,2,598,77,675,8197,2021-01-29 20:31:11
8285,721,2,698,90,788,8198,2021-01-30 03:47:03
8286,540,3,1047,136,1183,8199,2021-01-30 07:45:33
8287,626,3,688,89,777,8200,2021-01-29 16:53:00
8288,260,3,827,107,934,8201,2021-01-29 17:13:52
8289,646,3,647,84,731,8202,2021-01-30 08:41:22
8290,341,3,727,94,821,8203,2021-01-30 06:06:20
8291,579,2,498,64,562,8204,2021-01-30 16:49:04
8292,394,3,1047,136,1183,8205,2021-01-30 09:21:48
8293,446,3,1047,136,1183,8206,2021-01-30 02:44:11
8294,959,3,1247,162,1409,8207,2021-01-30 08:21:05
8295,330,3,647,84,731,8208,2021-01-30 11:16:10
8296,986,3,697,90,787,8209,2021-01-30 11:59:47
8297,6,2,459,59,518,8210,2021-01-30 00:45:34
8298,391,3,827,107,934,8211,2021-01-30 18:12:59
8299,549,3,647,84,731,8212,2021-01-30 17:39:02
8300,631,6,1724,224,1948,8213,2021-01-30 04:11:24
8301,414,4,1357,176,1533,8214,2021-01-29 23:26:57
8302,448,5,1106,143,1249,8215,2021-01-28 23:00:59
8303,147,5,907,117,1024,8216,2021-01-29 10:17:14
8304,332,2,598,77,675,8217,2021-01-29 16:48:55
8305,84,3,658,85,743,8218,2021-01-29 10:47:52
8306,450,3,727,94,821,8219,2021-01-29 01:18:39
8307,131,3,997,129,1126,8220,2021-01-28 23:29:35
8308,314,2,898,116,1014,8221,2021-01-29 00:51:06
8309,659,3,808,105,913,8222,2021-01-29 07:20:11
8310,104,4,1296,168,1464,8223,2021-01-29 06:45:51
8311,921,2,898,116,1014,8224,2021-01-29 06:06:39
8312,635,3,578,75,653,8225,2021-01-29 12:37:28
8313,907,3,727,94,821,8226,2021-01-29 13:26:27
8314,172,3,747,97,844,8227,2021-01-29 17:51:21
8315,924,2,329,42,371,8228,2021-01-29 18:08:00
8316,510,2,459,59,518,8229,2021-01-29 21:10:29
8317,439,3,847,110,957,8230,2021-01-29 14:33:15
8318,198,3,1047,136,1183,8231,2021-01-29 07:47:37
8319,798,3,688,89,777,8232,2021-01-29 12:56:44
8320,646,3,1027,133,1160,8233,2021-01-29 21:22:21
8321,635,3,1047,136,1183,8234,2021-01-29 20:23:45
8322,893,5,1545,200,1745,8235,2021-01-29 10:55:00
8323,744,6,1815,235,2050,8236,2021-01-29 05:39:40
8324,210,3,997,129,1126,8237,2021-01-29 14:30:04
8325,236,4,1426,185,1611,8238,2021-01-29 22:09:10
8326,192,3,688,89,777,8239,2021-01-29 16:39:50
8327,404,2,498,64,562,8240,2021-01-29 12:31:57
8328,194,2,798,103,901,8241,2021-01-29 18:05:02
8329,86,3,1047,136,1183,8242,2021-01-29 22:38:16
8330,802,3,808,105,913,8243,2021-01-29 02:27:57
8331,955,5,1325,172,1497,8244,2021-01-28 22:14:41
8332,551,6,1544,200,1744,8245,2021-01-28 16:24:53
8333,982,3,647,84,731,8246,2021-01-28 15:57:55
8334,156,3,927,120,1047,8247,2021-01-29 16:00:36
8335,735,3,697,90,787,8248,2021-01-29 15:12:35
8336,48,3,1247,162,1409,8249,2021-01-29 20:16:51
8337,901,2,898,116,1014,8250,2021-01-29 21:21:53
8338,213,2,598,77,675,8251,2021-01-29 17:22:24
8339,531,2,429,55,484,8252,2021-01-29 17:55:00
8340,302,2,1098,142,1240,8253,2021-01-29 05:17:35
8341,601,3,947,123,1070,8254,2021-01-28 17:50:29
8342,610,2,898,116,1014,8255,2021-01-28 10:49:36
8343,115,4,1526,198,1724,8256,2021-01-28 20:47:43
8344,786,2,598,77,675,8257,2021-01-28 13:23:41
8345,751,3,747,97,844,8258,2021-01-28 16:22:45
8346,133,3,647,84,731,8259,2021-01-28 07:52:18
8347,286,3,558,72,630,8260,2021-01-28 12:09:46
8348,500,2,598,77,675,8261,2021-01-29 04:28:35
8349,201,2,659,85,744,8262,2021-01-29 00:30:09
8350,617,5,1455,189,1644,8263,2021-01-28 14:16:45
8351,521,3,1197,155,1352,8264,2021-01-28 15:04:36
8352,72,2,459,59,518,8265,2021-01-29 01:43:02
8353,856,2,429,55,484,8266,2021-01-29 07:46:52
8354,108,1,299,38,337,8267,2021-01-29 12:35:25
8355,108,1,299,38,337,8267,2021-01-29 12:35:25
8356,165,2,329,42,371,8268,2021-01-29 02:38:37
8357,553,2,898,116,1014,8269,2021-01-29 05:07:58
8358,790,3,927,120,1047,8270,2021-01-28 17:37:55
8359,688,4,1077,140,1217,8271,2021-01-28 13:20:39
8360,440,3,1197,155,1352,8272,2021-01-28 21:53:03
8361,440,3,1197,155,1352,8272,2021-01-28 21:53:03
8362,780,2,1098,142,1240,8273,2021-01-28 20:13:43
8363,686,2,898,116,1014,8274,2021-01-28 20:02:25
8364,133,2,898,116,1014,8275,2021-01-30 06:12:32
8365,173,2,429,55,484,8276,2021-01-30 08:25:48
8366,330,6,1824,237,2061,8277,2021-01-30 02:59:24
8367,659,1,99,12,111,8278,2021-01-30 02:49:21
8368,546,3,558,72,630,8279,2021-01-30 03:55:05
8369,546,3,558,72,630,8279,2021-01-30 03:55:05
8370,996,1,229,29,258,8280,2021-01-29 17:35:49
8371,665,3,997,129,1126,8281,2021-01-29 14:02:16
8372,665,3,997,129,1126,8281,2021-01-29 14:02:16
8373,963,3,697,90,787,8282,2021-01-29 06:07:26
8374,56,5,1845,239,2084,8283,2021-01-29 10:51:48
8375,119,3,478,62,540,8284,2021-01-29 10:17:57
8376,798,3,1197,155,1352,8285,2021-01-29 13:51:31
8377,213,2,1098,142,1240,8286,2021-01-29 22:42:59
8378,683,3,747,97,844,8287,2021-01-30 06:21:04
8379,269,3,428,55,483,8288,2021-01-30 10:05:14
8380,538,2,498,64,562,8289,2021-01-29 18:48:28
8381,849,5,1855,241,2096,8290,2021-01-29 19:37:46
8382,117,2,798,103,901,8291,2021-01-30 09:14:40
8383,640,2,329,42,371,8292,2021-01-30 08:29:10
8384,290,3,697,90,787,8293,2021-01-30 19:04:38
8385,296,2,928,120,1048,8294,2021-01-30 11:15:28
8386,219,2,429,55,484,8295,2021-01-30 03:33:27
8387,519,2,898,116,1014,8296,2021-01-30 09:02:31
8388,784,3,558,72,630,8297,2021-01-30 12:28:09
8389,821,3,727,94,821,8298,2021-01-30 12:02:18
8390,339,3,888,115,1003,8299,2021-01-30 02:19:07
8391,80,2,498,64,562,8300,2021-01-30 18:45:02
8392,922,5,1795,233,2028,8301,2021-01-30 19:05:18
8393,827,3,747,97,844,8302,2021-01-30 06:47:04
8394,911,5,1586,206,1792,8303,2021-01-29 23:38:21
8395,500,2,898,116,1014,8304,2021-01-28 23:16:53
8396,143,1,229,29,258,8305,2021-01-29 13:00:30
8397,67,6,1605,208,1813,8306,2021-01-29 18:30:35
8398,846,2,498,64,562,8307,2021-01-29 11:50:04
8399,660,2,798,103,901,8308,2021-01-29 02:15:35
8400,57,3,1127,146,1273,8309,2021-01-28 23:57:55
8401,430,2,598,77,675,8310,2021-01-29 02:55:35
8402,909,1,149,19,168,8311,2021-01-29 08:42:03
8403,359,2,329,42,371,8312,2021-01-29 07:31:33
8404,476,3,697,90,787,8313,2021-01-29 07:46:50
8405,507,6,1485,193,1678,8314,2021-01-29 13:13:28
8406,117,3,658,85,743,8315,2021-01-29 14:26:47
8407,380,2,459,59,518,8316,2021-01-29 18:52:43
8408,885,3,578,75,653,8317,2021-01-29 20:22:52
8409,637,3,1327,172,1499,8318,2021-01-29 23:56:04
8410,844,3,1197,155,1352,8319,2021-01-29 15:47:19
8411,98,3,658,85,743,8320,2021-01-29 09:08:10
8412,761,2,598,77,675,8321,2021-01-29 13:17:36
8413,795,5,1676,217,1893,8322,2021-01-29 22:45:01
8414,474,3,747,97,844,8323,2021-01-29 20:30:15
8415,776,3,847,110,957,8324,2021-01-29 10:57:54
8416,338,3,697,90,787,8325,2021-01-29 05:47:32
8417,95,3,528,68,596,8326,2021-01-29 14:40:46
8418,41,2,429,55,484,8327,2021-01-29 23:20:36
8419,216,3,697,90,787,8328,2021-01-29 16:49:18
8420,894,3,478,62,540,8329,2021-01-29 13:54:08
8421,742,3,797,103,900,8330,2021-01-29 20:03:02
8422,917,6,1894,246,2140,8331,2021-01-29 23:24:24
8423,188,2,748,97,845,8332,2021-01-29 04:47:24
8424,88,2,698,90,788,8333,2021-01-29 00:59:53
8425,681,3,827,107,934,8334,2021-01-28 16:56:09
8426,875,3,697,90,787,8335,2021-01-28 17:02:53
8427,574,2,1098,142,1240,8336,2021-01-29 16:41:47
8428,365,6,1305,169,1474,8337,2021-01-29 15:34:36
8429,405,3,1047,136,1183,8338,2021-01-29 22:07:12
8430,613,3,727,94,821,8339,2021-01-29 21:58:57
8431,73,5,1645,213,1858,8340,2021-01-29 17:34:13
8432,533,3,1247,162,1409,8341,2021-01-29 19:57:19
8433,316,2,1098,142,1240,8342,2021-01-29 07:39:00
8434,770,3,1047,136,1183,8343,2021-01-28 19:59:49
8435,781,2,1098,142,1240,8344,2021-01-28 11:35:30
8436,752,3,727,94,821,8345,2021-01-28 23:18:28
8437,782,3,558,72,630,8346,2021-01-28 14:36:55
8438,706,2,459,59,518,8347,2021-01-28 18:27:12
8439,383,2,598,77,675,8348,2021-01-28 08:05:47
8440,435,6,2085,271,2356,8349,2021-01-28 14:42:14
8441,652,3,1047,136,1183,8350,2021-01-29 05:33:37
8442,791,3,597,77,674,8351,2021-01-29 02:52:11
8443,527,2,748,97,845,8352,2021-01-28 14:58:38
8444,184,3,658,85,743,8353,2021-01-28 16:45:04
8445,59,2,498,64,562,8354,2021-01-29 03:14:39
8446,142,2,598,77,675,8355,2021-01-29 09:28:25
8447,766,3,1247,162,1409,8356,2021-01-29 15:00:51
8448,399,2,429,55,484,8357,2021-01-29 14:59:56
8449,603,3,1247,162,1409,8358,2021-01-29 05:01:00
8450,190,3,697,90,787,8359,2021-01-29 06:06:46
8451,488,3,597,77,674,8360,2021-01-28 19:11:22
8452,940,2,429,55,484,8361,2021-01-28 14:05:27
8453,654,2,748,97,845,8362,2021-01-29 00:00:44
8454,170,3,478,62,540,8363,2021-01-28 23:01:10
8455,335,2,798,103,901,8364,2021-01-28 22:56:20
8456,934,5,1195,155,1350,8365,2021-01-28 21:12:42
8457,669,2,329,42,371,8366,2021-01-30 06:34:48
8458,850,3,758,98,856,8367,2021-01-30 08:34:22
8459,619,3,808,105,913,8368,2021-01-30 04:18:16
8460,599,1,149,19,168,8369,2021-01-30 05:01:46
8461,233,4,1257,163,1420,8370,2021-01-30 05:52:29
8462,96,2,459,59,518,8371,2021-01-30 05:15:29
8463,419,2,598,77,675,8372,2021-01-29 20:01:48
8464,41,3,578,75,653,8373,2021-01-29 15:45:08
8465,520,5,1395,181,1576,8374,2021-01-29 14:25:39
8466,856,4,1846,239,2085,8375,2021-01-29 07:40:35
8467,418,2,628,81,709,8376,2021-01-29 10:58:34
8468,324,2,628,81,709,8377,2021-01-29 12:56:07
8469,245,2,898,116,1014,8378,2021-01-29 16:11:37
8470,264,3,747,97,844,8379,2021-01-29 23:25:42
8471,82,2,798,103,901,8380,2021-01-30 07:16:20
8472,35,3,888,115,1003,8381,2021-01-30 10:38:11
8473,511,3,1247,162,1409,8382,2021-01-29 19:50:26
8474,315,3,758,98,856,8383,2021-01-29 20:17:26
8475,16,3,658,85,743,8384,2021-01-30 10:41:43
8476,156,3,827,107,934,8385,2021-01-30 10:04:20
8477,317,3,428,55,483,8386,2021-01-30 19:51:26
8478,169,2,698,90,788,8387,2021-01-30 12:47:34
8479,160,5,1906,247,2153,8388,2021-01-30 03:36:21
8480,372,3,558,72,630,8389,2021-01-30 10:32:42
8481,383,3,997,129,1126,8390,2021-01-30 14:02:43
8482,63,3,1127,146,1273,8391,2021-01-30 14:12:39
8483,780,2,598,77,675,8392,2021-01-30 04:25:03
8484,577,2,1098,142,1240,8393,2021-01-30 20:28:46
8485,931,2,898,116,1014,8394,2021-01-30 19:30:11
8486,5,3,1127,146,1273,8395,2021-01-30 08:46:28
8487,200,3,747,97,844,8396,2021-01-30 00:29:27
8488,859,2,498,64,562,8397,2021-01-29 00:34:05
8489,305,3,827,107,934,8398,2021-01-29 14:36:37
8490,300,3,1127,146,1273,8399,2021-01-29 20:36:30
8491,470,3,1247,162,1409,8400,2021-01-29 12:23:50
8492,923,6,1685,219,1904,8401,2021-01-29 03:40:07
8493,666,3,428,55,483,8402,2021-01-29 00:42:23
8494,800,2,429,55,484,8403,2021-01-29 03:28:56
8495,292,3,827,107,934,8404,2021-01-29 08:51:47
8496,712,2,329,42,371,8405,2021-01-29 08:29:33
8497,424,3,1027,133,1160,8406,2021-01-29 08:09:09
8498,583,2,329,42,371,8407,2021-01-29 15:46:44
8499,371,3,758,98,856,8408,2021-01-29 15:02:08
8500,58,2,598,77,675,8409,2021-01-29 19:21:36
8501,830,3,608,79,687,8410,2021-01-29 21:02:16
8502,830,3,747,97,844,8411,2021-01-30 01:39:16
8503,841,2,1098,142,1240,8412,2021-01-29 16:32:40
8504,374,2,598,77,675,8413,2021-01-29 10:50:12
8505,500,5,1326,172,1498,8414,2021-01-29 13:36:34
8506,741,2,459,59,518,8415,2021-01-30 00:48:23
8507,362,2,498,64,562,8416,2021-01-29 20:44:28
8508,159,2,898,116,1014,8417,2021-01-29 12:53:33
8509,342,4,1726,224,1950,8418,2021-01-29 05:52:23
8510,235,6,1944,252,2196,8419,2021-01-29 15:26:01
8511,635,2,659,85,744,8420,2021-01-30 00:05:26
8512,948,3,1247,162,1409,8421,2021-01-29 19:03:33
8513,705,1,699,90,789,8422,2021-01-29 15:02:03
8514,52,2,898,116,1014,8423,2021-01-29 22:01:26
8515,781,3,827,107,934,8424,2021-01-30 01:35:33
8516,781,3,827,107,934,8424,2021-01-30 01:35:33
8517,620,3,688,89,777,8425,2021-01-29 05:24:14
8518,96,5,1825,237,2062,8426,2021-01-29 02:22:43
8519,903,3,428,55,483,8427,2021-01-28 18:04:17
8520,120,3,808,105,913,8428,2021-01-28 19:26:37
8521,731,3,847,110,957,8429,2021-01-29 17:47:39
8522,579,2,898,116,1014,8430,2021-01-29 17:05:59
8523,364,3,747,97,844,8431,2021-01-29 23:45:46
8524,893,3,478,62,540,8432,2021-01-29 22:58:31
8525,952,3,697,90,787,8433,2021-01-29 17:49:57
8526,879,2,659,85,744,8434,2021-01-29 22:08:01
8527,537,3,1127,146,1273,8435,2021-01-29 07:52:30
8528,846,3,1027,133,1160,8436,2021-01-28 21:42:43
8529,297,2,659,85,744,8437,2021-01-28 12:48:08
8530,680,3,758,98,856,8438,2021-01-29 00:58:53
8531,92,5,1126,146,1272,8439,2021-01-28 15:05:14
8532,397,2,329,42,371,8440,2021-01-28 18:45:34
8533,604,3,927,120,1047,8441,2021-01-28 10:16:33
8534,766,2,459,59,518,8442,2021-01-28 14:54:26
8535,36,2,628,81,709,8443,2021-01-29 06:34:21
8536,663,5,1026,133,1159,8444,2021-01-29 05:24:53
8537,605,5,1217,158,1375,8445,2021-01-28 17:00:59
8538,649,2,798,103,901,8446,2021-01-28 18:32:11
8539,140,2,598,77,675,8447,2021-01-29 04:35:27
8540,383,3,1327,172,1499,8448,2021-01-29 10:01:40
8541,783,4,1387,180,1567,8449,2021-01-29 16:46:47
8542,960,6,1694,220,1914,8450,2021-01-29 16:20:04
8543,572,6,1446,187,1633,8451,2021-01-29 05:14:17
8544,329,3,428,55,483,8452,2021-01-29 06:48:41
8545,393,3,847,110,957,8453,2021-01-28 19:55:50
8546,528,2,498,64,562,8454,2021-01-28 15:57:09
8547,215,2,429,55,484,8455,2021-01-29 00:57:46
8548,487,3,1127,146,1273,8456,2021-01-29 00:56:24
8549,209,3,947,123,1070,8457,2021-01-28 23:49:16
8550,587,2,698,90,788,8458,2021-01-28 23:29:29
8551,360,6,1694,220,1914,8459,2021-01-30 08:29:38
8552,53,3,558,72,630,8460,2021-01-30 10:11:40
8553,319,3,428,55,483,8461,2021-01-30 06:27:44
8554,319,3,428,55,483,8461,2021-01-30 06:27:44
8555,937,2,459,59,518,8462,2021-01-30 07:11:38
8556,823,6,1344,174,1518,8463,2021-01-30 07:05:53
8557,456,3,558,72,630,8464,2021-01-30 07:48:04
8558,42,3,597,77,674,8465,2021-01-29 20:48:41
8559,66,2,628,81,709,8466,2021-01-29 16:36:04
8560,923,3,428,55,483,8467,2021-01-29 15:41:01
8561,314,4,1096,142,1238,8468,2021-01-29 07:49:44
8562,758,5,1256,163,1419,8469,2021-01-29 11:51:36
8563,652,3,847,110,957,8470,2021-01-29 15:14:36
8564,297,3,897,116,1013,8471,2021-01-29 16:41:12
8565,32,3,1027,133,1160,8472,2021-01-29 23:27:37
8566,236,3,1127,146,1273,8473,2021-01-30 08:54:19
8567,91,2,528,68,596,8474,2021-01-30 12:31:00
8568,671,3,947,123,1070,8475,2021-01-29 20:02:56
8569,89,3,558,72,630,8476,2021-01-29 21:49:45
8570,738,3,808,105,913,8477,2021-01-30 13:13:57
8571,763,3,997,129,1126,8478,2021-01-30 12:38:00
8572,896,3,697,90,787,8479,2021-01-30 20:21:27
8573,474,4,1276,165,1441,8480,2021-01-30 14:39:33
8574,681,1,399,51,450,8481,2021-01-30 04:51:13
8575,823,2,329,42,371,8482,2021-01-30 10:58:31
8576,736,3,747,97,844,8483,2021-01-30 14:11:40
8577,407,3,1047,136,1183,8484,2021-01-30 14:21:38
8578,933,3,927,120,1047,8485,2021-01-30 06:00:07
8579,756,3,697,90,787,8486,2021-01-30 21:31:03
8580,143,2,798,103,901,8487,2021-01-30 21:24:18
8581,523,2,798,103,901,8488,2021-01-30 11:11:37
8582,529,3,758,98,856,8489,2021-01-30 02:58:49
8583,844,3,808,105,913,8490,2021-01-29 01:20:41
8584,460,2,598,77,675,8491,2021-01-29 16:03:12
8585,961,3,847,110,957,8492,2021-01-29 21:13:47
8586,32,2,698,90,788,8493,2021-01-29 13:21:46
8587,294,4,1296,168,1464,8494,2021-01-29 05:09:23
8588,539,3,1127,146,1273,8495,2021-01-29 02:12:40
8589,226,3,428,55,483,8496,2021-01-29 05:43:55
8590,264,3,727,94,821,8497,2021-01-29 09:34:42
8591,14,2,1098,142,1240,8498,2021-01-29 10:24:42
8592,783,3,1197,155,1352,8499,2021-01-29 08:21:26
8593,917,1,149,19,168,8500,2021-01-29 18:23:02
8594,792,2,848,110,958,8501,2021-01-29 15:45:42
8595,696,4,1007,130,1137,8502,2021-01-29 21:38:54
8596,131,3,827,107,934,8503,2021-01-29 22:19:41
8597,400,3,1247,162,1409,8504,2021-01-30 04:23:07
8598,717,1,299,38,337,8505,2021-01-29 18:58:12
8599,749,3,558,72,630,8506,2021-01-29 12:43:18
8600,205,4,1526,198,1724,8507,2021-01-29 15:42:42
8601,882,3,1327,172,1499,8508,2021-01-30 02:23:20
8602,190,2,498,64,562,8509,2021-01-29 21:15:09
8603,346,2,498,64,562,8510,2021-01-29 15:14:33
8604,717,3,827,107,934,8511,2021-01-29 06:09:12
8605,667,3,1327,172,1499,8512,2021-01-29 17:46:45
8606,568,5,1345,174,1519,8513,2021-01-30 01:01:05
8607,637,3,1127,146,1273,8514,2021-01-29 21:15:28
8608,760,3,578,75,653,8515,2021-01-29 15:39:45
8609,181,3,808,105,913,8516,2021-01-29 22:48:49
8610,586,2,698,90,788,8517,2021-01-30 02:39:46
8611,940,3,1127,146,1273,8518,2021-01-30 03:18:25
8612,290,2,798,103,901,8519,2021-01-29 06:58:22
8613,400,2,898,116,1014,8520,2021-01-29 04:12:21
8614,882,2,898,116,1014,8521,2021-01-28 19:23:06
8615,948,3,558,72,630,8522,2021-01-28 21:09:44
8616,679,3,1047,136,1183,8523,2021-01-29 19:24:36
8617,157,3,428,55,483,8524,2021-01-29 18:32:10
8618,324,3,897,116,1013,8525,2021-01-30 00:56:02
8619,629,3,1047,136,1183,8526,2021-01-30 01:17:54
8620,658,3,578,75,653,8527,2021-01-29 18:34:34
8621,827,3,478,62,540,8528,2021-01-29 22:58:38
8622,626,2,898,116,1014,8529,2021-01-29 08:31:48
8623,695,6,1744,226,1970,8530,2021-01-29 00:03:13
8624,212,1,229,29,258,8531,2021-01-28 12:51:13
8625,434,3,658,85,743,8532,2021-01-29 02:30:57
8626,350,3,1097,142,1239,8533,2021-01-28 16:26:08
8627,752,1,99,12,111,8534,2021-01-28 20:42:47
8628,156,3,558,72,630,8535,2021-01-28 10:45:49
8629,452,2,698,90,788,8536,2021-01-28 17:33:30
8630,108,2,798,103,901,8537,2021-01-29 07:51:11
8631,889,3,827,107,934,8538,2021-01-29 06:59:57
8632,15,2,659,85,744,8539,2021-01-28 18:57:39
8633,422,5,1575,204,1779,8540,2021-01-28 18:51:40
8634,235,6,1574,204,1778,8541,2021-01-29 05:35:32
8635,895,2,798,103,901,8542,2021-01-29 10:11:02
8636,413,2,698,90,788,8543,2021-01-29 18:57:35
8637,495,3,827,107,934,8544,2021-01-29 18:40:31
8638,226,1,99,12,111,8545,2021-01-29 07:22:25
8639,815,3,758,98,856,8546,2021-01-29 08:52:38
8640,446,4,1746,226,1972,8547,2021-01-28 20:14:01
8641,577,3,1327,172,1499,8548,2021-01-28 17:02:55
8642,410,2,459,59,518,8549,2021-01-29 02:33:03
8643,884,4,1926,250,2176,8550,2021-01-29 01:38:41
8644,908,3,608,79,687,8551,2021-01-29 01:54:54
8645,913,3,478,62,540,8552,2021-01-29 01:28:17
8646,153,3,847,110,957,8553,2021-01-30 08:47:42
8647,10,3,697,90,787,8554,2021-01-30 10:13:10
8648,991,3,478,62,540,8555,2021-01-30 08:20:26
8649,147,2,329,42,371,8556,2021-01-30 08:20:44
8650,449,3,1197,155,1352,8557,2021-01-30 09:51:53
8651,962,3,808,105,913,8558,2021-01-30 07:24:31
8652,128,2,898,116,1014,8559,2021-01-30 09:47:35
8653,141,5,2145,278,2423,8560,2021-01-29 20:50:36
8654,931,3,608,79,687,8561,2021-01-29 19:07:33
8655,611,1,699,90,789,8562,2021-01-29 17:24:25
8656,817,3,997,129,1126,8563,2021-01-29 10:12:43
8657,773,3,747,97,844,8564,2021-01-29 12:50:15
8658,82,3,758,98,856,8565,2021-01-29 15:22:29
8659,43,2,898,116,1014,8566,2021-01-29 17:25:31
8660,757,2,528,68,596,8567,2021-01-30 01:37:29
8661,970,3,1197,155,1352,8568,2021-01-30 11:40:21
8662,323,3,428,55,483,8569,2021-01-30 15:05:32
8663,3,3,1127,146,1273,8570,2021-01-29 21:00:11
8664,303,3,478,62,540,8571,2021-01-29 23:32:36
8665,572,2,459,59,518,8572,2021-01-30 15:06:55
8666,76,3,1197,155,1352,8573,2021-01-30 13:55:23
8667,303,3,747,97,844,8574,2021-01-30 21:26:52
8668,680,3,747,97,844,8575,2021-01-30 16:27:11
8669,360,1,149,19,168,8576,2021-01-30 04:51:41
8670,967,2,459,59,518,8577,2021-01-30 11:56:26
8671,641,3,558,72,630,8578,2021-01-30 16:32:20
8672,46,3,747,97,844,8579,2021-01-30 16:16:15
8673,496,3,1127,146,1273,8580,2021-01-30 08:19:50
8674,275,3,847,110,957,8581,2021-01-30 21:39:16
8675,131,3,1127,146,1273,8582,2021-01-30 23:59:21
8676,123,3,947,123,1070,8583,2021-01-30 11:27:13
8677,197,2,329,42,371,8584,2021-01-30 03:45:57
8678,192,3,997,129,1126,8585,2021-01-29 01:21:51
8679,56,3,888,115,1003,8586,2021-01-29 17:28:09
8680,549,3,1127,146,1273,8587,2021-01-29 23:40:40
8681,233,4,1596,207,1803,8588,2021-01-29 13:38:43
8682,620,2,498,64,562,8589,2021-01-29 07:30:20
8683,505,3,747,97,844,8590,2021-01-29 02:33:57
8684,387,2,598,77,675,8591,2021-01-29 08:01:32
8685,250,3,558,72,630,8592,2021-01-29 12:16:11
8686,378,6,1175,152,1327,8593,2021-01-29 10:28:22
8687,865,2,329,42,371,8594,2021-01-29 08:40:57
8688,363,2,798,103,901,8595,2021-01-29 20:32:22
8689,284,2,698,90,788,8596,2021-01-29 18:19:25
8690,211,3,897,116,1013,8597,2021-01-29 22:31:12
8691,562,2,598,77,675,8598,2021-01-30 00:04:51
8692,925,3,927,120,1047,8599,2021-01-30 06:54:07
8693,11,3,727,94,821,8600,2021-01-29 19:26:42
8694,894,6,1494,194,1688,8601,2021-01-29 14:47:58
8695,355,2,648,84,732,8602,2021-01-29 16:36:38
8696,168,2,798,103,901,8603,2021-01-30 04:40:10
8697,348,3,697,90,787,8604,2021-01-29 22:17:55
8698,100,3,1127,146,1273,8605,2021-01-29 16:04:20
8699,259,3,1127,146,1273,8606,2021-01-29 06:18:13
8700,453,3,797,103,900,8607,2021-01-29 18:25:30
8701,297,3,428,55,483,8608,2021-01-30 02:34:22
8702,952,3,897,116,1013,8609,2021-01-29 23:41:31
8703,528,3,597,77,674,8610,2021-01-29 15:47:28
8704,811,3,727,94,821,8611,2021-01-30 00:29:11
8705,130,2,459,59,518,8612,2021-01-30 03:23:11
8706,368,3,558,72,630,8613,2021-01-30 05:40:46
8707,368,3,558,72,630,8613,2021-01-30 05:40:46
8708,617,3,997,129,1126,8614,2021-01-29 07:24:24
8709,315,2,459,59,518,8615,2021-01-29 06:50:46
8710,6,3,1127,146,1273,8616,2021-01-28 21:12:38
8711,18,3,888,115,1003,8617,2021-01-28 22:54:10
8712,906,3,797,103,900,8618,2021-01-29 22:03:31
8713,285,3,647,84,731,8619,2021-01-29 20:06:08
8714,573,3,797,103,900,8620,2021-01-30 01:17:10
8715,519,5,2125,276,2401,8621,2021-01-30 02:42:13
8716,203,3,827,107,934,8622,2021-01-29 19:11:39
8717,270,3,558,72,630,8623,2021-01-30 00:25:16
8718,774,3,1127,146,1273,8624,2021-01-29 09:19:06
8719,278,2,598,77,675,8625,2021-01-29 02:15:12
8720,342,5,1645,213,1858,8626,2021-01-28 14:39:58
8721,690,3,528,68,596,8627,2021-01-29 04:12:10
8722,107,3,558,72,630,8628,2021-01-28 18:10:27
8723,126,2,1098,142,1240,8629,2021-01-28 22:01:14
8724,301,3,947,123,1070,8630,2021-01-28 13:28:01
8725,722,3,658,85,743,8631,2021-01-28 17:58:15
8726,795,2,498,64,562,8632,2021-01-29 08:12:59
8727,4,2,498,64,562,8633,2021-01-29 07:11:00
8728,152,3,688,89,777,8634,2021-01-28 21:34:11
8729,903,2,898,116,1014,8635,2021-01-28 19:06:44
8730,768,1,299,38,337,8636,2021-01-29 06:31:47
8731,880,1,229,29,258,8637,2021-01-29 12:16:08
8732,668,2,598,77,675,8638,2021-01-29 19:53:24
8733,232,6,1305,169,1474,8639,2021-01-29 20:48:23
8734,644,3,827,107,934,8640,2021-01-29 08:24:19
8735,672,3,697,90,787,8641,2021-01-29 11:33:18
8736,283,5,2125,276,2401,8642,2021-01-28 20:47:32
8737,888,3,827,107,934,8643,2021-01-28 17:20:57
8738,85,3,888,115,1003,8644,2021-01-29 04:36:36
8739,389,5,1156,150,1306,8645,2021-01-29 03:39:56
8740,541,3,688,89,777,8646,2021-01-29 04:07:05
8741,109,3,478,62,540,8647,2021-01-29 02:53:32
8742,941,3,697,90,787,8648,2021-01-30 10:42:00
8743,720,1,599,77,676,8649,2021-01-30 11:26:14
8744,941,6,1474,191,1665,8650,2021-01-30 08:23:54
8745,499,3,827,107,934,8651,2021-01-30 09:01:34
8746,966,3,1247,162,1409,8652,2021-01-30 12:36:09
8747,715,2,459,59,518,8653,2021-01-30 10:02:54
8748,84,2,1098,142,1240,8654,2021-01-30 10:13:12
8749,382,2,698,90,788,8655,2021-01-29 23:03:51
8750,273,4,1296,168,1464,8656,2021-01-29 21:29:31
8751,613,2,429,55,484,8657,2021-01-29 18:48:09
8752,424,3,947,123,1070,8658,2021-01-29 12:01:02
8753,626,2,329,42,371,8659,2021-01-29 13:26:26
8754,778,3,808,105,913,8660,2021-01-29 16:12:49
8755,661,5,1825,237,2062,8661,2021-01-29 18:36:33
8756,608,2,728,94,822,8662,2021-01-30 02:57:10
8757,908,2,698,90,788,8663,2021-01-30 13:19:42
8758,146,3,847,110,957,8664,2021-01-30 17:37:34
8759,778,3,1327,172,1499,8665,2021-01-29 23:04:54
8760,480,3,697,90,787,8666,2021-01-29 23:55:34
8761,126,2,1098,142,1240,8667,2021-01-30 17:49:38
8762,782,2,598,77,675,8668,2021-01-30 15:40:16
8763,204,3,927,120,1047,8669,2021-01-30 23:10:24
8764,583,4,1626,211,1837,8670,2021-01-30 19:08:58
8765,336,3,847,110,957,8671,2021-01-30 06:56:09
8766,506,3,1027,133,1160,8672,2021-01-30 13:00:01
8767,35,3,608,79,687,8673,2021-01-30 18:31:23
8768,693,3,997,129,1126,8674,2021-01-30 18:03:55
8769,909,3,688,89,777,8675,2021-01-30 09:32:40
8770,653,2,398,51,449,8676,2021-01-30 22:06:03
8771,99,2,898,116,1014,8677,2021-01-31 02:05:34
8772,986,3,808,105,913,8678,2021-01-30 13:24:16
8773,429,2,598,77,675,8679,2021-01-30 04:49:22
8774,334,3,927,120,1047,8680,2021-01-29 03:06:46
8775,134,3,558,72,630,8681,2021-01-29 18:42:43
8776,681,3,697,90,787,8682,2021-01-30 00:24:25
8777,246,3,847,110,957,8683,2021-01-29 16:17:04
8778,213,3,847,110,957,8684,2021-01-29 08:37:48
8779,569,1,229,29,258,8685,2021-01-29 04:35:18
8780,390,3,578,75,653,8686,2021-01-29 10:43:06
8781,37,3,727,94,821,8687,2021-01-29 13:49:26
8782,280,3,827,107,934,8688,2021-01-29 12:45:17
8783,81,3,1247,162,1409,8689,2021-01-29 10:03:49
8784,152,2,898,116,1014,8690,2021-01-29 22:00:20
8785,761,6,1635,212,1847,8691,2021-01-29 20:42:20
8786,682,3,1127,146,1273,8692,2021-01-30 00:03:03
8787,699,3,727,94,821,8693,2021-01-30 01:15:56
8788,491,5,1206,156,1362,8694,2021-01-30 08:32:56
8789,46,2,898,116,1014,8695,2021-01-29 21:40:05
8790,647,2,429,55,484,8696,2021-01-29 16:47:52
8791,544,3,608,79,687,8697,2021-01-29 17:17:30
8792,273,3,747,97,844,8698,2021-01-30 05:18:11
8793,351,3,478,62,540,8699,2021-01-30 00:26:06
8794,711,3,558,72,630,8700,2021-01-29 18:02:21
8795,427,3,578,75,653,8701,2021-01-29 08:56:52
8796,453,2,598,77,675,8702,2021-01-29 19:57:27
8797,61,3,1327,172,1499,8703,2021-01-30 04:01:57
8798,92,6,1036,134,1170,8704,2021-01-30 00:41:10
8799,305,3,697,90,787,8705,2021-01-29 16:00:06
8800,772,6,1425,185,1610,8706,2021-01-30 00:40:39
8801,555,3,478,62,540,8707,2021-01-30 04:14:02
8802,101,6,1455,189,1644,8708,2021-01-30 07:25:21
8803,373,3,1027,133,1160,8709,2021-01-30 07:08:31
8804,241,2,698,90,788,8710,2021-01-29 07:40:15
8805,347,3,947,123,1070,8711,2021-01-29 07:47:29
8806,394,3,428,55,483,8712,2021-01-28 22:05:39
8807,355,3,827,107,934,8713,2021-01-29 00:16:40
8808,524,3,688,89,777,8714,2021-01-29 22:39:59
8809,242,3,888,115,1003,8715,2021-01-29 22:33:18
8810,581,3,688,89,777,8716,2021-01-30 02:29:17
8811,845,3,1327,172,1499,8717,2021-01-30 03:53:37
8812,299,2,598,77,675,8718,2021-01-29 21:48:21
8813,74,3,808,105,913,8719,2021-01-30 01:30:59
8814,783,3,478,62,540,8720,2021-01-29 10:26:02
8815,384,3,888,115,1003,8721,2021-01-29 02:24:04
8816,682,3,808,105,913,8722,2021-01-28 15:30:07
8817,270,3,1027,133,1160,8723,2021-01-29 05:22:55
8818,260,2,598,77,675,8724,2021-01-28 19:05:27
8819,16,5,1045,135,1180,8725,2021-01-28 23:04:30
8820,232,2,498,64,562,8726,2021-01-28 15:35:47
8821,192,3,558,72,630,8727,2021-01-28 18:10:21
8822,241,2,528,68,596,8728,2021-01-29 10:10:09
8823,523,3,727,94,821,8729,2021-01-29 07:52:41
8824,875,3,1047,136,1183,8730,2021-01-28 23:08:16
8825,97,3,827,107,934,8731,2021-01-28 21:33:49
8826,906,2,659,85,744,8732,2021-01-29 07:58:11
8827,170,3,1027,133,1160,8733,2021-01-29 14:13:57
8828,910,3,1327,172,1499,8734,2021-01-29 20:19:51
8829,701,3,558,72,630,8735,2021-01-29 23:04:33
8830,123,3,478,62,540,8736,2021-01-29 10:10:28
8831,489,3,1027,133,1160,8737,2021-01-29 12:53:26
8832,680,4,1296,168,1464,8738,2021-01-28 22:33:32
8833,210,4,826,107,933,8739,2021-01-28 18:13:20
8834,27,3,758,98,856,8740,2021-01-29 06:14:11
8835,318,3,1127,146,1273,8741,2021-01-29 05:26:35
8836,508,3,927,120,1047,8742,2021-01-29 04:14:11
8837,319,2,698,90,788,8743,2021-01-29 05:36:01
8838,175,2,659,85,744,8744,2021-01-30 12:39:48
8839,346,3,847,110,957,8745,2021-01-30 12:42:10
8840,629,3,608,79,687,8746,2021-01-30 10:03:00
8841,391,3,797,103,900,8747,2021-01-30 11:18:48
8842,287,2,898,116,1014,8748,2021-01-30 15:05:27
8843,79,3,1047,136,1183,8749,2021-01-30 11:59:15
8844,788,2,898,116,1014,8750,2021-01-30 10:29:34
8845,486,2,429,55,484,8751,2021-01-29 23:23:19
8846,956,6,2074,269,2343,8752,2021-01-30 00:10:25
8847,579,2,598,77,675,8753,2021-01-29 20:39:16
8848,542,3,797,103,900,8754,2021-01-29 14:42:15
8849,698,3,997,129,1126,8755,2021-01-29 13:26:42
8850,5,3,697,90,787,8756,2021-01-29 16:15:21
8851,961,3,1197,155,1352,8757,2021-01-29 19:24:11
8852,258,3,808,105,913,8758,2021-01-30 05:24:59
8853,473,3,688,89,777,8759,2021-01-30 14:29:14
8854,859,3,597,77,674,8760,2021-01-30 18:50:10
8855,906,2,1098,142,1240,8761,2021-01-29 23:29:48
8856,238,5,1226,159,1385,8762,2021-01-30 00:31:28
8857,973,2,798,103,901,8763,2021-01-30 19:58:20
8858,798,2,628,81,709,8764,2021-01-30 17:07:41
8859,90,3,808,105,913,8765,2021-01-30 23:52:01
8860,89,3,697,90,787,8766,2021-01-30 19:38:09
8861,977,2,898,116,1014,8767,2021-01-30 07:13:24
8862,42,2,429,55,484,8768,2021-01-30 13:05:13
8863,869,3,827,107,934,8769,2021-01-30 20:28:16
8864,87,2,548,71,619,8770,2021-01-30 18:58:52
8865,915,2,598,77,675,8771,2021-01-30 12:12:23
8866,877,2,598,77,675,8772,2021-01-30 23:46:13
8867,593,4,1557,202,1759,8773,2021-01-31 04:50:22
8868,625,3,727,94,821,8774,2021-01-30 14:37:48
8869,374,3,647,84,731,8775,2021-01-30 06:46:34
8870,633,2,548,71,619,8776,2021-01-29 03:32:22
8871,292,3,1127,146,1273,8777,2021-01-29 20:47:48
8872,550,2,498,64,562,8778,2021-01-30 01:20:45
8873,690,3,1127,146,1273,8779,2021-01-29 16:42:53
8874,16,2,798,103,901,8780,2021-01-29 10:04:36
8875,263,5,1645,213,1858,8781,2021-01-29 04:38:04
8876,607,3,747,97,844,8782,2021-01-29 12:33:40
8877,874,3,608,79,687,8783,2021-01-29 15:51:00
8878,370,3,528,68,596,8784,2021-01-29 14:24:20
8879,861,5,1245,161,1406,8785,2021-01-29 11:39:16
8880,696,3,528,68,596,8786,2021-01-29 22:01:30
8881,893,3,808,105,913,8787,2021-01-29 21:48:19
8882,444,2,598,77,675,8788,2021-01-30 02:09:20
8883,84,2,898,116,1014,8789,2021-01-30 01:42:04
8884,424,5,1576,204,1780,8790,2021-01-30 09:44:05
8885,824,2,659,85,744,8791,2021-01-29 21:50:48
8886,901,5,1256,163,1419,8792,2021-01-29 17:12:30
8887,705,2,398,51,449,8793,2021-01-29 17:33:06
8888,967,2,329,42,371,8794,2021-01-30 06:30:16
8889,731,3,797,103,900,8795,2021-01-30 00:33:31
8890,198,1,599,77,676,8796,2021-01-29 20:05:26
8891,748,3,697,90,787,8797,2021-01-29 10:51:52
8892,958,1,399,51,450,8798,2021-01-29 21:06:20
8893,467,3,888,115,1003,8799,2021-01-30 06:16:57
8894,822,3,697,90,787,8800,2021-01-30 01:47:42
8895,504,3,1127,146,1273,8801,2021-01-29 17:08:05
8896,913,3,888,115,1003,8802,2021-01-30 02:35:50
8897,711,2,1098,142,1240,8803,2021-01-30 04:49:28
8898,596,2,459,59,518,8804,2021-01-30 09:38:21
8899,497,3,888,115,1003,8805,2021-01-30 08:45:56
8900,641,4,826,107,933,8806,2021-01-29 08:10:18
8901,563,3,1127,146,1273,8807,2021-01-29 09:27:54
8902,944,3,558,72,630,8808,2021-01-28 23:11:57
8903,911,6,2054,267,2321,8809,2021-01-29 00:21:56
8904,965,3,847,110,957,8810,2021-01-30 00:49:33
8905,853,2,659,85,744,8811,2021-01-29 23:59:24
8906,396,2,828,107,935,8812,2021-01-30 02:52:36
8907,198,2,398,51,449,8813,2021-01-30 04:32:54
8908,357,1,229,29,258,8814,2021-01-29 23:41:50
8909,717,3,827,107,934,8815,2021-01-30 02:57:37
8910,331,3,997,129,1126,8816,2021-01-29 11:18:38
8911,341,3,797,103,900,8817,2021-01-29 02:27:13
8912,840,2,329,42,371,8818,2021-01-28 17:03:48
8913,428,3,997,129,1126,8819,2021-01-29 06:55:42
8914,227,3,697,90,787,8820,2021-01-28 19:30:49
8915,684,2,659,85,744,8821,2021-01-29 01:43:20
8916,826,2,628,81,709,8822,2021-01-28 18:05:44
8917,105,6,1774,230,2004,8823,2021-01-28 18:22:14
8918,26,3,997,129,1126,8824,2021-01-29 12:39:34
8919,46,3,797,103,900,8825,2021-01-29 08:37:16
8920,695,4,1246,161,1407,8826,2021-01-29 01:07:35
8921,458,4,1057,137,1194,8827,2021-01-28 22:26:25
8922,137,3,888,115,1003,8828,2021-01-29 10:16:47
8923,861,3,1327,172,1499,8829,2021-01-29 15:33:45
8924,105,6,1855,241,2096,8830,2021-01-29 21:47:53
8925,187,3,747,97,844,8831,2021-01-30 00:43:20
8926,447,3,1047,136,1183,8832,2021-01-29 11:06:38
8927,437,3,1327,172,1499,8833,2021-01-29 14:45:34
8928,233,3,888,115,1003,8834,2021-01-28 23:30:06
8929,575,3,1027,133,1160,8835,2021-01-28 18:25:41
8930,801,2,329,42,371,8836,2021-01-29 07:51:31
8931,916,3,697,90,787,8837,2021-01-29 06:28:02
8932,802,2,798,103,901,8838,2021-01-29 05:38:57
8933,845,2,898,116,1014,8839,2021-01-29 07:32:04
8934,254,3,727,94,821,8840,2021-01-30 14:43:15
8935,990,3,747,97,844,8841,2021-01-30 12:52:13
8936,505,3,1197,155,1352,8842,2021-01-30 12:21:49
8937,818,4,1526,198,1724,8843,2021-01-30 12:56:37
8938,323,3,897,116,1013,8844,2021-01-30 15:06:07
8939,296,6,1705,221,1926,8845,2021-01-30 14:33:31
8940,783,6,1336,173,1509,8846,2021-01-30 11:17:04
8941,536,2,659,85,744,8847,2021-01-30 00:35:50
8942,779,2,898,116,1014,8848,2021-01-30 02:28:12
8943,560,3,747,97,844,8849,2021-01-29 21:46:59
8944,549,2,459,59,518,8850,2021-01-29 16:45:51
8945,4,3,888,115,1003,8851,2021-01-29 16:09:06
8946,242,3,827,107,934,8852,2021-01-29 17:18:47
8947,84,5,1595,207,1802,8853,2021-01-29 21:19:50
8948,114,3,697,90,787,8854,2021-01-30 07:05:08
8949,988,3,888,115,1003,8855,2021-01-30 15:44:22
8950,120,4,1596,207,1803,8856,2021-01-30 20:44:07
8951,618,3,897,116,1013,8857,2021-01-30 02:06:15
8952,816,2,598,77,675,8858,2021-01-30 02:15:15
8953,215,3,827,107,934,8859,2021-01-30 21:38:10
8954,550,3,1197,155,1352,8860,2021-01-30 18:43:21
8955,204,3,608,79,687,8861,2021-01-31 00:06:30
8956,164,3,888,115,1003,8862,2021-01-30 22:24:09
8957,233,5,1676,217,1893,8863,2021-01-30 07:35:58
8958,465,5,1376,178,1554,8864,2021-01-30 15:26:07
8959,969,2,429,55,484,8865,2021-01-30 21:01:50
8960,192,3,997,129,1126,8866,2021-01-30 21:43:37
8961,181,3,1047,136,1183,8867,2021-01-30 14:12:51
8962,133,4,1126,146,1272,8868,2021-01-31 01:28:21
8963,803,3,688,89,777,8869,2021-01-31 05:36:48
8964,746,3,428,55,483,8870,2021-01-30 16:04:53
8965,784,3,697,90,787,8871,2021-01-30 07:39:55
8966,83,2,1098,142,1240,8872,2021-01-29 05:52:01
8967,62,3,578,75,653,8873,2021-01-29 20:56:04
8968,855,3,827,107,934,8874,2021-01-30 03:16:52
8969,516,3,827,107,934,8875,2021-01-29 18:19:55
8970,401,3,528,68,596,8876,2021-01-29 10:10:46
8971,626,3,658,85,743,8877,2021-01-29 05:20:53
8972,20,2,598,77,675,8878,2021-01-29 13:58:43
8973,170,4,957,124,1081,8879,2021-01-29 16:42:11
8974,947,3,1127,146,1273,8880,2021-01-29 15:09:32
8975,451,3,478,62,540,8881,2021-01-29 14:14:53
8976,98,3,558,72,630,8882,2021-01-30 00:04:46
8977,321,3,758,98,856,8883,2021-01-29 21:55:16
8978,712,3,1127,146,1273,8884,2021-01-30 03:13:54
8979,681,2,698,90,788,8885,2021-01-30 03:43:09
8980,537,3,1047,136,1183,8886,2021-01-30 09:51:18
8981,61,3,847,110,957,8887,2021-01-29 22:05:35
8982,445,2,1098,142,1240,8888,2021-01-29 18:41:10
8983,800,3,927,120,1047,8889,2021-01-29 19:51:05
8984,876,2,898,116,1014,8890,2021-01-30 08:45:18
8985,672,2,698,90,788,8891,2021-01-30 00:52:41
8986,265,2,698,90,788,8892,2021-01-29 20:18:39
8987,270,3,827,107,934,8893,2021-01-29 12:20:47
8988,550,3,1197,155,1352,8894,2021-01-29 21:09:41
8989,606,3,597,77,674,8895,2021-01-30 08:56:48
8990,177,3,688,89,777,8896,2021-01-30 03:13:15
8991,293,3,997,129,1126,8897,2021-01-29 18:51:22
8992,928,2,698,90,788,8898,2021-01-30 02:39:46
8993,276,1,229,29,258,8899,2021-01-30 06:57:20
8994,636,2,548,71,619,8900,2021-01-30 12:23:10
8995,7,5,1645,213,1858,8901,2021-01-30 09:01:56
8996,611,3,1197,155,1352,8902,2021-01-29 10:15:25
8997,286,4,1077,140,1217,8903,2021-01-29 09:47:12
8998,719,3,697,90,787,8904,2021-01-28 23:20:37
8999,805,2,898,116,1014,8905,2021-01-29 01:59:29
9000,155,2,1098,142,1240,8906,2021-01-30 02:09:15
9001,331,3,758,98,856,8907,2021-01-30 00:32:52
9002,456,3,428,55,483,8908,2021-01-30 03:53:43
9003,744,3,528,68,596,8909,2021-01-30 05:33:10
9004,678,3,608,79,687,8910,2021-01-29 23:53:31
9005,660,3,478,62,540,8911,2021-01-30 03:13:45
9006,395,3,697,90,787,8912,2021-01-29 13:53:02
9007,585,2,898,116,1014,8913,2021-01-29 03:11:51
9008,728,2,928,120,1048,8914,2021-01-28 17:35:58
9009,720,1,499,64,563,8915,2021-01-29 08:33:34
9010,524,3,697,90,787,8916,2021-01-28 21:58:55
9011,785,6,1674,217,1891,8917,2021-01-29 03:13:58
9012,93,2,898,116,1014,8918,2021-01-28 19:15:13
9013,773,3,1127,146,1273,8919,2021-01-28 18:52:49
9014,112,3,997,129,1126,8920,2021-01-29 13:45:57
9015,499,5,1056,137,1193,8921,2021-01-29 09:57:24
9016,328,3,478,62,540,8922,2021-01-29 01:18:47
9017,653,1,599,77,676,8923,2021-01-29 00:54:06
9018,800,3,758,98,856,8924,2021-01-29 12:37:53
9019,712,3,1127,146,1273,8925,2021-01-29 15:51:26
9020,41,2,429,55,484,8926,2021-01-29 21:59:54
9021,309,4,1096,142,1238,8927,2021-01-30 02:24:43
9022,685,2,928,120,1048,8928,2021-01-29 11:43:45
9023,132,2,798,103,901,8929,2021-01-29 16:50:09
9024,221,3,827,107,934,8930,2021-01-29 01:07:02
9025,988,3,997,129,1126,8931,2021-01-28 19:33:34
9026,925,3,997,129,1126,8932,2021-01-29 10:02:33
9027,220,2,498,64,562,8933,2021-01-29 06:45:34
9028,28,2,798,103,901,8934,2021-01-29 06:16:30
9029,697,3,1047,136,1183,8935,2021-01-29 08:08:49
9030,806,3,1197,155,1352,8936,2021-01-30 15:54:11
9031,506,3,528,68,596,8937,2021-01-30 14:13:15
9032,480,2,798,103,901,8938,2021-01-30 13:10:00
9033,490,2,598,77,675,8939,2021-01-30 13:27:41
9034,572,3,608,79,687,8940,2021-01-30 16:52:57
9035,669,3,1327,172,1499,8941,2021-01-30 15:15:09
9036,569,2,898,116,1014,8942,2021-01-30 13:51:04
9037,763,3,558,72,630,8943,2021-01-30 03:01:27
9038,162,6,1744,226,1970,8944,2021-01-30 04:47:13
9039,884,2,1098,142,1240,8945,2021-01-30 00:11:16
9040,990,5,1156,150,1306,8946,2021-01-29 16:58:13
9041,448,3,747,97,844,8947,2021-01-29 18:19:33
9042,851,2,598,77,675,8948,2021-01-29 17:51:02
9043,571,3,558,72,630,8949,2021-01-29 23:29:33
9044,848,5,1556,202,1758,8950,2021-01-30 07:05:55
9045,933,3,528,68,596,8951,2021-01-30 18:01:30
9046,236,2,429,55,484,8952,2021-01-30 22:06:22
9047,158,2,628,81,709,8953,2021-01-30 03:21:46
9048,564,3,808,105,913,8954,2021-01-30 04:49:41
9049,96,3,847,110,957,8955,2021-01-30 22:25:45
9050,694,2,429,55,484,8956,2021-01-30 19:05:21
9051,849,3,647,84,731,8957,2021-01-31 00:53:16
9052,228,3,888,115,1003,8958,2021-01-30 22:32:35
9053,776,3,947,123,1070,8959,2021-01-30 08:25:03
9054,636,2,898,116,1014,8960,2021-01-30 16:39:51
9055,546,4,1207,156,1363,8961,2021-01-30 21:44:43
9056,629,4,1126,146,1272,8962,2021-01-30 23:26:54
9057,471,1,699,90,789,8963,2021-01-30 16:55:44
9058,31,2,459,59,518,8964,2021-01-31 02:16:41
9059,937,6,1674,217,1891,8965,2021-01-31 06:03:10
9060,724,6,1444,187,1631,8966,2021-01-30 16:57:31
9061,624,2,698,90,788,8967,2021-01-30 08:46:36
9062,70,2,1098,142,1240,8968,2021-01-29 07:17:20
9063,226,2,498,64,562,8969,2021-01-29 22:39:26
9064,875,3,558,72,630,8970,2021-01-30 04:36:08
9065,563,6,2085,271,2356,8971,2021-01-29 20:31:14
9066,599,2,1098,142,1240,8972,2021-01-29 12:32:22
9067,66,3,1127,146,1273,8973,2021-01-29 05:37:46
9068,242,3,997,129,1126,8974,2021-01-29 16:26:08
9069,189,5,1386,180,1566,8975,2021-01-29 17:16:55
9070,643,2,698,90,788,8976,2021-01-29 16:56:51
9071,713,3,528,68,596,8977,2021-01-29 16:03:06
9072,103,2,898,116,1014,8978,2021-01-30 02:11:21
9073,893,6,1316,171,1487,8979,2021-01-29 22:52:01
9074,902,3,578,75,653,8980,2021-01-30 04:34:47
9075,111,3,997,129,1126,8981,2021-01-30 04:33:29
9076,225,2,798,103,901,8982,2021-01-30 09:55:14
9077,707,3,658,85,743,8983,2021-01-29 22:30:46
9078,173,3,827,107,934,8984,2021-01-29 20:34:37
9079,914,1,499,64,563,8985,2021-01-29 21:21:43
9080,329,3,558,72,630,8986,2021-01-30 08:46:51
9081,249,2,1098,142,1240,8987,2021-01-30 01:01:43
9082,40,3,808,105,913,8988,2021-01-29 21:42:44
9083,251,6,1535,199,1734,8989,2021-01-29 13:26:50
9084,355,3,597,77,674,8990,2021-01-29 23:08:58
9085,507,3,528,68,596,8991,2021-01-30 10:53:23
9086,506,2,898,116,1014,8992,2021-01-30 05:14:23
9087,532,3,578,75,653,8993,2021-01-29 20:37:00
9088,855,2,398,51,449,8994,2021-01-30 03:49:07
9089,25,5,1545,200,1745,8995,2021-01-30 07:28:35
9090,763,2,798,103,901,8996,2021-01-30 13:57:02
9091,680,1,599,77,676,8997,2021-01-30 10:33:02
9092,843,3,927,120,1047,8998,2021-01-29 11:23:50
9093,776,3,558,72,630,8999,2021-01-29 12:22:43
9094,203,4,1027,133,1160,9000,2021-01-29 01:50:39
9095,476,3,927,120,1047,9001,2021-01-29 02:52:47
9096,767,3,1247,162,1409,9002,2021-01-30 04:26:42
9097,654,3,747,97,844,9003,2021-01-30 02:51:29
9098,873,3,747,97,844,9004,2021-01-30 05:32:09
9099,797,3,597,77,674,9005,2021-01-30 05:46:58
9100,493,2,698,90,788,9006,2021-01-30 01:04:53
9101,290,2,798,103,901,9007,2021-01-30 04:37:20
9102,612,3,478,62,540,9008,2021-01-29 16:37:33
9103,585,2,898,116,1014,9009,2021-01-29 05:04:54
9104,986,3,697,90,787,9010,2021-01-28 18:31:16
9105,6,2,548,71,619,9011,2021-01-29 09:28:43
9106,126,3,1327,172,1499,9012,2021-01-29 00:45:06
9107,870,2,1098,142,1240,9013,2021-01-29 05:16:30
9108,741,3,558,72,630,9014,2021-01-28 21:29:38
9109,189,3,478,62,540,9015,2021-01-28 19:58:19
9110,756,1,399,51,450,9016,2021-01-29 15:30:10
9111,309,3,558,72,630,9017,2021-01-29 11:16:49
9112,807,2,898,116,1014,9018,2021-01-29 04:00:26
9113,781,3,827,107,934,9019,2021-01-29 02:24:39
9114,140,5,1575,204,1779,9020,2021-01-29 14:15:43
9115,7,3,558,72,630,9021,2021-01-29 17:13:51
9116,32,2,598,77,675,9022,2021-01-29 22:35:49
9117,616,4,1096,142,1238,9023,2021-01-30 04:22:19
9118,438,3,428,55,483,9024,2021-01-29 11:45:18
9119,144,2,498,64,562,9025,2021-01-29 17:11:13
9120,695,2,898,116,1014,9026,2021-01-29 02:19:14
9121,274,2,598,77,675,9027,2021-01-28 22:05:56
9122,547,5,1775,230,2005,9028,2021-01-29 10:41:22
9123,131,3,597,77,674,9029,2021-01-29 08:36:36
9124,815,2,898,116,1014,9030,2021-01-29 08:17:15
9125,432,2,329,42,371,9031,2021-01-29 09:15:17
9126,584,1,599,77,676,9032,2021-01-30 16:05:38
9127,819,2,598,77,675,9033,2021-01-30 15:30:31
9128,326,5,1456,189,1645,9034,2021-01-30 13:46:49
9129,51,3,747,97,844,9035,2021-01-30 15:58:34
9130,161,3,1027,133,1160,9036,2021-01-30 18:52:25
9131,645,3,1327,172,1499,9037,2021-01-30 15:52:16
9132,219,2,798,103,901,9038,2021-01-30 15:54:57
9133,122,2,748,97,845,9039,2021-01-30 04:28:36
9134,223,5,926,120,1046,9040,2021-01-30 07:23:44
9135,95,2,1098,142,1240,9041,2021-01-30 01:46:09
9136,960,2,498,64,562,9042,2021-01-29 16:59:15
9137,722,3,688,89,777,9043,2021-01-29 20:49:42
9138,13,3,827,107,934,9044,2021-01-29 18:27:05
9139,241,1,299,38,337,9045,2021-01-30 01:15:23
9140,555,2,598,77,675,9046,2021-01-30 07:35:40
9141,297,5,1547,201,1748,9047,2021-01-30 18:30:53
9142,732,2,598,77,675,9048,2021-01-31 00:08:01
9143,305,3,747,97,844,9049,2021-01-30 05:06:24
9144,526,3,528,68,596,9050,2021-01-30 04:58:07
9145,557,3,747,97,844,9051,2021-01-30 23:06:15
9146,196,2,628,81,709,9052,2021-01-30 19:17:28
9147,51,3,597,77,674,9053,2021-01-31 01:52:24
9148,683,3,608,79,687,9054,2021-01-30 22:40:52
9149,602,5,1406,182,1588,9055,2021-01-30 08:59:47
9150,94,2,898,116,1014,9056,2021-01-30 19:02:23
9151,77,2,698,90,788,9057,2021-01-30 23:44:05
9152,689,2,398,51,449,9058,2021-01-31 00:32:17
9153,236,2,898,116,1014,9059,2021-01-30 18:13:19
9154,986,6,1255,163,1418,9060,2021-01-31 02:31:23
9155,911,3,888,115,1003,9061,2021-01-31 08:22:54
9156,224,3,1197,155,1352,9062,2021-01-30 18:28:19
9157,754,3,727,94,821,9063,2021-01-30 11:10:34
9158,209,2,1098,142,1240,9064,2021-01-29 09:43:57
9159,883,3,1127,146,1273,9065,2021-01-29 22:47:49
9160,638,1,99,12,111,9066,2021-01-30 05:17:58
9161,336,2,429,55,484,9067,2021-01-29 22:34:31
9162,899,2,798,103,901,9068,2021-01-29 14:13:13
9163,910,2,429,55,484,9069,2021-01-29 08:09:24
9164,867,5,1026,133,1159,9070,2021-01-29 18:09:55
9165,427,3,997,129,1126,9071,2021-01-29 18:30:21
9166,91,2,498,64,562,9072,2021-01-29 17:48:07
9167,68,2,548,71,619,9073,2021-01-29 18:23:53
9168,903,3,888,115,1003,9074,2021-01-30 03:35:24
9169,34,3,478,62,540,9075,2021-01-30 01:10:38
9170,522,2,628,81,709,9076,2021-01-30 05:40:21
9171,784,2,698,90,788,9077,2021-01-30 06:48:34
9172,973,3,947,123,1070,9078,2021-01-30 11:28:21
9173,253,2,429,55,484,9079,2021-01-29 22:58:16
9174,961,3,697,90,787,9080,2021-01-29 22:29:02
9175,754,3,597,77,674,9081,2021-01-29 22:55:36
9176,144,3,747,97,844,9082,2021-01-30 10:00:08
9177,918,3,897,116,1013,9083,2021-01-30 03:19:40
9178,356,3,1247,162,1409,9084,2021-01-29 22:09:59
9179,800,3,727,94,821,9085,2021-01-29 14:24:34
9180,589,3,847,110,957,9086,2021-01-30 01:30:48
9181,982,2,1098,142,1240,9087,2021-01-30 12:40:09
9182,698,3,528,68,596,9088,2021-01-30 06:13:39
9183,458,2,628,81,709,9089,2021-01-29 22:05:20
9184,950,3,997,129,1126,9090,2021-01-30 04:33:32
9185,571,3,597,77,674,9091,2021-01-30 07:52:03
9186,886,3,428,55,483,9092,2021-01-30 15:09:51
9187,660,2,798,103,901,9093,2021-01-30 13:09:25
9188,574,3,478,62,540,9094,2021-01-29 12:13:03
9189,55,5,1306,169,1475,9095,2021-01-29 12:29:54
9190,415,5,1345,174,1519,9096,2021-01-29 03:16:33
9191,518,3,428,55,483,9097,2021-01-29 03:48:49
9192,221,5,1606,208,1814,9098,2021-01-30 05:54:50
9193,618,2,598,77,675,9099,2021-01-30 05:21:23
9194,945,3,428,55,483,9100,2021-01-30 05:56:56
9195,610,3,747,97,844,9101,2021-01-30 06:33:46
9196,122,5,1486,193,1679,9102,2021-01-30 02:28:11
9197,571,3,1197,155,1352,9103,2021-01-30 05:09:21
9198,600,3,658,85,743,9104,2021-01-29 17:31:02
9199,775,3,1247,162,1409,9105,2021-01-29 06:40:17
9200,335,3,478,62,540,9106,2021-01-28 19:39:49
9201,561,3,897,116,1013,9107,2021-01-29 11:37:35
9202,93,4,1646,213,1859,9108,2021-01-29 01:46:50
9203,123,3,1127,146,1273,9109,2021-01-29 06:24:19
9204,869,3,608,79,687,9110,2021-01-28 22:38:55
9205,160,3,1197,155,1352,9111,2021-01-28 21:41:53
9206,226,3,608,79,687,9112,2021-01-29 17:59:43
9207,382,3,697,90,787,9113,2021-01-29 13:17:42
9208,31,5,2145,278,2423,9114,2021-01-29 04:03:39
9209,306,2,429,55,484,9115,2021-01-29 03:02:10
9210,578,5,1395,181,1576,9116,2021-01-29 15:00:10
9211,825,6,1635,212,1847,9117,2021-01-29 19:19:52
9212,636,3,647,84,731,9118,2021-01-30 00:19:44
9213,724,3,597,77,674,9119,2021-01-30 05:19:04
9214,702,4,977,127,1104,9120,2021-01-29 12:07:01
9215,838,5,1495,194,1689,9121,2021-01-29 17:20:11
9216,50,3,597,77,674,9122,2021-01-29 04:03:59
9217,585,3,758,98,856,9123,2021-01-28 22:25:33
9218,671,3,1197,155,1352,9124,2021-01-29 13:19:21
9219,101,3,697,90,787,9125,2021-01-29 08:37:12
9220,758,5,1995,259,2254,9126,2021-01-29 09:07:51
9221,983,5,1506,195,1701,9127,2021-01-29 11:55:20
9222,503,2,659,85,744,9128,2021-01-30 17:46:19
9223,51,2,329,42,371,9129,2021-01-30 18:05:37
9224,948,3,1197,155,1352,9130,2021-01-30 15:09:34
9225,511,3,558,72,630,9131,2021-01-30 17:00:01
9226,649,3,758,98,856,9132,2021-01-30 19:09:53
9227,690,3,478,62,540,9133,2021-01-30 16:45:50
9228,946,3,647,84,731,9134,2021-01-30 16:55:23
9229,946,3,647,84,731,9134,2021-01-30 16:55:23
9230,891,2,429,55,484,9135,2021-01-30 06:23:43
9231,416,4,1526,198,1724,9136,2021-01-30 08:44:07
9232,270,4,1046,135,1181,9137,2021-01-30 03:22:07
9233,91,3,827,107,934,9138,2021-01-29 17:53:43
9234,663,2,898,116,1014,9139,2021-01-29 21:39:53
9235,633,2,598,77,675,9140,2021-01-29 19:09:01
9236,793,3,1127,146,1273,9141,2021-01-30 03:58:13
9237,360,5,1495,194,1689,9142,2021-01-30 09:20:16
9238,288,3,758,98,856,9143,2021-01-30 20:32:24
9239,791,3,1047,136,1183,9144,2021-01-31 02:43:57
9240,552,2,698,90,788,9145,2021-01-30 07:44:20
9241,391,2,798,103,901,9146,2021-01-30 06:38:52
9242,300,3,1247,162,1409,9147,2021-01-31 00:07:07
9243,90,2,429,55,484,9148,2021-01-30 19:24:16
9244,938,2,329,42,371,9149,2021-01-31 02:05:14
9245,795,5,1076,139,1215,9150,2021-01-31 01:15:50
9246,128,3,697,90,787,9151,2021-01-30 10:55:34
9247,457,3,847,110,957,9152,2021-01-30 19:57:53
9248,259,2,798,103,901,9153,2021-01-31 01:02:47
9249,674,3,897,116,1013,9154,2021-01-31 02:05:37
9250,566,3,608,79,687,9155,2021-01-30 19:15:32
9251,100,3,1327,172,1499,9156,2021-01-31 02:52:58
9252,622,2,329,42,371,9157,2021-01-31 10:46:16
9253,97,4,1046,135,1181,9158,2021-01-30 21:08:07
9254,405,3,558,72,630,9159,2021-01-30 13:30:39
9255,566,5,1345,174,1519,9160,2021-01-29 10:43:21
9256,736,2,329,42,371,9161,2021-01-30 00:31:41
9257,167,3,1247,162,1409,9162,2021-01-30 06:52:44
9258,337,4,1077,140,1217,9163,2021-01-30 01:12:11
9259,885,3,797,103,900,9164,2021-01-29 16:44:57
9260,480,3,797,103,900,9165,2021-01-29 08:58:25
9261,261,3,558,72,630,9166,2021-01-29 19:27:30
9262,116,2,429,55,484,9167,2021-01-29 21:13:19
9263,409,3,697,90,787,9168,2021-01-29 19:45:49
9264,345,3,478,62,540,9169,2021-01-29 18:35:20
9265,508,4,827,107,934,9170,2021-01-30 05:10:44
9266,936,1,229,29,258,9171,2021-01-30 03:56:41
9267,411,3,688,89,777,9172,2021-01-30 08:03:48
9268,398,3,428,55,483,9173,2021-01-30 08:38:31
9269,839,5,1076,139,1215,9174,2021-01-30 13:37:37
9270,17,5,1845,239,2084,9175,2021-01-29 23:49:08
9271,224,5,1326,172,1498,9176,2021-01-30 00:22:47
9272,789,4,1057,137,1194,9177,2021-01-30 00:06:29
9273,219,3,747,97,844,9178,2021-01-30 10:55:51
9274,577,2,898,116,1014,9179,2021-01-30 05:27:28
9275,494,5,1556,202,1758,9180,2021-01-29 22:21:49
9276,830,3,1047,136,1183,9181,2021-01-29 15:12:14
9277,958,3,808,105,913,9182,2021-01-30 03:15:29
9278,852,3,997,129,1126,9183,2021-01-30 13:34:53
9279,765,3,697,90,787,9184,2021-01-30 08:32:49
9280,682,3,688,89,777,9185,2021-01-29 23:03:10
9281,903,3,558,72,630,9186,2021-01-30 05:55:08
9282,210,2,698,90,788,9187,2021-01-30 10:31:22
9283,377,2,748,97,845,9188,2021-01-30 15:53:55
9284,984,3,697,90,787,9189,2021-01-30 15:43:47
9285,203,1,499,64,563,9190,2021-01-29 13:09:35
9286,253,6,2444,317,2761,9191,2021-01-29 12:32:18
9287,913,3,597,77,674,9192,2021-01-29 04:27:29
9288,727,3,1247,162,1409,9193,2021-01-29 04:41:09
9289,900,5,1245,161,1406,9194,2021-01-30 07:18:51
9290,9,2,898,116,1014,9195,2021-01-30 07:28:52
9291,362,3,697,90,787,9196,2021-01-30 06:41:42
9292,302,1,299,38,337,9197,2021-01-30 08:13:08
9293,854,3,697,90,787,9198,2021-01-30 03:51:18
9294,767,4,1646,213,1859,9199,2021-01-30 06:49:43
9295,670,2,498,64,562,9200,2021-01-29 19:35:49
9296,687,2,898,116,1014,9201,2021-01-29 07:31:07
9297,879,6,2274,295,2569,9202,2021-01-28 22:02:40
9298,354,3,478,62,540,9203,2021-01-29 12:47:26
9299,965,3,697,90,787,9204,2021-01-29 02:14:13
9300,696,3,528,68,596,9205,2021-01-29 06:51:06
9301,778,2,398,51,449,9206,2021-01-28 23:36:12
9302,599,3,528,68,596,9207,2021-01-28 23:48:22
9303,502,3,558,72,630,9208,2021-01-29 20:43:48
9304,315,3,1127,146,1273,9209,2021-01-29 13:58:16
9305,446,3,558,72,630,9210,2021-01-29 05:55:04
9306,674,3,927,120,1047,9211,2021-01-29 03:22:49
9307,803,3,758,98,856,9212,2021-01-29 16:24:08
9308,668,5,2295,298,2593,9213,2021-01-29 20:38:42
9309,785,2,498,64,562,9214,2021-01-30 00:44:02
9310,386,3,997,129,1126,9215,2021-01-30 06:31:23
9311,783,2,898,116,1014,9216,2021-01-29 13:14:27
9312,435,3,1047,136,1183,9217,2021-01-29 20:00:22
9313,200,5,1845,239,2084,9218,2021-01-29 05:01:00
9314,430,3,558,72,630,9219,2021-01-29 00:28:39
9315,695,3,808,105,913,9220,2021-01-29 13:28:20
9316,974,3,888,115,1003,9221,2021-01-29 08:49:10
9317,487,1,599,77,676,9222,2021-01-29 11:07:14
9318,1000,3,658,85,743,9223,2021-01-29 12:12:54
9319,531,3,997,129,1126,9224,2021-01-30 18:16:24
9320,804,3,578,75,653,9225,2021-01-30 18:07:53
9321,105,4,1296,168,1464,9226,2021-01-30 16:41:21
9322,386,3,528,68,596,9227,2021-01-30 17:15:14
9323,283,1,229,29,258,9228,2021-01-30 21:25:34
9324,547,2,848,110,958,9229,2021-01-30 17:34:40
9325,853,3,647,84,731,9230,2021-01-30 17:34:25
9326,806,2,429,55,484,9231,2021-01-30 18:49:56
9327,237,6,1605,208,1813,9232,2021-01-30 07:00:45
9328,784,2,498,64,562,9233,2021-01-30 10:18:03
9329,410,2,898,116,1014,9234,2021-01-30 05:45:07
9330,578,2,798,103,901,9235,2021-01-29 19:46:43
9331,593,2,1098,142,1240,9236,2021-01-29 22:47:22
9332,260,3,697,90,787,9237,2021-01-29 19:21:47
9333,751,2,329,42,371,9238,2021-01-30 05:12:32
9334,260,3,847,110,957,9239,2021-01-30 10:40:06
9335,59,2,329,42,371,9240,2021-01-30 20:34:24
9336,756,3,1047,136,1183,9241,2021-01-31 03:38:06
9337,196,3,808,105,913,9242,2021-01-30 08:12:13
9338,941,3,647,84,731,9243,2021-01-30 08:35:16
9339,363,3,688,89,777,9244,2021-01-31 01:24:10
9340,158,2,429,55,484,9245,2021-01-30 21:56:31
9341,427,3,1047,136,1183,9246,2021-01-31 02:26:33
9342,850,3,608,79,687,9247,2021-01-31 01:34:31
9343,655,2,429,55,484,9248,2021-01-30 11:40:53
9344,655,2,429,55,484,9248,2021-01-30 11:40:53
9345,228,3,688,89,777,9249,2021-01-30 22:41:03
9346,976,3,1127,146,1273,9250,2021-01-31 01:53:23
9347,149,3,897,116,1013,9251,2021-01-31 02:38:30
9348,545,5,1925,250,2175,9252,2021-01-30 21:25:02
9349,797,3,697,90,787,9253,2021-01-31 05:19:52
9350,425,2,798,103,901,9254,2021-01-31 12:23:20
9351,268,2,898,116,1014,9255,2021-01-30 22:16:48
9352,484,3,558,72,630,9256,2021-01-30 15:35:21
9353,171,3,1197,155,1352,9257,2021-01-29 12:11:26
9354,955,2,598,77,675,9258,2021-01-30 02:12:51
9355,545,2,598,77,675,9259,2021-01-30 09:10:48
9356,271,3,658,85,743,9260,2021-01-30 02:00:05
9357,318,2,798,103,901,9261,2021-01-29 16:57:51
9358,719,3,827,107,934,9262,2021-01-29 10:31:44
9359,16,3,697,90,787,9263,2021-01-29 20:50:02
9360,658,3,847,110,957,9264,2021-01-29 22:19:01
9361,962,3,608,79,687,9265,2021-01-29 21:14:16
9362,107,3,758,98,856,9266,2021-01-29 19:19:09
9363,377,2,828,107,935,9267,2021-01-30 07:08:36
9364,977,2,659,85,744,9268,2021-01-30 06:08:17
9365,332,2,548,71,619,9269,2021-01-30 10:06:52
9366,494,3,727,94,821,9270,2021-01-30 10:26:47
9367,108,2,459,59,518,9271,2021-01-30 16:16:01
9368,586,3,528,68,596,9272,2021-01-30 01:54:08
9369,657,3,558,72,630,9273,2021-01-30 00:24:42
9370,346,3,1127,146,1273,9274,2021-01-30 01:08:56
9371,65,6,1685,219,1904,9275,2021-01-30 11:55:06
9372,616,3,1247,162,1409,9276,2021-01-30 05:41:33
9373,102,5,2145,278,2423,9277,2021-01-30 00:40:20
9374,916,2,329,42,371,9278,2021-01-29 17:42:56
9375,933,3,558,72,630,9279,2021-01-30 04:12:51
9376,101,2,898,116,1014,9280,2021-01-30 13:55:58
9377,775,4,1926,250,2176,9281,2021-01-30 08:38:52
9378,911,5,1756,228,1984,9282,2021-01-30 00:19:41
9379,880,2,659,85,744,9283,2021-01-30 06:09:55
9380,748,2,898,116,1014,9284,2021-01-30 11:05:44
9381,626,2,798,103,901,9285,2021-01-30 16:27:13
9382,940,5,1325,172,1497,9286,2021-01-30 17:47:49
9383,103,5,1545,200,1745,9287,2021-01-29 13:55:19
9384,387,3,1047,136,1183,9288,2021-01-29 14:12:55
9385,451,2,329,42,371,9289,2021-01-29 06:16:33
9386,398,2,898,116,1014,9290,2021-01-29 06:29:03
9387,785,5,1706,221,1927,9291,2021-01-30 09:35:00
9388,434,1,99,12,111,9292,2021-01-30 07:53:28
9389,674,3,1047,136,1183,9293,2021-01-30 08:54:38
9390,471,2,698,90,788,9294,2021-01-30 08:48:02
9391,396,3,758,98,856,9295,2021-01-30 04:52:09
9392,36,3,888,115,1003,9296,2021-01-30 09:34:05
9393,873,5,1575,204,1779,9297,2021-01-29 20:21:33
9394,323,5,1195,155,1350,9298,2021-01-29 08:58:10
9395,939,2,429,55,484,9299,2021-01-29 00:26:10
9396,52,5,1056,137,1193,9300,2021-01-29 14:26:00
9397,708,3,827,107,934,9301,2021-01-29 02:29:27
9398,507,2,898,116,1014,9302,2021-01-29 09:23:32
9399,972,5,1786,232,2018,9303,2021-01-29 01:11:25
9400,764,3,897,116,1013,9304,2021-01-29 01:12:39
9401,736,3,1047,136,1183,9305,2021-01-29 21:19:21
9402,364,3,558,72,630,9306,2021-01-29 14:52:36
9403,236,2,659,85,744,9307,2021-01-29 07:09:05
9404,953,3,927,120,1047,9308,2021-01-29 04:57:23
9405,474,2,748,97,845,9309,2021-01-29 17:17:19
9406,349,3,428,55,483,9310,2021-01-29 23:08:14
9407,430,3,747,97,844,9311,2021-01-30 00:47:04
9408,992,3,608,79,687,9312,2021-01-30 09:13:30
9409,984,3,827,107,934,9313,2021-01-29 15:45:59
9410,513,1,599,77,676,9314,2021-01-29 22:02:47
9411,136,3,1047,136,1183,9315,2021-01-29 06:32:46
9412,537,2,498,64,562,9316,2021-01-29 01:53:04
9413,990,3,688,89,777,9317,2021-01-29 15:10:57
9414,951,5,1425,185,1610,9318,2021-01-29 11:30:04
9415,372,6,2374,308,2682,9319,2021-01-29 12:19:50
9416,805,3,827,107,934,9320,2021-01-29 13:41:28
9417,667,3,1047,136,1183,9321,2021-01-30 19:33:57
9418,383,3,528,68,596,9322,2021-01-30 19:58:37
9419,301,3,478,62,540,9323,2021-01-30 17:25:50
9420,476,3,597,77,674,9324,2021-01-30 18:01:52
9421,441,3,827,107,934,9325,2021-01-30 22:04:25
9422,950,2,628,81,709,9326,2021-01-30 17:42:39
9423,293,5,1356,176,1532,9327,2021-01-30 18:41:05
9424,571,5,1775,230,2005,9328,2021-01-30 19:57:50
9425,172,3,727,94,821,9329,2021-01-30 08:11:55
9426,141,3,1027,133,1160,9330,2021-01-30 12:22:00
9427,714,3,688,89,777,9331,2021-01-30 05:59:18
9428,285,3,1047,136,1183,9332,2021-01-29 21:12:06
9429,229,3,1027,133,1160,9333,2021-01-29 23:30:24
9430,553,3,578,75,653,9334,2021-01-29 21:06:19
9431,60,3,608,79,687,9335,2021-01-30 06:18:08
9432,541,3,1327,172,1499,9336,2021-01-30 12:54:00
9433,94,5,1087,141,1228,9337,2021-01-30 22:45:21
9434,683,2,498,64,562,9338,2021-01-31 03:45:20
9435,19,3,1197,155,1352,9339,2021-01-30 08:57:03
9436,572,3,1027,133,1160,9340,2021-01-30 08:40:18
9437,29,2,329,42,371,9341,2021-01-31 03:00:48
9438,902,3,747,97,844,9342,2021-01-31 00:05:01
9439,113,2,598,77,675,9343,2021-01-31 04:05:37
9440,638,4,956,124,1080,9344,2021-01-31 04:04:04
9441,680,3,747,97,844,9345,2021-01-30 12:30:58
9442,169,3,997,129,1126,9346,2021-01-30 12:23:01
9443,419,2,429,55,484,9347,2021-01-30 22:46:05
9444,964,2,498,64,562,9348,2021-01-31 02:16:50
9445,133,5,1325,172,1497,9349,2021-01-31 05:00:29
9446,120,2,1098,142,1240,9350,2021-01-30 23:03:32
9447,855,2,798,103,901,9351,2021-01-31 07:11:56
9448,594,5,1525,198,1723,9352,2021-01-31 14:24:47
9449,522,6,1774,230,2004,9353,2021-01-31 00:01:38
9450,152,2,498,64,562,9354,2021-01-30 16:49:12
9451,88,3,897,116,1013,9355,2021-01-29 12:41:10
9452,84,3,428,55,483,9356,2021-01-30 03:48:20
9453,94,2,598,77,675,9357,2021-01-30 11:54:28
9454,824,2,928,120,1048,9358,2021-01-30 03:32:52
9455,94,5,1445,187,1632,9359,2021-01-29 17:31:01
9456,777,2,429,55,484,9360,2021-01-29 11:12:27
9457,352,3,888,115,1003,9361,2021-01-29 22:45:38
9458,341,3,797,103,900,9362,2021-01-29 22:38:39
9459,996,2,429,55,484,9363,2021-01-29 21:31:52
9460,634,3,647,84,731,9364,2021-01-29 20:19:17
9461,481,5,1375,178,1553,9365,2021-01-30 07:48:15
9462,745,4,837,108,945,9366,2021-01-30 06:59:28
9463,673,3,608,79,687,9367,2021-01-30 12:53:03
9464,119,3,1047,136,1183,9368,2021-01-30 11:39:06
9465,517,6,1635,212,1847,9369,2021-01-30 16:51:41
9466,874,2,798,103,901,9370,2021-01-30 04:11:02
9467,364,6,1435,186,1621,9371,2021-01-30 02:03:53
9468,109,3,897,116,1013,9372,2021-01-30 03:07:13
9469,290,3,827,107,934,9373,2021-01-30 14:38:44
9470,476,3,847,110,957,9374,2021-01-30 05:46:06
9471,476,3,847,110,957,9374,2021-01-30 05:46:06
9472,193,2,798,103,901,9375,2021-01-30 00:52:26
9473,192,3,747,97,844,9376,2021-01-29 17:56:11
9474,674,2,329,42,371,9377,2021-01-30 05:03:11
9475,443,3,1027,133,1160,9378,2021-01-30 16:36:43
9476,175,6,1844,239,2083,9379,2021-01-30 11:03:09
9477,777,3,947,123,1070,9380,2021-01-30 02:31:03
9478,840,3,927,120,1047,9381,2021-01-30 06:32:06
9479,362,1,399,51,450,9382,2021-01-30 13:22:37
9480,533,2,598,77,675,9383,2021-01-30 16:54:55
9481,326,3,578,75,653,9384,2021-01-30 20:06:13
9482,969,3,808,105,913,9385,2021-01-29 15:01:05
9483,41,3,697,90,787,9386,2021-01-29 14:41:09
9484,942,2,898,116,1014,9387,2021-01-29 06:48:13
9485,102,3,1027,133,1160,9388,2021-01-29 06:35:06
9486,151,3,827,107,934,9389,2021-01-30 10:19:49
9487,461,3,927,120,1047,9390,2021-01-30 10:24:26
9488,603,5,1656,215,1871,9391,2021-01-30 09:09:02
9489,7,3,827,107,934,9392,2021-01-30 10:52:01
9490,158,3,428,55,483,9393,2021-01-30 05:39:02
9491,555,2,598,77,675,9394,2021-01-30 10:10:06
9492,940,2,798,103,901,9395,2021-01-29 20:32:12
9493,441,5,1395,181,1576,9396,2021-01-29 09:20:26
9494,535,2,898,116,1014,9397,2021-01-29 01:43:48
9495,841,2,898,116,1014,9398,2021-01-29 15:48:23
9496,952,3,1127,146,1273,9399,2021-01-29 04:16:47
9497,77,3,608,79,687,9400,2021-01-29 09:35:42
9498,915,1,399,51,450,9401,2021-01-29 02:35:38
9499,489,2,429,55,484,9402,2021-01-29 03:12:49
9500,80,3,1047,136,1183,9403,2021-01-29 22:12:40
9501,666,2,659,85,744,9404,2021-01-29 17:01:58
9502,11,3,997,129,1126,9405,2021-01-29 08:35:26
9503,858,5,1656,215,1871,9406,2021-01-29 05:21:06
9504,706,3,608,79,687,9407,2021-01-29 17:47:40
9505,426,3,888,115,1003,9408,2021-01-29 23:27:52
9506,490,2,659,85,744,9409,2021-01-30 02:11:12
9507,968,6,1994,259,2253,9410,2021-01-30 10:17:36
9508,234,3,608,79,687,9411,2021-01-29 16:40:14
9509,136,3,658,85,743,9412,2021-01-29 23:21:57
9510,430,2,498,64,562,9413,2021-01-29 06:54:05
9511,331,3,727,94,821,9414,2021-01-29 04:25:31
9512,228,3,827,107,934,9415,2021-01-29 17:40:24
9513,620,2,898,116,1014,9416,2021-01-29 12:29:54
9514,787,2,429,55,484,9417,2021-01-29 14:25:37
9515,336,3,597,77,674,9418,2021-01-29 15:12:18
9516,43,3,808,105,913,9419,2021-01-30 21:05:51
9517,176,3,558,72,630,9420,2021-01-30 22:26:51
9518,4,2,429,55,484,9421,2021-01-30 18:17:39
9519,7,2,659,85,744,9422,2021-01-30 18:45:54
9520,81,6,1246,161,1407,9423,2021-01-30 22:27:07
9521,177,3,1197,155,1352,9424,2021-01-30 19:08:17
9522,960,5,1017,132,1149,9425,2021-01-30 20:04:20
9523,878,3,1047,136,1183,9426,2021-01-30 21:19:50
9524,496,3,478,62,540,9427,2021-01-30 08:47:46
9525,281,2,828,107,935,9428,2021-01-30 13:38:21
9526,281,2,828,107,935,9428,2021-01-30 13:38:21
9527,339,5,1795,233,2028,9429,2021-01-30 07:59:31
9528,276,2,1098,142,1240,9430,2021-01-29 21:46:58
9529,914,4,1177,153,1330,9431,2021-01-30 00:45:14
9530,271,3,1327,172,1499,9432,2021-01-29 22:46:11
9531,222,2,659,85,744,9433,2021-01-30 06:30:43
9532,969,5,2045,265,2310,9434,2021-01-30 15:32:12
9533,315,3,1327,172,1499,9435,2021-01-31 01:06:49
9534,86,3,1127,146,1273,9436,2021-01-31 04:36:07
9535,276,2,429,55,484,9437,2021-01-30 09:27:04
9536,179,3,888,115,1003,9438,2021-01-30 10:03:48
9537,635,2,459,59,518,9439,2021-01-31 04:47:30
9538,979,3,558,72,630,9440,2021-01-31 02:28:38
9539,877,2,798,103,901,9441,2021-01-31 05:25:30
9540,571,5,1306,169,1475,9442,2021-01-31 04:30:58
9541,831,3,997,129,1126,9443,2021-01-30 14:18:52
9542,865,3,927,120,1047,9444,2021-01-30 13:39:50
9543,237,3,827,107,934,9445,2021-01-30 23:09:49
9544,107,3,827,107,934,9446,2021-01-31 02:45:12
9545,803,2,598,77,675,9447,2021-01-31 06:30:54
9546,491,1,149,19,168,9448,2021-01-30 23:51:23
9547,966,2,898,116,1014,9449,2021-01-31 09:27:27
9548,4,3,758,98,856,9450,2021-01-31 14:32:14
9549,855,3,827,107,934,9451,2021-01-31 01:03:39
9550,716,2,548,71,619,9452,2021-01-30 18:26:23
9551,573,3,478,62,540,9453,2021-01-29 15:14:26
9552,509,1,399,51,450,9454,2021-01-30 06:25:51
9553,954,2,598,77,675,9455,2021-01-30 13:59:53
9554,734,3,688,89,777,9456,2021-01-30 05:48:50
9555,989,6,2054,267,2321,9457,2021-01-29 19:14:04
9556,596,3,808,105,913,9458,2021-01-29 13:56:31
9557,691,3,558,72,630,9459,2021-01-29 23:11:19
9558,926,3,997,129,1126,9460,2021-01-30 00:33:27
9559,283,2,429,55,484,9461,2021-01-29 21:50:31
9560,293,2,659,85,744,9462,2021-01-29 22:43:56
9561,532,5,1037,134,1171,9463,2021-01-30 10:25:07
9562,170,5,1495,194,1689,9464,2021-01-30 07:25:39
9563,94,5,1225,159,1384,9465,2021-01-30 14:26:49
9564,119,2,598,77,675,9466,2021-01-30 12:42:07
9565,693,1,299,38,337,9467,2021-01-30 18:25:25
9566,709,2,898,116,1014,9468,2021-01-30 04:48:41
9567,944,3,1028,133,1161,9469,2021-01-30 02:42:31
9568,666,3,747,97,844,9470,2021-01-30 05:44:00
9569,148,2,748,97,845,9471,2021-01-30 14:59:48
9570,897,2,1098,142,1240,9472,2021-01-30 08:21:27
9571,476,1,599,77,676,9473,2021-01-30 07:34:01
9572,430,3,1127,146,1273,9474,2021-01-30 03:18:03
9573,84,3,1027,133,1160,9475,2021-01-29 18:32:16
9574,983,3,1027,133,1160,9476,2021-01-30 05:48:46
9575,126,2,528,68,596,9477,2021-01-30 16:54:49
9576,363,1,499,64,563,9478,2021-01-30 13:41:07
9577,992,2,598,77,675,9479,2021-01-30 04:39:45
9578,102,3,897,116,1013,9480,2021-01-30 07:44:57
9579,34,3,428,55,483,9481,2021-01-30 14:07:29
9580,680,2,498,64,562,9482,2021-01-30 17:50:43
9581,920,1,149,19,168,9483,2021-01-30 22:08:54
9582,651,3,897,116,1013,9484,2021-01-29 16:05:41
9583,471,3,827,107,934,9485,2021-01-29 15:30:33
9584,393,2,329,42,371,9486,2021-01-29 09:03:27
9585,740,2,329,42,371,9487,2021-01-29 07:42:14
9586,954,2,598,77,675,9488,2021-01-30 12:45:12
9587,679,3,697,90,787,9489,2021-01-30 11:15:14
9588,19,3,658,85,743,9490,2021-01-30 09:20:19
9589,119,5,1445,187,1632,9491,2021-01-30 10:59:45
9590,293,5,1456,189,1645,9492,2021-01-30 06:06:43
9591,199,3,647,84,731,9493,2021-01-30 10:58:18
9592,97,1,229,29,258,9494,2021-01-29 22:33:05
9593,623,2,1098,142,1240,9495,2021-01-29 09:52:41
9594,302,3,528,68,596,9496,2021-01-29 02:51:51
9595,36,4,926,120,1046,9497,2021-01-29 16:52:38
9596,986,1,299,38,337,9498,2021-01-29 05:24:45
9597,990,3,597,77,674,9499,2021-01-29 10:26:32
9598,179,1,399,51,450,9500,2021-01-29 04:56:54
9599,301,2,498,64,562,9501,2021-01-29 04:42:14
9600,290,3,1327,172,1499,9502,2021-01-30 00:31:16
9601,111,2,698,90,788,9503,2021-01-29 17:50:39
9602,866,3,558,72,630,9504,2021-01-29 10:33:51
9603,716,3,997,129,1126,9505,2021-01-29 06:26:03
9604,486,3,1127,146,1273,9506,2021-01-29 19:14:48
9605,814,3,1327,172,1499,9507,2021-01-30 01:37:41
9606,450,2,898,116,1014,9508,2021-01-30 03:30:02
9607,506,3,1027,133,1160,9509,2021-01-30 12:45:20
9608,482,4,1276,165,1441,9510,2021-01-29 19:06:54
9609,494,3,1327,172,1499,9511,2021-01-30 00:25:28
9610,278,3,697,90,787,9512,2021-01-29 08:37:59
9611,356,3,1047,136,1183,9513,2021-01-29 04:32:01
9612,671,2,598,77,675,9514,2021-01-29 19:10:00
9613,63,2,498,64,562,9515,2021-01-29 12:38:27
9614,910,1,229,29,258,9516,2021-01-29 15:26:08
9615,589,2,659,85,744,9517,2021-01-29 16:28:23
9616,821,3,827,107,934,9518,2021-01-30 22:17:04
9617,677,3,747,97,844,9519,2021-01-31 01:10:39
9618,352,2,898,116,1014,9520,2021-01-30 19:22:58
9619,644,3,997,129,1126,9521,2021-01-30 19:20:14
9620,909,4,996,129,1125,9522,2021-01-31 00:43:07
9621,904,3,1047,136,1183,9523,2021-01-30 20:08:25
9622,523,2,429,55,484,9524,2021-01-30 20:33:42
9623,321,2,598,77,675,9525,2021-01-30 22:32:40
9624,98,5,1525,198,1723,9526,2021-01-30 11:01:45
9625,291,5,1475,191,1666,9527,2021-01-30 16:04:08
9626,247,2,659,85,744,9528,2021-01-30 13:45:58
9627,606,3,528,68,596,9529,2021-01-30 08:17:10
9628,654,2,498,64,562,9530,2021-01-29 23:15:39
9629,998,3,727,94,821,9531,2021-01-30 03:28:37
9630,44,3,797,103,900,9532,2021-01-30 00:45:55
9631,856,3,558,72,630,9533,2021-01-30 07:50:46
9632,785,2,898,116,1014,9534,2021-01-30 16:33:08
9633,953,2,898,116,1014,9535,2021-01-31 01:21:11
9634,45,5,1626,211,1837,9536,2021-01-31 07:21:31
9635,773,5,1126,146,1272,9537,2021-01-30 11:54:13
9636,17,3,897,116,1013,9538,2021-01-30 11:24:10
9637,437,3,897,116,1013,9539,2021-01-31 07:31:20
9638,590,2,659,85,744,9540,2021-01-31 04:17:27
9639,294,2,598,77,675,9541,2021-01-31 06:47:32
9640,196,2,698,90,788,9542,2021-01-31 07:00:04
9641,453,3,727,94,821,9543,2021-01-30 16:46:43
9642,877,3,697,90,787,9544,2021-01-30 16:10:57
9643,514,3,927,120,1047,9545,2021-01-31 00:27:56
9644,568,3,747,97,844,9546,2021-01-31 03:59:40
9645,495,3,1197,155,1352,9547,2021-01-31 08:54:06
9646,555,3,888,115,1003,9548,2021-01-31 02:35:27
9647,828,2,448,58,506,9549,2021-01-31 09:47:57
9648,215,2,498,64,562,9550,2021-01-31 16:56:37
9649,850,3,428,55,483,9551,2021-01-31 01:48:50
9650,776,3,558,72,630,9552,2021-01-30 19:12:00
9651,466,3,1027,133,1160,9553,2021-01-29 15:52:49
9652,306,3,997,129,1126,9554,2021-01-30 06:53:22
9653,780,5,1456,189,1645,9555,2021-01-30 14:37:28
9654,780,5,1456,189,1645,9555,2021-01-30 14:37:28
9655,263,2,628,81,709,9556,2021-01-30 06:47:06
9656,483,3,597,77,674,9557,2021-01-29 20:17:34
9657,66,3,847,110,957,9558,2021-01-29 15:14:43
9658,577,3,528,68,596,9559,2021-01-29 23:20:52
9659,784,3,428,55,483,9560,2021-01-30 02:39:22
9660,474,3,997,129,1126,9561,2021-01-29 23:18:52
9661,474,3,997,129,1126,9561,2021-01-29 23:18:52
9662,333,2,798,103,901,9562,2021-01-29 23:58:51
9663,523,3,608,79,687,9563,2021-01-30 10:34:36
9664,240,2,1098,142,1240,9564,2021-01-30 07:40:52
9665,149,1,699,90,789,9565,2021-01-30 16:08:22
9666,201,6,1854,241,2095,9566,2021-01-30 13:43:16
9667,986,3,888,115,1003,9567,2021-01-30 18:26:07
9668,962,6,1555,202,1757,9568,2021-01-30 07:02:10
9669,95,3,1027,133,1160,9569,2021-01-30 04:02:38
9670,369,3,847,110,957,9570,2021-01-30 06:20:29
9671,116,6,2074,269,2343,9571,2021-01-30 16:41:13
9672,272,3,888,115,1003,9572,2021-01-30 09:58:03
9673,566,2,1098,142,1240,9573,2021-01-30 10:20:07
9674,53,1,229,29,258,9574,2021-01-30 04:31:18
9675,852,2,898,116,1014,9575,2021-01-29 20:23:07
9676,510,2,848,110,958,9576,2021-01-30 05:53:53
9677,520,2,659,85,744,9577,2021-01-30 17:03:57
9678,180,3,827,107,934,9578,2021-01-30 15:51:11
9679,461,3,758,98,856,9579,2021-01-30 06:33:19
9680,292,2,329,42,371,9580,2021-01-30 07:54:01
9681,794,3,658,85,743,9581,2021-01-30 16:21:41
9682,227,3,827,107,934,9582,2021-01-30 18:30:48
9683,602,3,997,129,1126,9583,2021-01-31 00:42:12
9684,4,3,1247,162,1409,9584,2021-01-29 18:16:51
9685,189,2,898,116,1014,9585,2021-01-29 17:45:01
9686,241,3,647,84,731,9586,2021-01-29 09:09:07
9687,958,2,598,77,675,9587,2021-01-29 10:01:51
9688,546,2,598,77,675,9588,2021-01-30 13:46:17
9689,999,3,528,68,596,9589,2021-01-30 13:03:26
9690,589,6,1524,198,1722,9590,2021-01-30 11:49:02
9691,496,3,697,90,787,9591,2021-01-30 11:45:31
9692,919,3,688,89,777,9592,2021-01-30 07:00:55
9693,494,2,598,77,675,9593,2021-01-30 11:01:02
9694,809,3,1047,136,1183,9594,2021-01-29 23:41:45
9695,715,3,1047,136,1183,9595,2021-01-29 10:18:34
9696,154,3,997,129,1126,9596,2021-01-29 04:46:55
9697,225,3,827,107,934,9597,2021-01-29 16:58:00
9698,183,3,747,97,844,9598,2021-01-29 07:55:55
9699,475,2,598,77,675,9599,2021-01-29 12:07:58
9700,779,3,697,90,787,9600,2021-01-29 06:34:51
9701,321,3,1027,133,1160,9601,2021-01-29 04:55:29
9702,457,2,898,116,1014,9602,2021-01-30 01:32:11
9703,94,3,578,75,653,9603,2021-01-29 18:05:11
9704,538,2,1098,142,1240,9604,2021-01-29 11:42:58
9705,960,3,1047,136,1183,9605,2021-01-29 07:48:43
9706,538,2,429,55,484,9606,2021-01-29 21:16:11
9707,959,3,888,115,1003,9607,2021-01-30 03:32:27
9708,772,2,648,84,732,9608,2021-01-30 04:46:00
9709,627,3,1147,149,1296,9609,2021-01-30 15:21:16
9710,129,3,927,120,1047,9610,2021-01-29 21:34:02
9711,49,3,1247,162,1409,9611,2021-01-30 01:29:48
9712,927,3,428,55,483,9612,2021-01-29 10:49:38
9713,927,3,428,55,483,9612,2021-01-29 10:49:38
9714,547,3,1127,146,1273,9613,2021-01-29 05:09:44
9715,462,2,598,77,675,9614,2021-01-29 20:47:57
9716,635,3,888,115,1003,9615,2021-01-29 14:21:19
9717,399,5,1256,163,1419,9616,2021-01-29 16:29:52
9718,767,2,798,103,901,9617,2021-01-29 16:58:18
9719,47,2,598,77,675,9618,2021-01-30 22:56:55
9720,153,6,1575,204,1779,9619,2021-01-31 03:01:31
9721,337,3,478,62,540,9620,2021-01-30 22:07:08
9722,273,3,1027,133,1160,9621,2021-01-30 20:24:02
9723,863,3,658,85,743,9622,2021-01-31 01:58:34
9724,91,2,459,59,518,9623,2021-01-30 21:42:37
9725,162,3,897,116,1013,9624,2021-01-30 23:09:28
9726,162,3,897,116,1013,9624,2021-01-30 23:09:28
9727,62,3,528,68,596,9625,2021-01-31 00:16:45
9728,275,2,698,90,788,9626,2021-01-30 12:31:32
9729,972,3,1197,155,1352,9627,2021-01-30 18:29:30
9730,791,3,558,72,630,9628,2021-01-30 14:25:02
9731,253,3,827,107,934,9629,2021-01-30 08:51:14
9732,828,3,1247,162,1409,9630,2021-01-29 23:26:28
9733,72,4,1257,163,1420,9631,2021-01-30 05:01:03
9734,691,5,1525,198,1723,9632,2021-01-30 00:46:08
9735,648,2,898,116,1014,9633,2021-01-30 10:27:20
9736,597,3,478,62,540,9634,2021-01-30 16:41:26
9737,226,3,428,55,483,9635,2021-01-31 03:21:00
9738,994,6,1854,241,2095,9636,2021-01-31 09:04:13
9739,281,4,1107,143,1250,9637,2021-01-30 13:24:33
9740,932,3,747,97,844,9638,2021-01-30 12:06:58
9741,95,2,598,77,675,9639,2021-01-31 08:01:29
9742,2,3,947,123,1070,9640,2021-01-31 07:00:05
9743,606,3,827,107,934,9641,2021-01-31 08:43:04
9744,105,6,2454,319,2773,9642,2021-01-31 07:10:29
9745,340,2,698,90,788,9643,2021-01-30 17:23:35
9746,99,3,1127,146,1273,9644,2021-01-30 18:26:20
9747,91,1,299,38,337,9645,2021-01-31 01:17:19
9748,988,3,997,129,1126,9646,2021-01-31 05:47:22
9749,119,2,828,107,935,9647,2021-01-31 10:22:18
9750,388,5,1126,146,1272,9648,2021-01-31 04:06:07
9751,40,2,498,64,562,9649,2021-01-31 09:57:46
9752,979,2,898,116,1014,9650,2021-01-31 18:32:43
9753,974,1,149,19,168,9651,2021-01-31 02:25:23
9754,558,2,848,110,958,9652,2021-01-30 20:15:17
9755,970,3,758,98,856,9653,2021-01-29 17:00:49
9756,576,3,997,129,1126,9654,2021-01-30 07:51:52
9757,329,1,149,19,168,9655,2021-01-30 15:13:15
9758,748,3,1027,133,1160,9656,2021-01-30 16:02:39
9759,821,3,927,120,1047,9657,2021-01-30 09:28:22
9760,436,3,847,110,957,9658,2021-01-29 22:07:28
9761,700,3,827,107,934,9659,2021-01-29 16:03:35
9762,428,3,747,97,844,9660,2021-01-30 01:58:31
9763,573,5,1706,221,1927,9661,2021-01-30 04:01:10
9764,181,6,2394,311,2705,9662,2021-01-29 23:29:35
9765,942,2,329,42,371,9663,2021-01-30 00:07:34
9766,974,5,1945,252,2197,9664,2021-01-30 02:37:34
9767,652,2,659,85,744,9665,2021-01-30 12:18:21
9768,342,4,1287,167,1454,9666,2021-01-30 08:53:45
9769,233,3,478,62,540,9667,2021-01-30 16:11:22
9770,949,2,898,116,1014,9668,2021-01-30 13:50:23
9771,464,3,847,110,957,9669,2021-01-30 19:03:37
9772,930,2,329,42,371,9670,2021-01-30 08:48:32
9773,189,2,1098,142,1240,9671,2021-01-30 05:05:35
9774,382,3,797,103,900,9672,2021-01-30 08:37:21
9775,482,3,558,72,630,9673,2021-01-30 18:38:09
9776,305,3,847,110,957,9674,2021-01-30 11:06:33
9777,685,2,659,85,744,9675,2021-01-30 12:44:16
9778,846,3,558,72,630,9676,2021-01-30 06:29:07
9779,834,3,827,107,934,9677,2021-01-29 21:54:21
9780,933,4,1387,180,1567,9678,2021-01-30 07:54:24
9781,912,3,747,97,844,9679,2021-01-30 19:32:50
9782,60,1,149,19,168,9680,2021-01-30 16:55:05
9783,431,2,598,77,675,9681,2021-01-30 07:59:11
9784,439,2,698,90,788,9682,2021-01-30 08:04:31
9785,13,3,827,107,934,9683,2021-01-30 18:03:12
9786,409,3,1047,136,1183,9684,2021-01-30 20:40:36
9787,138,5,1256,163,1419,9685,2021-01-31 01:55:25
9788,52,3,808,105,913,9686,2021-01-29 18:21:21
9789,197,3,558,72,630,9687,2021-01-29 18:55:44
9790,91,3,808,105,913,9688,2021-01-29 11:40:36
9791,380,2,1098,142,1240,9689,2021-01-29 10:11:45
9792,597,5,1845,239,2084,9690,2021-01-30 14:02:52
9793,717,2,498,64,562,9691,2021-01-30 14:14:15
9794,551,2,1098,142,1240,9692,2021-01-30 12:27:49
9795,926,1,499,64,563,9693,2021-01-30 12:40:18
9796,74,3,478,62,540,9694,2021-01-30 07:49:10
9797,120,3,478,62,540,9695,2021-01-30 12:14:05
9798,348,2,898,116,1014,9696,2021-01-30 01:42:02
9799,194,3,747,97,844,9697,2021-01-29 11:50:37
9800,575,3,1197,155,1352,9698,2021-01-29 07:14:44
9801,447,2,598,77,675,9699,2021-01-29 17:53:35
9802,314,6,1266,164,1430,9700,2021-01-29 08:54:34
9803,158,2,698,90,788,9701,2021-01-29 14:06:06
9804,84,2,798,103,901,9702,2021-01-29 08:34:31
9805,683,3,697,90,787,9703,2021-01-29 06:02:33
9806,667,3,558,72,630,9704,2021-01-30 02:52:14
9807,506,4,1387,180,1567,9705,2021-01-29 18:21:13
9808,209,2,798,103,901,9706,2021-01-29 14:06:16
9809,269,4,1196,155,1351,9707,2021-01-29 10:22:03
9810,178,3,827,107,934,9708,2021-01-29 22:54:16
9811,6,2,498,64,562,9709,2021-01-30 05:46:35
9812,354,2,598,77,675,9710,2021-01-30 07:14:31
9813,529,3,747,97,844,9711,2021-01-30 18:04:29
9814,112,3,647,84,731,9712,2021-01-29 23:53:30
9815,187,3,997,129,1126,9713,2021-01-30 01:38:24
9816,778,5,907,117,1024,9714,2021-01-29 12:28:39
9817,790,3,847,110,957,9715,2021-01-29 12:29:53
9818,674,5,1706,221,1927,9716,2021-01-29 06:02:05
9819,609,3,1047,136,1183,9717,2021-01-29 23:16:15
9820,226,3,528,68,596,9718,2021-01-29 16:32:59
9821,361,3,888,115,1003,9719,2021-01-29 18:47:14
9822,7,6,1366,177,1543,9720,2021-01-29 18:17:02
9823,993,3,897,116,1013,9721,2021-01-31 00:24:39
9824,754,3,997,129,1126,9722,2021-01-31 04:51:26
9825,209,3,747,97,844,9723,2021-01-30 23:46:53
9826,468,3,1197,155,1352,9724,2021-01-30 23:05:06
9827,717,3,808,105,913,9725,2021-01-31 03:11:25
9828,383,3,1047,136,1183,9726,2021-01-31 00:10:18
9829,17,3,827,107,934,9727,2021-01-31 00:41:44
9830,583,6,1485,193,1678,9728,2021-01-30 23:31:01
9831,476,5,1306,169,1475,9729,2021-01-31 02:25:03
9832,606,2,1098,142,1240,9730,2021-01-30 15:14:01
9833,510,4,1146,148,1294,9731,2021-01-30 21:06:38
9834,505,2,1098,142,1240,9732,2021-01-30 15:09:49
9835,121,5,1406,182,1588,9733,2021-01-30 09:05:18
9836,886,3,528,68,596,9734,2021-01-30 00:09:38
9837,224,3,1197,155,1352,9735,2021-01-30 06:50:12
9838,825,5,1656,215,1871,9736,2021-01-30 01:37:18
9839,811,3,847,110,957,9737,2021-01-30 13:09:32
9840,363,3,647,84,731,9738,2021-01-30 17:26:51
9841,121,3,1127,146,1273,9739,2021-01-31 05:25:55
9842,172,5,1556,202,1758,9740,2021-01-31 10:53:51
9843,498,5,1725,224,1949,9741,2021-01-30 13:30:20
9844,426,3,647,84,731,9742,2021-01-30 14:08:52
9845,538,1,99,12,111,9743,2021-01-31 10:17:30
9846,47,2,828,107,935,9744,2021-01-31 09:00:39
9847,575,3,997,129,1126,9745,2021-01-31 11:04:47
9848,446,3,747,97,844,9746,2021-01-31 07:51:48
9849,808,3,697,90,787,9747,2021-01-30 17:49:08
9850,650,1,99,12,111,9748,2021-01-30 19:11:18
9851,246,3,688,89,777,9749,2021-01-31 01:51:06
9852,639,3,647,84,731,9750,2021-01-31 08:05:40
9853,8,5,1126,146,1272,9751,2021-01-31 12:05:35
9854,458,3,647,84,731,9752,2021-01-31 06:39:48
9855,316,1,499,64,563,9753,2021-01-31 12:41:03
9856,423,2,1098,142,1240,9754,2021-01-31 19:57:50
9857,547,3,897,116,1013,9755,2021-01-31 04:06:56
9858,994,2,628,81,709,9756,2021-01-30 20:17:31
9859,753,4,1296,168,1464,9757,2021-01-29 19:19:36
9860,264,3,658,85,743,9758,2021-01-30 08:46:00
9861,39,3,997,129,1126,9759,2021-01-30 15:37:11
9862,171,2,1098,142,1240,9760,2021-01-30 18:35:40
9863,207,3,647,84,731,9761,2021-01-30 11:37:28
9864,683,3,578,75,653,9762,2021-01-29 23:07:24
9865,366,1,99,12,111,9763,2021-01-29 18:17:52
9866,843,3,578,75,653,9764,2021-01-30 02:59:01
9867,972,2,798,103,901,9765,2021-01-30 06:39:46
9868,179,2,429,55,484,9766,2021-01-30 02:15:06
9869,409,2,429,55,484,9767,2021-01-30 00:21:16
9870,150,2,898,116,1014,9768,2021-01-30 04:35:18
9871,535,3,827,107,934,9769,2021-01-30 14:39:48
9872,804,3,1047,136,1183,9770,2021-01-30 11:28:15
9873,400,3,827,107,934,9771,2021-01-30 17:59:30
9874,158,3,897,116,1013,9772,2021-01-30 15:25:29
9875,795,3,597,77,674,9773,2021-01-30 19:34:59
9876,6,1,149,19,168,9774,2021-01-30 10:17:03
9877,6,1,149,19,168,9774,2021-01-30 10:17:03
9878,297,2,498,64,562,9775,2021-01-30 06:23:16
9879,601,2,698,90,788,9776,2021-01-30 09:41:50
9880,192,4,1227,159,1386,9777,2021-01-30 20:44:00
9881,568,2,1098,142,1240,9778,2021-01-30 12:46:28
9882,783,3,428,55,483,9779,2021-01-30 14:20:54
9883,645,2,848,110,958,9780,2021-01-30 06:44:48
9884,536,3,428,55,483,9781,2021-01-29 22:21:40
9885,722,5,1545,200,1745,9782,2021-01-30 10:39:24
9886,964,2,898,116,1014,9783,2021-01-30 20:04:25
9887,732,2,798,103,901,9784,2021-01-30 17:56:05
9888,434,2,528,68,596,9785,2021-01-30 10:12:19
9889,507,4,807,104,911,9786,2021-01-30 08:29:48
9890,753,3,797,103,900,9787,2021-01-30 20:15:15
9891,655,3,558,72,630,9788,2021-01-30 20:42:49
9892,721,2,398,51,449,9789,2021-01-31 04:40:59
9893,742,3,1047,136,1183,9790,2021-01-29 18:32:50
9894,665,2,698,90,788,9791,2021-01-29 21:09:39
9895,498,3,1247,162,1409,9792,2021-01-29 12:41:07
9896,573,3,1127,146,1273,9793,2021-01-29 12:11:45
9897,283,2,659,85,744,9794,2021-01-30 14:46:12
9898,921,2,598,77,675,9795,2021-01-30 15:16:54
9899,692,4,1127,146,1273,9796,2021-01-30 12:33:57
9900,533,2,659,85,744,9797,2021-01-30 13:30:48
9901,378,3,827,107,934,9798,2021-01-30 09:44:49
9902,708,3,428,55,483,9799,2021-01-30 12:20:28
9903,936,3,608,79,687,9800,2021-01-30 02:56:18
9904,827,2,459,59,518,9801,2021-01-29 13:42:31
9905,608,6,1505,195,1700,9802,2021-01-29 08:35:57
9906,734,3,1027,133,1160,9803,2021-01-29 19:56:02
9907,265,2,459,59,518,9804,2021-01-29 09:53:54
9908,193,3,1047,136,1183,9805,2021-01-29 16:32:32
9909,928,3,758,98,856,9806,2021-01-29 08:54:44
9910,40,3,1327,172,1499,9807,2021-01-29 07:10:32
9911,932,3,1327,172,1499,9808,2021-01-30 03:18:55
9912,54,3,747,97,844,9809,2021-01-29 19:12:36
9913,892,3,478,62,540,9810,2021-01-29 16:06:35
9914,866,3,888,115,1003,9811,2021-01-29 11:44:48
9915,670,5,1556,202,1758,9812,2021-01-30 01:03:34
9916,972,6,1785,232,2017,9813,2021-01-30 06:07:12
9917,260,3,758,98,856,9814,2021-01-30 09:48:59
9918,47,3,747,97,844,9815,2021-01-30 19:51:44
9919,945,3,558,72,630,9816,2021-01-30 01:11:16
9920,424,2,598,77,675,9817,2021-01-30 04:16:10
9921,873,2,698,90,788,9818,2021-01-29 13:44:52
9922,421,3,528,68,596,9819,2021-01-29 13:11:56
9923,969,2,598,77,675,9820,2021-01-29 06:18:57
9924,631,2,329,42,371,9821,2021-01-30 01:33:49
9925,629,3,558,72,630,9822,2021-01-29 17:18:55
9926,629,3,558,72,630,9822,2021-01-29 17:18:55
9927,144,1,499,64,563,9823,2021-01-29 20:14:50
9928,709,2,659,85,744,9824,2021-01-29 18:56:20
9929,828,5,1017,132,1149,9825,2021-01-31 02:03:14
9930,17,2,798,103,901,9826,2021-01-31 07:24:45
9931,61,3,558,72,630,9827,2021-01-31 01:28:44
9932,119,6,1685,219,1904,9828,2021-01-31 01:11:54
9933,548,6,1774,230,2004,9829,2021-01-31 04:59:17
9934,902,3,528,68,596,9830,2021-01-31 01:01:02
9935,295,2,698,90,788,9831,2021-01-31 02:46:29
9936,936,3,947,123,1070,9832,2021-01-31 00:51:20
9937,806,3,997,129,1126,9833,2021-01-31 04:07:49
9938,806,3,997,129,1126,9833,2021-01-31 04:07:49
9939,740,2,598,77,675,9834,2021-01-30 15:26:17
9940,421,2,498,64,562,9835,2021-01-30 22:51:28
9941,785,3,747,97,844,9836,2021-01-30 16:13:06
9942,502,3,478,62,540,9837,2021-01-30 09:08:34
9943,401,1,399,51,450,9838,2021-01-30 01:10:07
9944,695,3,1127,146,1273,9839,2021-01-30 09:00:06
9945,547,3,997,129,1126,9840,2021-01-30 03:45:36
9946,839,3,747,97,844,9841,2021-01-30 13:17:03
9947,745,3,747,97,844,9842,2021-01-30 18:58:58
9948,105,3,888,115,1003,9843,2021-01-31 07:19:59
9949,171,2,898,116,1014,9844,2021-01-31 10:58:58
9950,10,2,659,85,744,9845,2021-01-30 13:53:51
9951,352,3,558,72,630,9846,2021-01-30 14:24:57
9952,25,2,659,85,744,9847,2021-01-31 10:41:03
9953,100,2,798,103,901,9848,2021-01-31 09:16:50
9954,881,2,698,90,788,9849,2021-01-31 12:18:14
9955,735,3,827,107,934,9850,2021-01-31 10:08:03
9956,604,3,1097,142,1239,9851,2021-01-30 19:55:30
9957,434,4,1226,159,1385,9852,2021-01-30 21:25:10
9958,166,3,597,77,674,9853,2021-01-31 02:37:01
9959,691,2,798,103,901,9854,2021-01-31 10:35:46
9960,205,2,628,81,709,9855,2021-01-31 14:11:27
9961,173,3,647,84,731,9856,2021-01-31 07:24:51
9962,356,3,888,115,1003,9857,2021-01-31 13:22:08
9963,113,3,927,120,1047,9858,2021-01-31 21:58:46
9964,301,5,1195,155,1350,9859,2021-01-31 04:23:34
9965,137,5,1695,220,1915,9860,2021-01-30 20:31:44
9966,928,2,828,107,935,9861,2021-01-29 21:13:52
9967,297,3,997,129,1126,9862,2021-01-30 09:44:02
9968,220,6,2215,287,2502,9863,2021-01-30 18:19:34
9969,389,3,797,103,900,9864,2021-01-30 18:53:42
9970,670,3,1127,146,1273,9865,2021-01-30 14:21:58
9971,542,5,2225,289,2514,9866,2021-01-30 00:34:33
9972,715,3,1127,146,1273,9867,2021-01-29 19:34:37
9973,82,5,1345,174,1519,9868,2021-01-30 05:34:40
9974,608,6,1785,232,2017,9869,2021-01-30 08:54:14
9975,632,2,659,85,744,9870,2021-01-30 03:12:26
9976,85,2,598,77,675,9871,2021-01-30 02:40:46
9977,782,2,659,85,744,9872,2021-01-30 05:02:30
9978,83,3,1027,133,1160,9873,2021-01-30 15:10:07
9979,322,2,498,64,562,9874,2021-01-30 12:01:37
9980,191,5,1395,181,1576,9875,2021-01-30 19:30:51
9981,942,5,1286,167,1453,9876,2021-01-30 16:05:38
9982,283,3,1247,162,1409,9877,2021-01-30 20:57:04
9983,128,2,528,68,596,9878,2021-01-30 10:35:08
9984,691,5,1245,161,1406,9879,2021-01-30 11:40:02
9985,546,3,688,89,777,9880,2021-01-30 06:50:01
9986,586,3,1247,162,1409,9881,2021-01-30 11:45:33
9987,287,3,747,97,844,9882,2021-01-30 21:20:44
9988,378,3,608,79,687,9883,2021-01-30 15:21:53
9989,201,3,697,90,787,9884,2021-01-30 15:23:33
9990,438,2,698,90,788,9885,2021-01-30 07:04:24
9991,947,3,558,72,630,9886,2021-01-29 22:40:56
9992,165,3,1327,172,1499,9887,2021-01-30 11:46:16
9993,406,3,428,55,483,9888,2021-01-30 22:24:24
9994,629,3,478,62,540,9889,2021-01-30 19:58:21
9995,402,5,1675,217,1892,9890,2021-01-30 12:48:51
9996,385,3,758,98,856,9891,2021-01-30 10:03:08
9997,68,3,1327,172,1499,9892,2021-01-30 22:22:18
9998,900,2,598,77,675,9893,2021-01-30 21:16:03
9999,600,2,498,64,562,9894,2021-01-31 05:22:06
10000,183,3,927,120,1047,9895,2021-01-29 20:03:14
10001,174,3,1197,155,1352,9896,2021-01-29 23:40:25
10002,479,1,699,90,789,9897,2021-01-29 14:40:08
10003,289,6,1705,221,1926,9898,2021-01-29 13:43:26
10004,908,5,1445,187,1632,9899,2021-01-30 15:22:03
10005,135,3,558,72,630,9900,2021-01-30 17:59:58
10006,313,3,897,116,1013,9901,2021-01-30 14:02:22
10007,813,2,598,77,675,9902,2021-01-30 15:55:56
10008,292,3,927,120,1047,9903,2021-01-30 11:29:52
10009,26,3,827,107,934,9904,2021-01-30 12:25:54
10010,329,3,658,85,743,9905,2021-01-30 05:39:00
10011,411,2,698,90,788,9906,2021-01-29 15:49:01
10012,248,3,747,97,844,9907,2021-01-29 08:57:22
10013,855,3,558,72,630,9908,2021-01-29 22:07:45
10014,557,3,1247,162,1409,9909,2021-01-29 10:00:23
10015,609,2,429,55,484,9910,2021-01-29 16:35:46
10016,888,3,428,55,483,9911,2021-01-29 09:11:07
10017,165,3,888,115,1003,9912,2021-01-29 08:29:26
10018,627,2,848,110,958,9913,2021-01-30 05:31:34
10019,699,2,459,59,518,9914,2021-01-29 19:14:35
10020,197,3,558,72,630,9915,2021-01-29 18:29:58
10021,413,3,1258,163,1421,9916,2021-01-29 13:37:04
10022,561,3,478,62,540,9917,2021-01-30 03:12:38
10023,641,2,598,77,675,9918,2021-01-30 08:49:26
10024,762,2,659,85,744,9919,2021-01-30 10:33:46
10025,788,3,847,110,957,9920,2021-01-30 22:09:31
10026,55,3,1247,162,1409,9921,2021-01-30 02:10:47
10027,818,2,598,77,675,9922,2021-01-30 06:52:53
10028,377,2,898,116,1014,9923,2021-01-29 13:55:47
10029,625,2,429,55,484,9924,2021-01-29 15:45:37
10030,163,2,498,64,562,9925,2021-01-29 07:13:13
10031,891,3,797,103,900,9926,2021-01-30 03:39:41
10032,372,3,558,72,630,9927,2021-01-29 17:45:32
10033,297,3,1027,133,1160,9928,2021-01-29 20:02:35
10034,569,3,747,97,844,9929,2021-01-29 22:26:32
10035,709,3,997,129,1126,9930,2021-01-29 19:16:50
10036,524,3,808,105,913,9931,2021-01-31 02:26:38
10037,302,3,578,75,653,9932,2021-01-31 10:06:53
10038,340,3,578,75,653,9933,2021-01-31 03:48:54
10039,712,3,597,77,674,9934,2021-01-31 03:30:58
10040,873,3,597,77,674,9935,2021-01-31 07:19:15
10041,812,3,747,97,844,9936,2021-01-31 02:54:18
10042,139,3,897,116,1013,9937,2021-01-31 04:59:28
10043,277,3,808,105,913,9938,2021-01-31 01:30:39
10044,696,3,747,97,844,9939,2021-01-31 05:15:34
10045,212,3,847,110,957,9940,2021-01-31 05:56:38
10046,452,3,997,129,1126,9941,2021-01-30 15:56:18
10047,354,3,688,89,777,9942,2021-01-31 01:12:34
10048,3,3,1127,146,1273,9943,2021-01-30 17:46:46
10049,212,2,898,116,1014,9944,2021-01-30 11:45:02
10050,581,5,1017,132,1149,9945,2021-01-30 01:38:38
10051,651,3,1047,136,1183,9946,2021-01-30 09:54:19
10052,513,3,647,84,731,9947,2021-01-30 05:07:29
10053,185,3,997,129,1126,9948,2021-01-30 14:26:49
10054,180,3,1327,172,1499,9949,2021-01-30 21:26:27
10055,636,2,898,116,1014,9950,2021-01-31 08:56:19
10056,224,3,1127,146,1273,9951,2021-01-31 12:05:57
10057,140,3,727,94,821,9952,2021-01-30 15:42:29
10058,655,3,1047,136,1183,9953,2021-01-30 16:53:10
10059,59,2,429,55,484,9954,2021-01-31 11:23:55
10060,94,3,827,107,934,9955,2021-01-31 11:04:30
10061,792,3,758,98,856,9956,2021-01-31 12:25:55
10062,570,3,758,98,856,9957,2021-01-31 11:50:44
10063,233,3,1027,133,1160,9958,2021-01-30 21:09:05
10064,321,3,578,75,653,9959,2021-01-30 23:30:08
10065,107,3,578,75,653,9960,2021-01-31 02:48:57
10066,488,3,1327,172,1499,9961,2021-01-31 11:14:17
10067,145,2,498,64,562,9962,2021-01-31 16:07:16
10068,956,2,798,103,901,9963,2021-01-31 09:32:31
10069,787,2,528,68,596,9964,2021-01-31 14:24:32
10070,494,3,1047,136,1183,9965,2021-02-01 00:28:45
10071,213,3,1047,136,1183,9966,2021-01-31 06:45:18
10072,109,3,658,85,743,9967,2021-01-30 21:21:14
10073,562,3,558,72,630,9968,2021-01-29 21:48:42
10074,652,3,578,75,653,9969,2021-01-30 10:25:06
10075,465,3,947,123,1070,9970,2021-01-30 20:10:08
10076,343,3,688,89,777,9971,2021-01-30 20:11:06
10077,436,6,1774,230,2004,9972,2021-01-30 14:36:59
10078,825,3,697,90,787,9973,2021-01-30 01:29:47
10079,815,1,599,77,676,9974,2021-01-29 20:36:11
10080,778,2,548,71,619,9975,2021-01-30 07:16:19
10081,273,3,947,123,1070,9976,2021-01-30 10:06:39
10082,782,3,558,72,630,9977,2021-01-30 03:41:04
10083,711,3,1127,146,1273,9978,2021-01-30 04:55:29
10084,322,5,1606,208,1814,9979,2021-01-30 07:40:25
10085,679,3,827,107,934,9980,2021-01-30 15:13:16
10086,767,3,808,105,913,9981,2021-01-30 14:30:49
10087,719,6,1325,172,1497,9982,2021-01-30 21:43:20
10088,639,3,797,103,900,9983,2021-01-30 17:06:05
10089,33,3,697,90,787,9984,2021-01-30 23:16:31
10090,245,2,1098,142,1240,9985,2021-01-30 12:28:26
10091,3,3,827,107,934,9986,2021-01-30 12:22:06
10092,68,3,997,129,1126,9987,2021-01-30 08:29:18
10093,786,3,797,103,900,9988,2021-01-30 13:16:43
10094,386,1,399,51,450,9989,2021-01-30 23:35:42
10095,234,3,428,55,483,9990,2021-01-30 18:05:29
10096,428,3,888,115,1003,9991,2021-01-30 16:34:33
10097,561,3,827,107,934,9992,2021-01-30 08:11:33
10098,50,4,1626,211,1837,9993,2021-01-29 23:43:19
10099,736,2,429,55,484,9994,2021-01-30 13:12:54
10100,558,2,648,84,732,9995,2021-01-31 01:05:30
10101,753,2,598,77,675,9996,2021-01-30 20:46:42
10102,905,5,1795,233,2028,9997,2021-01-30 14:15:36
10103,505,3,478,62,540,9998,2021-01-30 11:30:16
10104,91,2,659,85,744,9999,2021-01-30 22:25:51
10105,255,3,428,55,483,10000,2021-01-30 22:11:49
