,customer_id,quantity,subtotal,tax,total,order_id,created_at
0,917,2,459,59,518,1,2021-01-01 00:44:22
1,743,5,1625,211,1836,2,2021-01-01 01:52:49
2,585,3,597,77,674,3,2021-01-01 03:40:07
3,774,3,478,62,540,4,2021-01-01 04:00:57
4,662,6,1405,182,1587,5,2021-01-01 05:07:36
5,60,3,697,90,787,6,2021-01-01 05:24:10
6,855,2,498,64,562,7,2021-01-01 08:01:31
7,728,5,1725,224,1949,8,2021-01-01 08:01:40
8,268,2,498,64,562,9,2021-01-01 09:35:36
9,116,2,598,77,675,10,2021-01-01 10:45:01
10,408,2,898,116,1014,11,2021-01-01 10:47:30
11,299,2,798,103,901,12,2021-01-01 10:49:50
12,272,3,1347,175,1522,13,2021-01-01 12:41:49
13,782,3,827,107,934,14,2021-01-01 13:10:21
14,589,3,797,103,900,15,2021-01-01 13:41:34
15,736,1,699,90,789,16,2021-01-01 14:47:57
16,443,2,1098,142,1240,17,2021-01-01 15:20:00
17,500,2,659,85,744,18,2021-01-01 16:31:14
18,753,2,659,85,744,19,2021-01-01 19:07:31
19,729,3,658,85,743,20,2021-01-01 21:53:36
20,519,3,808,105,913,21,2021-01-01 23:33:34
21,165,3,1127,146,1273,22,2021-01-02 01:13:45
22,470,5,1495,194,1689,23,2021-01-02 02:16:38
23,716,3,558,72,630,24,2021-01-02 04:08:37
24,14,2,598,77,675,25,2021-01-02 05:10:36
25,447,2,459,59,518,26,2021-01-02 07:03:09
26,664,2,429,55,484,27,2021-01-02 07:03:21
27,769,3,727,94,821,28,2021-01-02 09:23:30
28,796,2,698,90,788,29,2021-01-02 11:19:43
29,454,3,558,72,630,30,2021-01-02 11:30:54
30,156,1,399,51,450,31,2021-01-02 13:34:29
31,42,3,528,68,596,32,2021-01-02 16:03:47
32,210,5,1545,200,1745,33,2021-01-02 17:39:35
33,559,2,898,116,1014,34,2021-01-02 18:00:46
34,76,2,448,58,506,35,2021-01-02 19:05:10
35,558,3,1047,136,1183,36,2021-01-02 20:29:01
36,787,3,658,85,743,37,2021-01-02 22:19:11
37,561,3,647,84,731,38,2021-01-02 23:46:13
38,949,3,747,97,844,39,2021-01-02 23:56:56
39,94,2,898,116,1014,40,2021-01-03 01:18:16
40,279,3,647,84,731,41,2021-01-03 01:48:28
41,824,5,1645,213,1858,42,2021-01-03 02:06:22
42,725,1,699,90,789,43,2021-01-03 03:02:31
43,435,2,459,59,518,44,2021-01-03 03:07:20
44,959,2,898,116,1014,45,2021-01-03 03:17:20
45,5,3,578,75,653,46,2021-01-03 05:52:48
46,70,3,428,55,483,47,2021-01-03 08:27:41
47,135,3,727,94,821,48,2021-01-03 10:07:26
48,760,1,399,51,450,49,2021-01-03 12:29:25
49,824,3,597,77,674,50,2021-01-03 14:04:33
50,624,3,647,84,731,51,2021-01-03 14:33:07
51,533,2,1098,142,1240,52,2021-01-03 16:29:45
52,254,6,1824,237,2061,53,2021-01-03 17:33:18
53,360,3,578,75,653,54,2021-01-03 19:16:51
54,330,2,648,84,732,55,2021-01-03 19:33:02
55,683,2,798,103,901,56,2021-01-03 19:40:13
56,570,2,698,90,788,57,2021-01-03 20:55:28
57,965,3,727,94,821,58,2021-01-03 21:34:19
58,335,5,1795,233,2028,59,2021-01-03 22:20:31
59,421,2,1098,142,1240,60,2021-01-03 22:49:04
60,567,3,688,89,777,61,2021-01-03 23:00:11
61,925,6,1475,191,1666,62,2021-01-04 00:33:17
62,649,3,1247,162,1409,63,2021-01-04 03:03:05
63,536,3,797,103,900,64,2021-01-04 03:50:20
64,737,3,1327,172,1499,65,2021-01-04 06:27:48
65,892,2,459,59,518,66,2021-01-04 06:41:43
66,636,2,898,116,1014,67,2021-01-04 09:24:38
67,636,2,898,116,1014,67,2021-01-04 09:24:38
68,938,5,1286,167,1453,68,2021-01-04 12:02:58
69,425,3,1047,136,1183,69,2021-01-04 11:52:06
70,15,3,827,107,934,70,2021-01-04 13:58:48
71,276,2,698,90,788,71,2021-01-04 13:00:40
72,427,3,578,75,653,72,2021-01-04 14:24:09
73,477,2,329,42,371,73,2021-01-04 14:01:24
74,598,3,797,103,900,74,2021-01-04 17:09:03
75,120,2,898,116,1014,75,2021-01-04 14:31:04
76,870,2,498,64,562,76,2021-01-04 18:55:54
77,291,3,658,85,743,77,2021-01-04 17:01:50
78,627,2,448,58,506,78,2021-01-04 19:14:53
79,970,2,898,116,1014,79,2021-01-04 18:03:58
80,259,3,1247,162,1409,80,2021-01-04 19:50:23
81,637,3,997,129,1126,81,2021-01-04 19:11:57
82,479,2,598,77,675,82,2021-01-04 22:05:53
83,955,5,1147,149,1296,83,2021-01-04 19:49:44
84,232,2,598,77,675,84,2021-01-04 23:46:55
85,833,2,459,59,518,85,2021-01-04 21:33:25
86,531,3,658,85,743,86,2021-01-04 23:49:31
87,452,3,888,115,1003,87,2021-01-04 22:56:17
88,69,3,1047,136,1183,88,2021-01-05 02:19:48
89,214,4,1726,224,1950,89,2021-01-04 23:30:35
90,634,3,727,94,821,90,2021-01-05 03:29:37
91,760,1,499,64,563,91,2021-01-05 02:04:45
92,351,3,747,97,844,92,2021-01-05 03:32:42
93,584,5,1545,200,1745,93,2021-01-05 04:50:34
94,716,3,897,116,1013,94,2021-01-05 04:37:07
95,81,2,848,110,958,95,2021-01-05 05:28:41
96,143,3,727,94,821,96,2021-01-05 05:17:23
97,912,3,558,72,630,97,2021-01-05 05:48:49
98,805,3,797,103,900,98,2021-01-05 07:19:20
99,923,3,597,77,674,99,2021-01-05 07:23:46
100,818,1,499,64,563,100,2021-01-05 08:43:13
101,116,3,847,110,957,101,2021-01-05 08:25:06
102,72,2,548,71,619,102,2021-01-05 11:28:19
103,99,2,898,116,1014,103,2021-01-05 09:53:58
104,600,3,1127,146,1273,104,2021-01-05 12:43:20
105,7,2,1098,142,1240,105,2021-01-05 12:20:15
106,417,3,1027,133,1160,106,2021-01-05 14:48:01
107,603,3,558,72,630,107,2021-01-05 14:03:42
108,163,3,1127,146,1273,108,2021-01-05 14:58:23
109,227,3,747,97,844,109,2021-01-05 14:06:18
110,474,5,1156,150,1306,110,2021-01-05 17:10:30
111,701,3,428,55,483,111,2021-01-05 16:30:31
112,162,2,698,90,788,112,2021-01-05 17:11:51
113,198,3,1047,136,1183,113,2021-01-05 17:25:50
114,596,3,927,120,1047,114,2021-01-05 18:26:59
115,148,4,1446,187,1633,115,2021-01-05 18:30:46
116,346,3,997,129,1126,116,2021-01-05 20:14:42
117,359,2,898,116,1014,117,2021-01-05 20:21:30
118,172,3,688,89,777,118,2021-01-05 20:46:12
119,514,3,927,120,1047,119,2021-01-05 22:22:01
120,819,3,897,116,1013,120,2021-01-05 21:26:38
121,995,3,1027,133,1160,121,2021-01-05 22:55:29
122,455,3,697,90,787,122,2021-01-05 22:30:46
123,779,2,598,77,675,123,2021-01-06 00:53:06
124,265,3,1047,136,1183,124,2021-01-05 23:43:08
125,633,3,608,79,687,125,2021-01-06 01:27:36
126,147,3,747,97,844,126,2021-01-06 01:11:26
127,349,6,1444,187,1631,127,2021-01-06 01:56:42
128,657,5,1226,159,1385,128,2021-01-06 01:44:17
129,84,3,658,85,743,129,2021-01-06 04:37:02
130,506,2,659,85,744,130,2021-01-06 03:03:57
131,829,2,459,59,518,131,2021-01-06 05:18:13
132,658,2,1098,142,1240,132,2021-01-06 04:58:50
133,231,2,498,64,562,133,2021-01-06 05:22:46
134,238,6,1424,185,1609,134,2021-01-06 07:45:14
135,964,3,808,105,913,135,2021-01-06 08:04:02
136,852,3,597,77,674,136,2021-01-06 09:07:14
137,833,3,478,62,540,137,2021-01-06 10:33:55
138,529,3,597,77,674,138,2021-01-06 10:10:49
139,497,3,558,72,630,139,2021-01-06 12:48:54
140,411,2,598,77,675,140,2021-01-06 11:21:14
141,908,3,1127,146,1273,141,2021-01-06 13:46:40
142,646,3,727,94,821,142,2021-01-06 12:07:16
143,820,4,1626,211,1837,143,2021-01-06 16:04:24
144,938,2,548,71,619,144,2021-01-06 12:22:53
145,662,4,846,109,955,145,2021-01-06 17:58:32
146,297,3,808,105,913,146,2021-01-06 13:56:26
147,198,2,498,64,562,147,2021-01-06 19:04:47
148,240,3,558,72,630,148,2021-01-06 15:35:16
149,7,1,149,19,168,149,2021-01-06 19:16:25
150,639,3,608,79,687,150,2021-01-06 17:39:03
151,249,3,578,75,653,151,2021-01-06 19:42:52
152,360,1,499,64,563,152,2021-01-06 19:57:50
153,309,3,697,90,787,153,2021-01-06 21:09:48
154,302,5,1545,200,1745,154,2021-01-06 20:51:44
155,152,3,827,107,934,155,2021-01-06 23:34:43
156,908,3,797,103,900,156,2021-01-06 23:33:16
157,456,2,628,81,709,157,2021-01-07 01:26:52
158,584,2,659,85,744,158,2021-01-07 00:09:07
159,444,3,478,62,540,159,2021-01-07 03:46:26
160,786,3,758,98,856,160,2021-01-07 02:51:30
161,124,4,896,116,1012,161,2021-01-07 04:29:24
162,189,2,898,116,1014,162,2021-01-07 04:40:47
163,515,3,747,97,844,163,2021-01-07 05:21:51
164,584,2,1098,142,1240,164,2021-01-07 05:26:41
165,982,3,897,116,1013,165,2021-01-07 05:29:59
166,701,6,1574,204,1778,166,2021-01-07 07:29:11
167,169,3,1027,133,1160,167,2021-01-07 07:01:50
168,754,3,997,129,1126,168,2021-01-07 08:29:17
169,693,3,1197,155,1352,169,2021-01-07 08:07:55
170,777,1,149,19,168,170,2021-01-07 09:56:39
171,315,3,558,72,630,171,2021-01-07 08:40:19
172,196,3,1197,155,1352,172,2021-01-07 11:35:39
173,295,3,727,94,821,173,2021-01-07 11:03:14
174,309,3,1127,146,1273,174,2021-01-07 12:13:51
175,972,1,399,51,450,175,2021-01-07 13:28:17
176,272,3,747,97,844,176,2021-01-07 14:34:42
177,365,3,927,120,1047,177,2021-01-07 14:31:10
178,376,3,1327,172,1499,178,2021-01-07 17:01:00
179,292,2,798,103,901,179,2021-01-07 15:04:14
180,647,3,558,72,630,180,2021-01-07 17:51:46
181,316,5,1087,141,1228,181,2021-01-07 16:55:08
182,428,1,99,12,111,182,2021-01-07 18:55:37
183,424,3,827,107,934,183,2021-01-07 17:56:49
184,204,2,698,90,788,184,2021-01-07 21:23:25
185,476,6,1474,191,1665,185,2021-01-07 19:44:56
186,970,2,698,90,788,186,2021-01-07 22:06:56
187,183,2,1098,142,1240,187,2021-01-07 19:58:19
188,869,2,1098,142,1240,188,2021-01-07 23:04:11
189,801,3,997,129,1126,189,2021-01-07 21:44:28
190,929,5,1076,139,1215,190,2021-01-08 00:56:55
191,378,6,1854,241,2095,191,2021-01-07 23:59:44
192,815,5,1026,133,1159,192,2021-01-08 03:20:48
193,389,5,1117,145,1262,193,2021-01-08 02:02:35
194,814,3,597,77,674,194,2021-01-08 06:02:59
195,756,4,1346,174,1520,195,2021-01-08 02:49:33
196,422,3,747,97,844,196,2021-01-08 08:40:02
197,915,2,429,55,484,197,2021-01-08 03:11:35
198,481,2,498,64,562,198,2021-01-08 09:26:41
199,663,3,1247,162,1409,199,2021-01-08 05:47:13
200,957,2,748,97,845,200,2021-01-08 11:26:05
201,32,3,1327,172,1499,201,2021-01-08 07:45:48
202,439,5,1245,161,1406,202,2021-01-08 11:58:24
203,152,3,947,123,1070,203,2021-01-08 08:27:56
204,315,2,528,68,596,204,2021-01-08 13:14:35
205,234,3,558,72,630,205,2021-01-08 09:49:16
206,227,2,798,103,901,206,2021-01-08 15:26:52
207,473,6,2094,272,2366,207,2021-01-08 11:15:30
208,222,2,648,84,732,208,2021-01-08 17:31:52
209,149,5,1355,176,1531,209,2021-01-08 13:01:11
210,482,5,1195,155,1350,210,2021-01-08 19:00:45
211,78,3,947,123,1070,211,2021-01-08 14:33:52
212,14,3,1327,172,1499,212,2021-01-08 19:04:55
213,927,2,598,77,675,213,2021-01-08 15:51:40
214,353,5,1156,150,1306,214,2021-01-08 20:15:14
215,685,3,608,79,687,215,2021-01-08 17:36:34
216,545,3,647,84,731,216,2021-01-08 22:55:23
217,279,2,898,116,1014,217,2021-01-08 18:05:29
218,931,3,558,72,630,218,2021-01-08 23:56:17
219,370,5,1695,220,1915,219,2021-01-08 19:29:34
220,246,3,827,107,934,220,2021-01-09 01:14:58
221,508,3,578,75,653,221,2021-01-08 21:40:18
222,462,3,997,129,1126,222,2021-01-09 01:42:16
223,232,5,1645,213,1858,223,2021-01-08 22:52:56
224,726,2,498,64,562,224,2021-01-09 03:14:23
225,478,3,827,107,934,225,2021-01-09 01:37:18
226,672,1,149,19,168,226,2021-01-09 05:51:56
227,268,3,997,129,1126,227,2021-01-09 03:49:29
228,97,3,827,107,934,228,2021-01-09 08:34:03
229,992,1,599,77,676,229,2021-01-09 05:44:52
230,299,2,598,77,675,230,2021-01-09 10:49:51
231,902,2,548,71,619,231,2021-01-09 05:51:09
232,564,3,797,103,900,232,2021-01-09 13:06:25
233,974,5,1456,189,1645,233,2021-01-09 06:06:58
234,80,3,528,68,596,234,2021-01-09 14:44:17
235,315,3,528,68,596,235,2021-01-09 06:41:22
236,817,3,558,72,630,236,2021-01-09 14:51:38
237,143,3,827,107,934,237,2021-01-09 06:49:39
238,864,3,827,107,934,238,2021-01-09 16:09:49
239,128,3,1327,172,1499,239,2021-01-09 08:39:10
240,414,3,478,62,540,240,2021-01-09 17:43:52
241,725,3,1127,146,1273,241,2021-01-09 09:08:26
242,273,2,1098,142,1240,242,2021-01-09 19:20:45
243,668,3,558,72,630,243,2021-01-09 09:44:18
244,825,3,608,79,687,244,2021-01-09 20:29:08
245,187,2,1098,142,1240,245,2021-01-09 11:37:25
246,910,2,498,64,562,246,2021-01-09 21:30:29
247,766,3,528,68,596,247,2021-01-09 13:06:21
248,511,3,747,97,844,248,2021-01-09 22:38:55
249,968,6,1605,208,1813,249,2021-01-09 14:02:05
250,706,2,898,116,1014,250,2021-01-10 00:17:50
251,144,3,597,77,674,251,2021-01-09 14:09:45
252,300,6,1544,200,1744,252,2021-01-10 00:56:31
253,460,3,1247,162,1409,253,2021-01-09 15:39:36
254,261,3,1247,162,1409,254,2021-01-10 02:10:06
255,360,3,658,85,743,255,2021-01-09 17:09:33
256,385,2,798,103,901,256,2021-01-10 02:17:32
257,513,3,1127,146,1273,257,2021-01-09 18:52:58
258,799,3,808,105,913,258,2021-01-10 04:25:47
259,531,3,888,115,1003,259,2021-01-09 20:43:00
260,154,3,797,103,900,260,2021-01-10 06:06:35
261,303,4,1346,174,1520,261,2021-01-09 20:46:51
262,226,3,1027,133,1160,262,2021-01-10 07:20:50
263,621,2,498,64,562,263,2021-01-09 22:32:23
264,85,2,848,110,958,264,2021-01-10 10:02:53
265,764,2,498,64,562,265,2021-01-09 23:22:59
266,702,3,827,107,934,266,2021-01-10 11:16:03
267,912,3,947,123,1070,267,2021-01-10 00:34:43
268,178,1,399,51,450,268,2021-01-10 14:00:41
269,808,3,658,85,743,269,2021-01-10 03:11:33
270,665,3,428,55,483,270,2021-01-10 16:41:38
271,376,3,697,90,787,271,2021-01-10 04:14:49
272,228,2,498,64,562,272,2021-01-10 18:02:22
273,187,3,608,79,687,273,2021-01-10 05:17:11
274,395,6,1036,134,1170,274,2021-01-10 18:30:29
275,927,2,848,110,958,275,2021-01-10 06:42:12
276,425,1,99,12,111,276,2021-01-10 18:50:49
277,871,3,697,90,787,277,2021-01-10 08:53:09
278,153,3,697,90,787,278,2021-01-10 20:28:39
279,989,3,558,72,630,279,2021-01-10 11:08:12
280,354,3,478,62,540,280,2021-01-10 22:51:36
281,52,3,997,129,1126,281,2021-01-10 12:02:31
282,401,3,697,90,787,282,2021-01-11 00:55:45
283,908,2,698,90,788,283,2021-01-10 14:29:27
284,201,2,659,85,744,284,2021-01-11 02:12:38
285,35,2,898,116,1014,285,2021-01-10 16:58:22
286,567,3,608,79,687,286,2021-01-11 04:29:42
287,339,5,1386,180,1566,287,2021-01-10 17:46:09
288,197,3,827,107,934,288,2021-01-11 05:09:04
289,941,3,897,116,1013,289,2021-01-10 19:27:24
290,879,3,897,116,1013,290,2021-01-11 06:31:10
291,950,3,558,72,630,291,2021-01-10 20:10:59
292,656,2,498,64,562,292,2021-01-11 07:41:59
293,75,2,598,77,675,293,2021-01-10 22:42:28
294,566,2,598,77,675,294,2021-01-11 08:57:53
295,529,3,997,129,1126,295,2021-01-11 01:08:01
296,422,2,798,103,901,296,2021-01-11 11:26:11
297,339,3,747,97,844,297,2021-01-11 01:38:58
298,128,3,897,116,1013,298,2021-01-11 13:50:23
299,861,3,808,105,913,299,2021-01-11 03:03:31
300,763,2,698,90,788,300,2021-01-11 14:21:05
301,5,3,1197,155,1352,301,2021-01-11 03:47:44
302,744,3,797,103,900,302,2021-01-11 16:45:01
303,659,5,1625,211,1836,303,2021-01-11 04:12:20
304,964,2,459,59,518,304,2021-01-11 19:09:52
305,243,3,428,55,483,305,2021-01-11 04:33:54
306,610,3,727,94,821,306,2021-01-11 20:15:29
307,737,3,758,98,856,307,2021-01-11 06:51:08
308,114,3,1247,162,1409,308,2021-01-11 21:35:20
309,157,5,1325,172,1497,309,2021-01-11 08:02:00
310,427,2,748,97,845,310,2021-01-11 21:52:08
311,94,3,927,120,1047,311,2021-01-11 09:26:31
312,259,5,1445,187,1632,312,2021-01-11 23:38:31
313,810,2,898,116,1014,313,2021-01-11 11:41:59
314,466,3,1127,146,1273,314,2021-01-12 00:17:59
315,551,2,659,85,744,315,2021-01-11 12:36:23
316,82,2,898,116,1014,316,2021-01-12 00:50:36
317,18,3,697,90,787,317,2021-01-11 15:02:18
318,909,3,888,115,1003,318,2021-01-12 03:35:11
319,153,3,808,105,913,319,2021-01-11 15:24:21
320,609,3,697,90,787,320,2021-01-12 05:00:52
321,260,2,459,59,518,321,2021-01-11 17:40:47
322,449,3,608,79,687,322,2021-01-12 05:03:45
323,883,5,1256,163,1419,323,2021-01-11 18:12:28
324,578,2,598,77,675,324,2021-01-12 05:58:46
325,475,4,1626,211,1837,325,2021-01-11 18:46:58
326,304,3,827,107,934,326,2021-01-12 07:52:01
327,260,3,947,123,1070,327,2021-01-11 19:08:21
328,130,3,847,110,957,328,2021-01-12 09:38:15
329,706,3,1127,146,1273,329,2021-01-11 20:55:18
330,734,3,827,107,934,330,2021-01-12 11:01:49
331,803,3,428,55,483,331,2021-01-11 23:06:52
332,247,2,459,59,518,332,2021-01-12 12:57:09
333,416,3,927,120,1047,333,2021-01-11 23:18:02
334,167,3,827,107,934,334,2021-01-12 14:08:21
335,792,3,608,79,687,335,2021-01-12 01:56:56
336,659,3,1327,172,1499,336,2021-01-12 16:15:08
337,650,2,459,59,518,337,2021-01-12 04:06:29
338,153,5,1645,213,1858,338,2021-01-12 18:33:45
339,879,3,1127,146,1273,339,2021-01-12 05:42:43
340,643,3,688,89,777,340,2021-01-12 20:08:46
341,296,3,888,115,1003,341,2021-01-12 07:38:40
342,623,3,688,89,777,342,2021-01-12 22:50:51
343,498,3,888,115,1003,343,2021-01-12 09:39:15
344,298,2,429,55,484,344,2021-01-13 00:07:07
345,358,3,1047,136,1183,345,2021-01-12 10:40:10
346,944,4,1196,155,1351,346,2021-01-13 01:44:03
347,96,2,898,116,1014,347,2021-01-12 11:31:03
348,910,2,798,103,901,348,2021-01-13 03:38:19
349,783,3,997,129,1126,349,2021-01-12 12:15:58
350,679,2,498,64,562,350,2021-01-13 06:05:37
351,821,2,598,77,675,351,2021-01-12 14:29:35
352,479,3,1247,162,1409,352,2021-01-13 08:21:20
353,565,2,928,120,1048,353,2021-01-12 16:31:27
354,932,3,747,97,844,354,2021-01-13 09:52:25
355,263,2,598,77,675,355,2021-01-12 18:02:53
356,377,1,229,29,258,356,2021-01-13 11:05:18
357,880,5,1606,208,1814,357,2021-01-12 20:23:20
358,951,3,608,79,687,358,2021-01-13 11:22:25
359,960,2,598,77,675,359,2021-01-12 20:43:01
360,436,1,149,19,168,360,2021-01-13 13:31:29
361,848,2,898,116,1014,361,2021-01-12 21:16:18
362,756,2,429,55,484,362,2021-01-13 15:30:32
363,823,6,1555,202,1757,363,2021-01-12 22:36:15
364,334,3,888,115,1003,364,2021-01-13 16:16:38
365,709,2,898,116,1014,365,2021-01-13 00:20:42
366,347,3,997,129,1126,366,2021-01-13 16:52:27
367,550,2,429,55,484,367,2021-01-13 02:30:32
368,908,3,727,94,821,368,2021-01-13 18:05:56
369,939,3,927,120,1047,369,2021-01-13 03:09:27
370,951,2,548,71,619,370,2021-01-13 19:39:01
371,99,2,659,85,744,371,2021-01-13 05:35:21
372,266,2,659,85,744,372,2021-01-13 20:35:56
373,750,3,578,75,653,373,2021-01-13 05:49:29
374,648,3,658,85,743,374,2021-01-13 20:59:35
375,893,2,828,107,935,375,2021-01-13 06:00:09
376,538,3,747,97,844,376,2021-01-13 21:19:48
377,674,2,1098,142,1240,377,2021-01-13 07:05:42
378,50,2,598,77,675,378,2021-01-13 22:52:11
379,504,3,727,94,821,379,2021-01-13 09:02:36
380,204,3,947,123,1070,380,2021-01-13 23:40:52
381,891,1,229,29,258,381,2021-01-13 09:02:54
382,41,3,647,84,731,382,2021-01-14 00:28:31
383,434,3,1027,133,1160,383,2021-01-13 11:42:38
384,912,2,429,55,484,384,2021-01-14 02:29:22
385,912,2,429,55,484,384,2021-01-14 02:29:22
386,277,3,897,116,1013,385,2021-01-13 13:16:49
387,454,2,698,90,788,386,2021-01-14 03:31:03
388,208,3,478,62,540,387,2021-01-14 02:42:44
389,170,2,598,77,675,388,2021-01-13 14:47:44
390,917,5,1386,180,1566,389,2021-01-14 03:32:59
391,307,2,429,55,484,390,2021-01-14 05:21:37
392,827,3,997,129,1126,391,2021-01-13 16:18:50
393,364,3,927,120,1047,392,2021-01-14 05:49:02
394,922,6,1405,182,1587,393,2021-01-14 05:23:02
395,10,2,598,77,675,394,2021-01-13 18:14:10
396,979,3,1047,136,1183,395,2021-01-14 08:12:51
397,470,3,647,84,731,396,2021-01-14 06:55:10
398,11,3,797,103,900,397,2021-01-13 19:40:18
399,553,3,1027,133,1160,398,2021-01-14 09:17:37
400,669,3,658,85,743,399,2021-01-14 07:33:52
401,322,2,498,64,562,400,2021-01-13 20:28:11
402,74,2,598,77,675,401,2021-01-14 10:30:24
403,252,3,888,115,1003,402,2021-01-14 08:25:36
404,709,2,798,103,901,403,2021-01-13 22:17:37
405,593,3,827,107,934,404,2021-01-14 12:26:30
406,574,1,399,51,450,405,2021-01-14 08:27:57
407,885,3,578,75,653,406,2021-01-13 23:19:37
408,28,3,697,90,787,407,2021-01-14 13:02:31
409,370,4,1057,137,1194,408,2021-01-14 09:26:32
410,929,2,898,116,1014,409,2021-01-14 01:42:23
411,561,3,1327,172,1499,410,2021-01-14 14:29:33
412,228,3,947,123,1070,411,2021-01-14 11:06:23
413,18,3,827,107,934,412,2021-01-14 02:42:24
414,185,2,528,68,596,413,2021-01-14 15:56:34
415,662,3,558,72,630,414,2021-01-14 13:50:25
416,544,3,947,123,1070,415,2021-01-14 04:00:49
417,447,5,1345,174,1519,416,2021-01-14 16:29:41
418,671,3,1047,136,1183,417,2021-01-14 15:03:50
419,733,5,1425,185,1610,418,2021-01-14 05:59:42
420,425,2,329,42,371,419,2021-01-14 17:28:23
421,989,3,897,116,1013,420,2021-01-14 17:43:04
422,58,3,1247,162,1409,421,2021-01-14 06:28:32
423,889,2,698,90,788,422,2021-01-14 19:23:25
424,907,5,1495,194,1689,423,2021-01-14 18:05:14
425,512,3,927,120,1047,424,2021-01-14 06:43:54
426,311,3,947,123,1070,425,2021-01-14 21:02:26
427,381,3,727,94,821,426,2021-01-14 18:32:48
428,129,3,558,72,630,427,2021-01-14 06:59:37
429,789,3,827,107,934,428,2021-01-14 22:58:44
430,496,2,828,107,935,429,2021-01-14 19:52:51
431,615,3,1327,172,1499,430,2021-01-14 07:44:05
432,21,2,329,42,371,431,2021-01-15 00:08:03
433,749,3,558,72,630,432,2021-01-14 21:06:44
434,440,4,1326,172,1498,433,2021-01-14 08:22:42
435,628,2,828,107,935,434,2021-01-15 00:27:13
436,410,2,698,90,788,435,2021-01-14 23:16:43
437,135,3,847,110,957,436,2021-01-14 08:49:33
438,197,3,808,105,913,437,2021-01-15 00:37:44
439,12,6,2254,293,2547,438,2021-01-15 00:35:58
440,126,3,1047,136,1183,439,2021-01-14 10:49:32
441,125,3,1127,146,1273,440,2021-01-15 01:37:53
442,562,5,1825,237,2062,441,2021-01-15 01:02:14
443,269,3,428,55,483,442,2021-01-14 12:20:11
444,40,3,697,90,787,443,2021-01-15 02:30:44
445,242,3,747,97,844,444,2021-01-15 02:43:49
446,358,1,149,19,168,445,2021-01-14 14:53:37
447,323,1,399,51,450,446,2021-01-15 04:17:14
448,543,3,808,105,913,447,2021-01-15 03:20:37
449,139,2,828,107,935,448,2021-01-14 15:23:35
450,382,3,888,115,1003,449,2021-01-15 05:58:57
451,661,5,1506,195,1701,450,2021-01-15 03:35:11
452,157,5,1595,207,1802,451,2021-01-14 15:57:58
453,926,4,1296,168,1464,452,2021-01-15 06:11:38
454,18,3,827,107,934,453,2021-01-15 05:09:13
455,36,2,459,59,518,454,2021-01-14 17:54:54
456,40,6,1735,225,1960,455,2021-01-15 07:21:20
457,499,2,498,64,562,456,2021-01-15 07:32:23
458,26,3,747,97,844,457,2021-01-14 19:40:18
459,716,3,747,97,844,458,2021-01-15 09:21:54
460,840,3,558,72,630,459,2021-01-15 09:07:18
461,297,3,747,97,844,460,2021-01-14 20:15:12
462,262,3,1047,136,1183,461,2021-01-15 11:30:21
463,656,6,1466,190,1656,462,2021-01-15 10:54:54
464,572,3,997,129,1126,463,2021-01-14 21:50:57
465,913,2,548,71,619,464,2021-01-15 12:22:24
466,913,2,548,71,619,464,2021-01-15 12:22:24
467,839,3,897,116,1013,465,2021-01-15 11:47:50
468,71,4,1396,181,1577,466,2021-01-14 22:49:38
469,183,2,848,110,958,467,2021-01-15 14:21:51
470,383,3,688,89,777,468,2021-01-15 14:55:59
471,39,3,1127,146,1273,469,2021-01-15 12:53:58
472,956,2,798,103,901,470,2021-01-15 01:19:55
473,956,2,798,103,901,470,2021-01-15 01:19:55
474,737,2,1098,142,1240,471,2021-01-15 14:51:51
475,769,5,1545,200,1745,472,2021-01-15 16:39:26
476,979,3,808,105,913,473,2021-01-15 15:06:57
477,857,2,498,64,562,474,2021-01-15 04:00:07
478,346,6,1566,203,1769,475,2021-01-15 02:05:21
479,149,3,897,116,1013,476,2021-01-15 15:31:28
480,270,3,647,84,731,477,2021-01-15 17:26:30
481,180,2,898,116,1014,478,2021-01-15 15:33:26
482,121,2,598,77,675,479,2021-01-15 05:22:53
483,360,3,808,105,913,480,2021-01-15 04:15:00
484,223,1,229,29,258,481,2021-01-15 17:12:07
485,523,3,827,107,934,482,2021-01-15 17:36:42
486,60,3,558,72,630,483,2021-01-15 17:27:44
487,527,3,997,129,1126,484,2021-01-15 06:37:50
488,640,2,598,77,675,485,2021-01-15 06:27:36
489,724,3,827,107,934,486,2021-01-15 19:27:52
490,113,3,747,97,844,487,2021-01-15 18:17:59
491,709,3,808,105,913,488,2021-01-15 19:44:27
492,794,3,1127,146,1273,489,2021-01-15 08:16:44
493,506,3,558,72,630,490,2021-01-15 07:44:58
494,885,6,1444,187,1631,491,2021-01-15 21:22:14
495,337,5,1176,152,1328,492,2021-01-15 19:16:32
496,377,3,997,129,1126,493,2021-01-15 22:04:21
497,615,3,578,75,653,494,2021-01-15 09:11:30
498,967,4,1296,168,1464,495,2021-01-15 09:30:59
499,489,3,808,105,913,496,2021-01-16 00:04:33
500,113,2,928,120,1048,497,2021-01-15 20:00:49
501,104,2,598,77,675,498,2021-01-16 00:44:23
502,552,5,1176,152,1328,499,2021-01-15 10:54:43
503,988,2,459,59,518,500,2021-01-15 10:30:12
504,906,3,597,77,674,501,2021-01-16 01:31:59
505,793,3,947,123,1070,502,2021-01-15 22:10:58
506,900,3,528,68,596,503,2021-01-16 01:20:33
507,370,5,2045,265,2310,504,2021-01-15 11:09:05
508,911,2,398,51,449,505,2021-01-15 12:07:08
509,323,3,1127,146,1273,506,2021-01-16 02:15:37
510,338,3,428,55,483,507,2021-01-15 22:49:52
511,958,2,828,107,935,508,2021-01-16 01:25:32
512,925,3,947,123,1070,509,2021-01-15 11:20:59
513,642,1,229,29,258,510,2021-01-15 12:08:19
514,642,1,229,29,258,510,2021-01-15 12:08:19
515,87,3,578,75,653,511,2021-01-16 03:10:47
516,205,2,598,77,675,512,2021-01-15 23:44:43
517,463,2,329,42,371,513,2021-01-16 02:11:14
518,196,3,697,90,787,514,2021-01-15 12:48:20
519,568,3,428,55,483,515,2021-01-15 14:52:48
520,87,3,558,72,630,516,2021-01-15 14:13:12
521,988,2,329,42,371,517,2021-01-16 03:26:51
522,403,3,827,107,934,518,2021-01-16 01:10:32
523,772,2,459,59,518,519,2021-01-16 02:43:17
524,29,3,758,98,856,520,2021-01-15 15:30:57
525,764,3,927,120,1047,521,2021-01-15 15:55:24
526,300,2,459,59,518,522,2021-01-15 16:45:29
527,386,3,578,75,653,523,2021-01-16 04:06:29
528,536,3,1027,133,1160,524,2021-01-16 02:49:14
529,161,1,399,51,450,525,2021-01-16 02:58:46
530,884,2,698,90,788,526,2021-01-15 16:10:03
531,262,2,898,116,1014,527,2021-01-15 17:24:40
532,972,3,658,85,743,528,2021-01-15 16:48:58
533,550,2,429,55,484,529,2021-01-16 05:32:42
534,321,3,1127,146,1273,530,2021-01-16 05:12:14
535,459,2,498,64,562,531,2021-01-16 03:17:01
536,569,2,898,116,1014,532,2021-01-15 18:19:55
537,847,3,647,84,731,533,2021-01-15 19:16:39
538,782,3,997,129,1126,534,2021-01-15 19:16:50
539,555,2,698,90,788,535,2021-01-16 06:41:54
540,537,3,658,85,743,536,2021-01-16 07:36:16
541,635,3,1327,172,1499,537,2021-01-16 04:03:01
542,559,5,1906,247,2153,538,2021-01-15 20:38:29
543,454,6,1515,196,1711,539,2021-01-15 20:07:09
544,12,3,647,84,731,540,2021-01-15 19:34:59
545,682,2,429,55,484,541,2021-01-16 09:00:32
546,204,3,827,107,934,542,2021-01-16 08:30:19
547,732,2,659,85,744,543,2021-01-16 05:54:28
548,443,3,578,75,653,544,2021-01-15 22:16:14
549,387,4,1146,148,1294,545,2021-01-15 22:07:45
550,577,3,558,72,630,546,2021-01-15 21:08:14
551,601,3,1047,136,1183,547,2021-01-16 10:37:40
552,942,2,728,94,822,548,2021-01-16 10:16:30
553,420,2,548,71,619,549,2021-01-16 06:24:01
554,889,1,499,64,563,550,2021-01-16 00:38:07
555,85,3,897,116,1013,551,2021-01-16 00:45:47
556,354,2,459,59,518,552,2021-01-15 22:34:44
557,933,2,828,107,935,553,2021-01-16 12:11:05
558,557,1,229,29,258,554,2021-01-16 12:44:53
559,760,4,1446,187,1633,555,2021-01-16 06:44:43
560,994,3,658,85,743,556,2021-01-16 02:33:51
561,558,5,1406,182,1588,557,2021-01-16 01:28:23
562,521,3,927,120,1047,558,2021-01-15 22:56:07
563,831,3,997,129,1126,559,2021-01-16 14:12:18
564,864,3,1127,146,1273,560,2021-01-16 14:46:53
565,925,2,898,116,1014,561,2021-01-16 07:00:44
566,958,2,598,77,675,562,2021-01-16 04:55:13
567,764,2,498,64,562,563,2021-01-16 01:37:59
568,286,2,498,64,562,564,2021-01-16 01:42:46
569,987,5,1326,172,1498,565,2021-01-16 15:52:50
570,8,2,598,77,675,566,2021-01-16 16:53:08
571,796,5,1276,165,1441,567,2021-01-16 08:20:19
572,176,3,827,107,934,568,2021-01-16 06:17:42
573,433,3,997,129,1126,569,2021-01-16 03:41:40
574,722,2,329,42,371,570,2021-01-16 03:33:45
575,578,2,498,64,562,571,2021-01-16 16:35:14
576,132,2,598,77,675,572,2021-01-16 17:04:38
577,9,2,598,77,675,573,2021-01-16 11:01:24
578,400,3,747,97,844,574,2021-01-16 07:49:56
579,365,2,798,103,901,575,2021-01-16 05:24:28
580,987,2,898,116,1014,576,2021-01-16 03:42:39
581,411,2,928,120,1048,577,2021-01-16 19:07:33
582,88,3,1047,136,1183,578,2021-01-16 18:01:48
583,36,5,1795,233,2028,579,2021-01-16 11:53:10
584,323,3,947,123,1070,580,2021-01-16 08:41:40
585,114,2,928,120,1048,581,2021-01-16 07:03:20
586,434,3,528,68,596,582,2021-01-16 04:37:58
587,636,2,898,116,1014,583,2021-01-16 19:40:42
588,405,4,927,120,1047,584,2021-01-16 19:06:01
589,537,3,897,116,1013,585,2021-01-16 13:35:58
590,998,3,597,77,674,586,2021-01-16 09:15:20
591,496,4,927,120,1047,587,2021-01-16 07:49:57
592,553,3,797,103,900,588,2021-01-16 07:22:26
593,138,3,558,72,630,589,2021-01-16 20:47:58
594,346,3,747,97,844,590,2021-01-16 19:35:29
595,727,3,578,75,653,591,2021-01-16 15:52:08
596,799,3,578,75,653,592,2021-01-16 11:15:23
597,662,3,797,103,900,593,2021-01-16 09:08:21
598,750,3,558,72,630,594,2021-01-16 07:44:28
599,458,2,798,103,901,595,2021-01-16 20:52:48
600,596,3,947,123,1070,596,2021-01-16 22:16:59
601,350,2,898,116,1014,597,2021-01-16 18:05:27
602,531,3,1127,146,1273,598,2021-01-16 12:30:40
603,268,2,798,103,901,599,2021-01-16 09:14:57
604,624,3,528,68,596,600,2021-01-16 10:05:54
605,943,3,747,97,844,601,2021-01-16 23:37:10
606,168,3,697,90,787,602,2021-01-17 00:31:02
607,689,2,898,116,1014,603,2021-01-16 20:41:43
608,658,2,728,94,822,604,2021-01-16 13:12:48
609,270,3,997,129,1126,605,2021-01-16 09:23:06
610,183,2,798,103,901,606,2021-01-16 10:47:19
611,20,6,1355,176,1531,607,2021-01-17 00:57:47
612,550,3,1127,146,1273,608,2021-01-17 01:39:51
613,873,2,598,77,675,609,2021-01-16 23:06:19
614,644,5,1267,164,1431,610,2021-01-16 15:06:02
615,909,3,1197,155,1352,611,2021-01-16 09:34:35
616,815,2,598,77,675,612,2021-01-16 11:02:59
617,54,3,897,116,1013,613,2021-01-17 02:52:19
618,591,3,1247,162,1409,614,2021-01-17 02:32:43
619,561,3,888,115,1003,615,2021-01-17 01:01:38
620,517,3,608,79,687,616,2021-01-16 16:59:48
621,942,5,1256,163,1419,617,2021-01-16 10:15:16
622,615,3,1247,162,1409,618,2021-01-16 12:16:01
623,972,2,498,64,562,619,2021-01-17 03:52:39
624,85,1,699,90,789,620,2021-01-17 03:17:19
625,601,2,698,90,788,621,2021-01-17 02:19:50
626,329,3,647,84,731,622,2021-01-16 18:13:23
627,24,2,898,116,1014,623,2021-01-16 12:09:37
628,794,3,808,105,913,624,2021-01-16 12:52:54
629,133,3,947,123,1070,625,2021-01-17 04:38:22
630,329,4,1027,133,1160,626,2021-01-17 04:57:39
631,802,2,848,110,958,627,2021-01-17 04:52:59
632,231,2,459,59,518,628,2021-01-16 18:40:08
633,270,3,747,97,844,629,2021-01-16 12:14:25
634,270,3,747,97,844,629,2021-01-16 12:14:25
635,706,2,598,77,675,630,2021-01-16 13:59:40
636,557,2,429,55,484,631,2021-01-17 05:47:44
637,23,5,1725,224,1949,632,2021-01-17 06:27:35
638,443,3,697,90,787,633,2021-01-17 07:27:56
639,630,2,598,77,675,634,2021-01-16 20:46:10
640,604,3,758,98,856,635,2021-01-16 13:12:59
641,186,3,1047,136,1183,636,2021-01-16 12:21:39
642,962,3,827,107,934,637,2021-01-16 15:54:33
643,219,2,1098,142,1240,638,2021-01-17 07:27:57
644,4,5,1986,258,2244,639,2021-01-17 06:49:21
645,838,2,698,90,788,640,2021-01-17 08:08:29
646,937,3,888,115,1003,641,2021-01-16 21:45:42
647,99,5,1475,191,1666,642,2021-01-16 14:03:23
648,166,4,1496,194,1690,643,2021-01-16 12:50:10
649,61,1,229,29,258,644,2021-01-16 17:21:50
650,379,3,727,94,821,645,2021-01-17 09:51:44
651,860,1,399,51,450,646,2021-01-17 08:14:57
652,887,2,728,94,822,647,2021-01-17 09:48:05
653,119,2,898,116,1014,648,2021-01-16 23:52:27
654,124,3,688,89,777,649,2021-01-16 15:03:30
655,923,3,747,97,844,650,2021-01-16 15:24:11
656,63,2,898,116,1014,651,2021-01-16 19:59:49
657,906,6,2054,267,2321,652,2021-01-17 11:35:48
658,906,6,2054,267,2321,652,2021-01-17 11:35:48
659,990,3,747,97,844,653,2021-01-17 09:07:24
660,201,3,1047,136,1183,654,2021-01-17 10:18:39
661,716,2,498,64,562,655,2021-01-17 00:24:44
662,789,3,597,77,674,656,2021-01-16 17:34:33
663,152,2,798,103,901,657,2021-01-16 16:39:07
664,716,2,498,64,562,658,2021-01-16 20:08:44
665,905,2,598,77,675,659,2021-01-17 12:24:52
666,287,5,1276,165,1441,660,2021-01-17 14:06:08
667,950,2,498,64,562,661,2021-01-17 11:05:53
668,968,3,1127,146,1273,662,2021-01-17 10:36:57
669,472,6,1394,181,1575,663,2021-01-17 00:38:49
670,651,3,727,94,821,664,2021-01-16 17:44:20
671,738,2,459,59,518,665,2021-01-16 18:14:34
672,642,3,478,62,540,666,2021-01-16 20:21:27
673,674,2,898,116,1014,667,2021-01-17 13:50:14
674,461,6,1724,224,1948,668,2021-01-17 15:16:10
675,618,2,459,59,518,669,2021-01-17 12:25:52
676,713,2,628,81,709,670,2021-01-17 12:08:31
677,320,5,1147,149,1296,671,2021-01-17 02:36:15
678,601,2,598,77,675,672,2021-01-16 20:27:07
679,655,3,847,110,957,673,2021-01-16 20:31:29
680,245,1,149,19,168,674,2021-01-16 21:09:53
681,91,3,808,105,913,675,2021-01-17 15:24:30
682,992,3,688,89,777,676,2021-01-17 16:03:20
683,276,2,828,107,935,677,2021-01-17 13:52:29
684,666,3,1047,136,1183,678,2021-01-17 14:02:01
685,496,3,697,90,787,679,2021-01-17 02:56:47
686,390,5,1525,198,1723,680,2021-01-16 20:27:58
687,414,2,659,85,744,681,2021-01-16 21:41:02
688,752,2,498,64,562,682,2021-01-16 21:13:08
689,479,3,428,55,483,683,2021-01-17 15:25:50
690,386,2,548,71,619,684,2021-01-17 16:07:35
691,890,2,898,116,1014,685,2021-01-17 16:20:56
692,212,3,697,90,787,686,2021-01-17 14:06:49
693,243,2,598,77,675,687,2021-01-17 05:10:00
694,159,5,1426,185,1611,688,2021-01-16 21:28:54
695,820,2,459,59,518,689,2021-01-16 23:39:51
696,709,1,399,51,450,690,2021-01-16 22:10:05
697,52,3,888,115,1003,691,2021-01-17 17:05:48
698,243,3,608,79,687,692,2021-01-17 17:17:58
699,180,2,898,116,1014,693,2021-01-17 16:26:21
700,351,3,758,98,856,694,2021-01-17 15:58:23
701,971,3,1247,162,1409,695,2021-01-17 07:40:44
702,849,2,598,77,675,696,2021-01-16 22:26:46
703,591,2,898,116,1014,697,2021-01-17 01:59:14
704,833,3,688,89,777,698,2021-01-16 23:27:43
705,807,5,1795,233,2028,699,2021-01-17 19:25:52
706,985,2,698,90,788,700,2021-01-17 18:06:27
707,416,3,1247,162,1409,701,2021-01-17 19:09:48
708,478,2,898,116,1014,702,2021-01-17 16:12:26
709,11,1,399,51,450,703,2021-01-17 07:40:44
710,475,3,727,94,821,704,2021-01-16 23:07:22
711,909,1,599,77,676,705,2021-01-17 03:10:37
712,690,3,1047,136,1183,706,2021-01-16 23:54:17
713,328,3,578,75,653,707,2021-01-17 22:08:23
714,525,2,798,103,901,708,2021-01-17 18:29:41
715,661,5,1376,178,1554,709,2021-01-17 20:35:09
716,943,2,429,55,484,710,2021-01-17 18:30:49
717,294,2,659,85,744,711,2021-01-17 07:45:39
718,323,3,697,90,787,712,2021-01-16 23:47:05
719,292,3,827,107,934,713,2021-01-17 05:34:32
720,201,5,1356,176,1532,714,2021-01-17 00:17:31
721,664,3,578,75,653,715,2021-01-17 23:16:27
722,385,2,498,64,562,716,2021-01-17 20:31:51
723,894,5,1925,250,2175,717,2021-01-17 23:03:20
724,20,3,997,129,1126,718,2021-01-17 19:01:40
725,872,5,1555,202,1757,719,2021-01-17 09:11:29
726,702,3,428,55,483,720,2021-01-17 02:33:33
727,863,2,429,55,484,721,2021-01-17 07:08:18
728,658,3,847,110,957,722,2021-01-17 00:28:48
729,623,2,628,81,709,723,2021-01-18 01:32:32
730,221,1,229,29,258,724,2021-01-17 22:55:05
731,85,3,658,85,743,725,2021-01-17 23:33:57
732,517,4,907,117,1024,726,2021-01-17 19:45:49
733,61,3,947,123,1070,727,2021-01-17 11:49:26
734,933,3,997,129,1126,728,2021-01-17 03:16:22
735,42,3,558,72,630,729,2021-01-17 07:34:24
736,773,2,598,77,675,730,2021-01-17 02:42:29
737,485,1,699,90,789,731,2021-01-18 03:42:09
738,403,1,399,51,450,732,2021-01-18 00:31:45
739,244,4,1007,130,1137,733,2021-01-18 01:25:16
740,244,4,1007,130,1137,733,2021-01-18 01:25:16
741,124,5,1845,239,2084,734,2021-01-17 20:13:28
742,767,6,1935,251,2186,735,2021-01-17 13:04:03
743,420,3,888,115,1003,736,2021-01-17 03:42:50
744,562,5,2055,267,2322,737,2021-01-17 09:31:51
745,489,3,1327,172,1499,738,2021-01-17 03:49:59
746,298,1,299,38,337,739,2021-01-18 05:59:16
747,87,3,927,120,1047,740,2021-01-18 01:25:08
748,71,3,827,107,934,741,2021-01-18 02:40:56
749,497,2,498,64,562,742,2021-01-18 03:47:58
750,135,3,528,68,596,743,2021-01-17 20:17:58
751,11,5,1825,237,2062,744,2021-01-17 13:49:23
752,179,3,1047,136,1183,745,2021-01-17 04:36:40
753,898,3,947,123,1070,746,2021-01-17 09:51:10
754,432,6,1305,169,1474,747,2021-01-17 05:53:34
755,603,3,827,107,934,748,2021-01-18 07:49:45
756,28,3,697,90,787,749,2021-01-18 03:29:19
757,647,3,528,68,596,750,2021-01-18 04:56:46
758,747,2,898,116,1014,751,2021-01-18 04:11:59
759,91,2,498,64,562,752,2021-01-17 22:30:45
760,45,5,1745,226,1971,753,2021-01-17 15:41:42
761,137,3,1247,162,1409,754,2021-01-17 07:11:21
762,365,6,1305,169,1474,755,2021-01-17 12:15:26
763,390,3,558,72,630,756,2021-01-17 06:21:06
764,299,5,2145,278,2423,757,2021-01-18 08:08:54
765,351,3,797,103,900,758,2021-01-18 05:58:01
766,800,3,1327,172,1499,759,2021-01-18 07:16:24
767,817,2,598,77,675,760,2021-01-18 06:43:55
768,55,3,1047,136,1183,761,2021-01-18 00:15:46
769,707,2,459,59,518,762,2021-01-17 16:17:42
770,621,3,658,85,743,763,2021-01-17 07:58:47
771,352,3,1197,155,1352,764,2021-01-17 13:00:23
772,682,4,996,129,1125,765,2021-01-17 07:08:35
773,966,2,659,85,744,766,2021-01-18 10:43:21
774,230,5,1556,202,1758,767,2021-01-18 08:43:19
775,844,3,747,97,844,768,2021-01-18 09:45:54
776,413,3,997,129,1126,769,2021-01-18 08:47:15
777,55,2,1098,142,1240,770,2021-01-18 01:14:42
778,211,2,698,90,788,771,2021-01-17 16:55:37
779,251,5,1495,194,1689,772,2021-01-17 10:30:50
780,231,3,1127,146,1273,773,2021-01-17 15:43:20
781,314,2,598,77,675,774,2021-01-17 08:44:49
782,252,2,698,90,788,775,2021-01-18 12:13:16
783,85,5,1825,237,2062,776,2021-01-18 09:06:31
784,186,3,847,110,957,777,2021-01-18 10:13:44
785,559,3,997,129,1126,778,2021-01-18 09:03:31
786,777,3,1047,136,1183,779,2021-01-18 02:24:05
787,798,2,429,55,484,780,2021-01-17 18:03:16
788,637,2,898,116,1014,781,2021-01-17 12:19:19
789,637,2,898,116,1014,781,2021-01-17 12:19:19
790,228,3,997,129,1126,782,2021-01-17 17:25:03
791,588,2,898,116,1014,783,2021-01-17 09:46:18
792,108,3,758,98,856,784,2021-01-18 14:48:53
793,905,2,459,59,518,785,2021-01-18 09:49:41
794,313,2,598,77,675,786,2021-01-18 12:19:50
795,422,4,1426,185,1611,787,2021-01-18 11:04:33
796,700,2,459,59,518,788,2021-01-18 02:36:10
797,95,1,399,51,450,789,2021-01-17 19:30:51
798,388,3,847,110,957,790,2021-01-17 13:22:54
799,798,3,1047,136,1183,791,2021-01-17 13:01:30
800,427,3,597,77,674,792,2021-01-17 18:07:10
801,136,4,1226,159,1385,793,2021-01-17 10:27:59
802,296,3,697,90,787,794,2021-01-18 17:07:16
803,952,5,1895,246,2141,795,2021-01-18 11:21:56
804,836,2,728,94,822,796,2021-01-18 12:32:26
805,607,2,498,64,562,797,2021-01-18 11:27:19
806,942,1,149,19,168,798,2021-01-18 03:25:20
807,527,2,798,103,901,799,2021-01-17 20:55:27
808,696,3,528,68,596,800,2021-01-17 15:35:34
809,422,2,598,77,675,801,2021-01-17 13:55:51
810,387,3,1047,136,1183,802,2021-01-17 18:10:22
811,919,4,1526,198,1724,803,2021-01-17 11:34:58
812,235,3,827,107,934,804,2021-01-18 18:53:37
813,387,3,947,123,1070,805,2021-01-18 12:38:06
814,761,3,647,84,731,806,2021-01-18 13:23:57
815,446,3,1197,155,1352,807,2021-01-18 13:05:38
816,330,2,698,90,788,808,2021-01-18 05:36:52
817,788,3,947,123,1070,809,2021-01-17 21:55:53
818,880,3,727,94,821,810,2021-01-17 15:40:01
819,621,2,898,116,1014,811,2021-01-17 15:39:44
820,976,3,688,89,777,812,2021-01-17 18:35:31
821,63,1,599,77,676,813,2021-01-17 13:52:14
822,618,2,429,55,484,814,2021-01-18 20:07:28
823,636,3,727,94,821,815,2021-01-18 15:02:14
824,103,3,1247,162,1409,816,2021-01-18 15:35:30
825,188,3,478,62,540,817,2021-01-18 15:44:12
826,452,3,558,72,630,818,2021-01-18 08:17:06
827,919,3,688,89,777,819,2021-01-18 00:24:26
828,809,3,428,55,483,820,2021-01-17 15:45:18
829,985,4,1726,224,1950,821,2021-01-17 18:14:31
830,995,3,997,129,1126,822,2021-01-17 18:41:22
831,727,3,747,97,844,823,2021-01-17 13:54:05
832,892,3,558,72,630,824,2021-01-18 20:58:23
833,617,3,747,97,844,825,2021-01-18 16:19:59
834,400,1,399,51,450,826,2021-01-18 18:10:19
835,400,1,399,51,450,826,2021-01-18 18:10:19
836,627,2,598,77,675,827,2021-01-18 15:53:33
837,87,2,898,116,1014,828,2021-01-18 10:42:37
838,807,3,597,77,674,829,2021-01-18 03:08:30
839,807,1,399,51,450,830,2021-01-17 17:31:39
840,659,5,1845,239,2084,831,2021-01-17 18:20:04
841,971,3,927,120,1047,832,2021-01-17 19:40:27
842,735,3,1027,133,1160,833,2021-01-17 15:19:20
843,137,6,1794,233,2027,834,2021-01-18 21:33:30
844,884,3,697,90,787,835,2021-01-18 18:24:47
845,884,3,697,90,787,835,2021-01-18 18:24:47
846,64,3,597,77,674,836,2021-01-18 18:55:57
847,562,3,608,79,687,837,2021-01-18 19:28:22
848,204,3,658,85,743,838,2021-01-18 16:19:27
849,233,3,558,72,630,839,2021-01-18 11:29:40
850,332,3,808,105,913,840,2021-01-18 05:45:17
851,525,2,898,116,1014,841,2021-01-17 17:37:06
852,425,3,688,89,777,842,2021-01-17 18:35:25
853,501,3,1027,133,1160,843,2021-01-17 21:39:29
854,22,3,658,85,743,844,2021-01-17 15:47:16
855,379,3,727,94,821,845,2021-01-18 22:05:20
856,707,3,927,120,1047,846,2021-01-18 19:12:02
857,435,3,997,129,1126,847,2021-01-18 19:56:39
858,987,2,798,103,901,848,2021-01-18 21:18:46
859,721,3,1127,146,1273,849,2021-01-18 21:36:48
860,784,3,597,77,674,850,2021-01-18 16:36:46
861,185,3,1047,136,1183,851,2021-01-18 12:02:36
862,185,2,898,116,1014,852,2021-01-18 08:04:01
863,572,2,898,116,1014,853,2021-01-17 20:00:24
864,916,2,898,116,1014,854,2021-01-17 19:51:43
865,195,2,398,51,449,855,2021-01-17 22:53:22
866,347,2,528,68,596,856,2021-01-17 17:59:29
867,455,1,99,12,111,857,2021-01-18 23:18:56
868,4,3,647,84,731,858,2021-01-18 21:15:21
869,280,5,1476,191,1667,859,2021-01-18 22:05:25
870,88,3,808,105,913,860,2021-01-18 23:52:31
871,981,1,149,19,168,861,2021-01-19 00:11:01
872,813,2,598,77,675,862,2021-01-18 18:35:55
873,935,3,608,79,687,863,2021-01-18 13:28:44
874,223,3,808,105,913,864,2021-01-18 08:44:25
875,908,1,399,51,450,865,2021-01-17 20:33:10
876,64,3,608,79,687,866,2021-01-17 22:29:03
877,132,2,898,116,1014,867,2021-01-17 23:33:23
878,391,3,727,94,821,868,2021-01-17 18:07:45
879,902,3,827,107,934,869,2021-01-19 00:34:03
880,126,3,578,75,653,870,2021-01-18 23:59:35
881,506,2,1098,142,1240,871,2021-01-18 23:53:19
882,12,3,1027,133,1160,872,2021-01-19 00:28:39
883,474,3,827,107,934,873,2021-01-19 02:05:54
884,717,3,758,98,856,874,2021-01-18 19:19:41
885,475,3,758,98,856,875,2021-01-18 15:30:09
886,465,3,608,79,687,876,2021-01-18 10:01:59
887,337,3,808,105,913,877,2021-01-17 21:20:58
888,825,3,688,89,777,878,2021-01-17 22:53:04
889,338,3,827,107,934,879,2021-01-18 00:41:26
890,882,2,659,85,744,880,2021-01-17 20:47:38
891,80,3,1047,136,1183,881,2021-01-19 02:51:15
892,352,3,558,72,630,882,2021-01-19 01:45:25
893,14,3,747,97,844,883,2021-01-19 00:50:43
894,38,3,697,90,787,884,2021-01-19 02:40:51
895,38,3,647,84,731,885,2021-01-19 03:02:25
896,155,2,748,97,845,886,2021-01-18 19:24:34
897,70,2,1098,142,1240,887,2021-01-18 15:53:00
898,308,3,688,89,777,888,2021-01-18 10:54:27
899,308,3,688,89,777,888,2021-01-18 10:54:27
900,420,1,699,90,789,889,2021-01-17 21:38:28
901,50,3,1247,162,1409,890,2021-01-18 00:55:37
902,455,1,399,51,450,891,2021-01-18 02:03:10
903,399,3,808,105,913,892,2021-01-17 23:16:01
904,347,3,1327,172,1499,893,2021-01-19 03:15:55
905,37,3,578,75,653,894,2021-01-19 02:09:27
906,183,2,659,85,744,895,2021-01-19 03:18:48
907,247,4,1196,155,1351,896,2021-01-19 05:20:29
908,770,3,727,94,821,897,2021-01-19 04:12:36
909,513,4,888,115,1003,898,2021-01-18 21:37:19
910,770,1,149,19,168,899,2021-01-18 18:04:34
911,669,3,727,94,821,900,2021-01-18 13:30:44
912,876,2,798,103,901,901,2021-01-18 11:52:06
913,141,3,758,98,856,902,2021-01-18 00:19:23
914,322,5,1306,169,1475,903,2021-01-18 02:11:43
915,686,6,2054,267,2321,904,2021-01-18 02:45:57
916,655,2,898,116,1014,905,2021-01-18 01:06:49
917,788,3,1247,162,1409,906,2021-01-19 05:56:42
918,471,5,1706,221,1927,907,2021-01-19 04:40:26
919,267,2,1098,142,1240,908,2021-01-19 04:50:00
920,602,3,758,98,856,909,2021-01-19 07:32:59
921,446,1,99,12,111,910,2021-01-19 05:11:18
922,833,3,608,79,687,911,2021-01-18 21:50:06
923,373,3,947,123,1070,912,2021-01-18 20:10:30
924,103,3,1197,155,1352,913,2021-01-18 15:17:55
925,250,3,578,75,653,914,2021-01-18 14:06:52
926,188,1,99,12,111,915,2021-01-18 00:55:40
927,177,3,1047,136,1183,916,2021-01-18 04:30:56
928,568,3,1047,136,1183,917,2021-01-18 02:49:32
929,82,2,1098,142,1240,918,2021-01-18 02:23:42
930,741,4,696,90,786,919,2021-01-19 07:06:11
931,483,5,1406,182,1588,920,2021-01-19 07:13:27
932,49,4,1146,148,1294,921,2021-01-19 06:52:37
933,483,3,1127,146,1273,922,2021-01-19 09:08:09
934,854,2,329,42,371,923,2021-01-19 06:19:30
935,352,3,997,129,1126,924,2021-01-18 22:50:04
936,687,3,888,115,1003,925,2021-01-18 21:32:03
937,461,6,1116,145,1261,926,2021-01-18 16:08:21
938,518,2,848,110,958,927,2021-01-18 14:21:20
939,518,2,848,110,958,927,2021-01-18 14:21:20
940,252,2,898,116,1014,928,2021-01-18 01:39:18
941,772,2,329,42,371,929,2021-01-18 05:33:14
942,791,3,647,84,731,930,2021-01-18 04:33:32
943,987,3,727,94,821,931,2021-01-18 02:54:40
944,371,5,1375,178,1553,932,2021-01-19 07:54:20
945,631,3,727,94,821,933,2021-01-19 08:51:47
946,829,2,659,85,744,934,2021-01-19 07:10:21
947,356,3,888,115,1003,935,2021-01-19 10:02:54
948,720,2,528,68,596,936,2021-01-19 08:34:24
949,197,3,1127,146,1273,937,2021-01-18 23:24:51
950,700,3,1127,146,1273,938,2021-01-18 22:00:13
951,996,2,1098,142,1240,939,2021-01-18 18:31:06
952,289,2,659,85,744,940,2021-01-18 15:32:17
953,520,2,798,103,901,941,2021-01-18 17:05:44
954,579,5,1525,198,1723,942,2021-01-18 04:02:14
955,120,3,558,72,630,943,2021-01-18 05:47:12
956,564,2,548,71,619,944,2021-01-18 06:00:53
957,554,2,848,110,958,945,2021-01-18 03:03:24
958,350,6,1444,187,1631,946,2021-01-19 10:16:53
959,886,3,827,107,934,947,2021-01-19 08:55:28
960,156,3,847,110,957,948,2021-01-19 08:00:33
961,502,2,659,85,744,949,2021-01-19 11:40:23
962,638,2,598,77,675,950,2021-01-19 10:44:34
963,738,2,598,77,675,951,2021-01-18 23:40:45
964,774,3,1027,133,1160,952,2021-01-18 23:29:59
965,157,2,898,116,1014,953,2021-01-18 19:00:05
966,101,6,1275,165,1440,954,2021-01-18 15:40:32
967,568,2,659,85,744,955,2021-01-18 19:32:50
968,323,3,558,72,630,956,2021-01-18 05:24:43
969,263,4,1196,155,1351,957,2021-01-18 06:40:19
970,371,5,1326,172,1498,958,2021-01-18 07:08:59
971,715,1,699,90,789,959,2021-01-18 05:23:10
972,710,2,459,59,518,960,2021-01-19 11:05:20
973,79,3,747,97,844,961,2021-01-19 09:16:48
974,408,3,758,98,856,962,2021-01-19 10:27:52
975,673,3,847,110,957,963,2021-01-19 11:51:38
976,248,3,528,68,596,964,2021-01-19 12:37:36
977,784,2,598,77,675,965,2021-01-19 01:04:08
978,812,5,1645,213,1858,966,2021-01-19 02:04:01
979,412,3,1027,133,1160,967,2021-01-18 21:25:34
980,871,3,597,77,674,968,2021-01-18 17:00:00
981,547,3,1127,146,1273,969,2021-01-18 20:28:13
982,402,2,329,42,371,970,2021-01-18 07:50:59
983,995,3,558,72,630,971,2021-01-18 06:59:29
984,545,3,888,115,1003,972,2021-01-18 07:43:23
985,998,3,697,90,787,973,2021-01-18 07:42:57
986,117,6,1944,252,2196,974,2021-01-19 11:40:00
987,745,3,1127,146,1273,975,2021-01-19 11:16:54
988,285,5,1695,220,1915,976,2021-01-19 12:59:46
989,405,3,1047,136,1183,977,2021-01-19 12:33:59
990,803,3,847,110,957,978,2021-01-19 14:04:50
991,357,3,947,123,1070,979,2021-01-19 01:16:27
992,56,3,797,103,900,980,2021-01-19 03:05:06
993,334,2,329,42,371,981,2021-01-18 23:02:16
994,54,2,698,90,788,982,2021-01-18 18:21:27
995,188,2,1098,142,1240,983,2021-01-18 20:42:07
996,13,2,598,77,675,984,2021-01-18 10:34:55
997,229,2,498,64,562,985,2021-01-18 08:37:45
998,299,3,827,107,934,986,2021-01-18 07:47:28
999,930,2,848,110,958,987,2021-01-18 09:40:58
1000,581,3,478,62,540,988,2021-01-19 12:30:36
1001,878,3,578,75,653,989,2021-01-19 12:02:09
1002,642,2,598,77,675,990,2021-01-19 14:25:40
1003,590,3,1197,155,1352,991,2021-01-19 15:10:40
1004,361,2,648,84,732,992,2021-01-19 15:28:06
1005,572,3,888,115,1003,993,2021-01-19 01:18:07
1006,72,3,747,97,844,994,2021-01-19 03:08:58
1007,885,2,659,85,744,995,2021-01-19 01:37:12
1008,210,2,448,58,506,996,2021-01-18 19:06:10
1009,320,3,1247,162,1409,997,2021-01-18 20:43:17
1010,561,2,1098,142,1240,998,2021-01-18 11:26:34
1011,915,3,997,129,1126,999,2021-01-18 10:09:49
1012,292,3,658,85,743,1000,2021-01-18 08:43:01
1013,464,2,598,77,675,1001,2021-01-18 11:39:15
1014,419,1,399,51,450,1002,2021-01-19 14:21:28
1015,419,1,399,51,450,1002,2021-01-19 14:21:28
1016,764,3,1197,155,1352,1003,2021-01-19 14:11:03
1017,950,1,99,12,111,1004,2021-01-19 15:44:25
1018,979,3,558,72,630,1005,2021-01-19 15:52:22
1019,608,3,827,107,934,1006,2021-01-19 16:38:39
1020,230,5,987,128,1115,1007,2021-01-19 01:26:19
1021,19,2,848,110,958,1008,2021-01-19 04:42:22
1022,632,3,1247,162,1409,1009,2021-01-19 01:43:14
1023,55,1,499,64,563,1010,2021-01-18 21:34:48
1024,443,2,748,97,845,1011,2021-01-18 21:58:54
1025,23,3,797,103,900,1012,2021-01-18 12:54:07
1026,128,3,558,72,630,1013,2021-01-18 11:29:31
1027,285,3,997,129,1126,1014,2021-01-18 10:28:42
1028,918,2,429,55,484,1015,2021-01-18 12:03:41
1029,639,3,747,97,844,1016,2021-01-19 14:23:32
1030,676,2,459,59,518,1017,2021-01-19 16:54:22
1031,232,3,428,55,483,1018,2021-01-19 16:52:52
1032,228,3,727,94,821,1019,2021-01-19 17:36:47
1033,967,3,697,90,787,1020,2021-01-19 16:38:10
1034,152,3,808,105,913,1021,2021-01-19 18:44:28
1035,647,2,659,85,744,1022,2021-01-19 01:34:22
1036,948,2,459,59,518,1023,2021-01-19 07:22:43
1037,728,6,1585,206,1791,1024,2021-01-19 03:57:39
1038,240,5,1256,163,1419,1025,2021-01-18 22:16:22
1039,700,3,647,84,731,1026,2021-01-18 23:28:04
1040,359,3,747,97,844,1027,2021-01-18 15:28:23
1041,794,3,558,72,630,1028,2021-01-18 13:54:59
1042,21,6,2074,269,2343,1029,2021-01-18 11:32:27
1043,206,3,1247,162,1409,1030,2021-01-18 14:40:41
1044,492,5,1026,133,1159,1031,2021-01-19 14:30:21
1045,417,3,1047,136,1183,1032,2021-01-19 19:31:21
1046,784,3,1027,133,1160,1033,2021-01-19 17:47:16
1047,275,2,429,55,484,1034,2021-01-19 19:01:34
1048,424,2,498,64,562,1035,2021-01-19 18:11:30
1049,177,2,648,84,732,1036,2021-01-19 20:40:50
1050,742,6,1755,228,1983,1037,2021-01-19 03:09:38
1051,239,3,747,97,844,1038,2021-01-19 09:15:32
1052,207,3,747,97,844,1039,2021-01-19 04:02:18
1053,75,3,597,77,674,1040,2021-01-19 00:37:59
1054,346,4,1726,224,1950,1041,2021-01-18 23:32:22
1055,724,2,698,90,788,1042,2021-01-18 16:53:17
1056,645,3,827,107,934,1043,2021-01-18 13:58:39
1057,376,3,947,123,1070,1044,2021-01-18 13:24:30
1058,128,3,947,123,1070,1045,2021-01-18 15:26:08
1059,544,3,647,84,731,1046,2021-01-19 15:35:35
1060,857,3,558,72,630,1047,2021-01-19 20:41:36
1061,597,5,937,121,1058,1048,2021-01-19 19:11:02
1062,780,3,528,68,596,1049,2021-01-19 19:09:31
1063,191,2,598,77,675,1050,2021-01-19 20:18:27
1064,779,2,728,94,822,1051,2021-01-19 20:52:55
1065,528,2,459,59,518,1052,2021-01-19 03:15:32
1066,288,3,697,90,787,1053,2021-01-19 10:45:16
1067,504,2,429,55,484,1054,2021-01-19 04:53:04
1068,703,3,688,89,777,1055,2021-01-19 02:05:23
1069,608,2,798,103,901,1056,2021-01-19 00:52:48
1070,391,3,597,77,674,1057,2021-01-18 18:52:30
1071,776,4,896,116,1012,1058,2021-01-18 14:01:06
1072,348,2,648,84,732,1059,2021-01-18 15:04:43
1073,218,3,658,85,743,1060,2021-01-18 17:02:24
1074,100,3,847,110,957,1061,2021-01-19 18:14:34
1075,777,3,997,129,1126,1062,2021-01-19 21:53:53
1076,901,2,698,90,788,1063,2021-01-19 21:16:36
1077,659,3,478,62,540,1064,2021-01-19 20:09:56
1078,86,2,459,59,518,1065,2021-01-19 21:49:58
1079,197,3,997,129,1126,1066,2021-01-19 20:55:36
1080,958,6,1524,198,1722,1067,2021-01-19 03:37:58
1081,37,4,1676,217,1893,1068,2021-01-19 11:48:41
1082,350,3,478,62,540,1069,2021-01-19 06:52:48
1083,453,3,558,72,630,1070,2021-01-19 04:25:14
1084,957,3,997,129,1126,1071,2021-01-19 01:03:13
1085,163,5,1575,204,1779,1072,2021-01-18 21:31:18
1086,308,1,149,19,168,1073,2021-01-18 14:07:33
1087,915,1,599,77,676,1074,2021-01-18 16:01:59
1088,825,3,608,79,687,1075,2021-01-18 17:46:13
1089,677,3,897,116,1013,1076,2021-01-19 20:54:43
1090,922,3,1127,146,1273,1077,2021-01-19 23:00:35
1091,89,3,747,97,844,1078,2021-01-19 22:33:59
1092,663,3,927,120,1047,1079,2021-01-19 22:26:56
1093,802,2,598,77,675,1080,2021-01-19 23:06:01
1094,988,3,997,129,1126,1081,2021-01-19 21:32:23
1095,624,3,808,105,913,1082,2021-01-19 06:10:00
1096,156,6,2124,276,2400,1083,2021-01-19 13:50:49
1097,613,2,698,90,788,1084,2021-01-19 07:19:06
1098,950,2,648,84,732,1085,2021-01-19 07:00:26
1099,703,3,727,94,821,1086,2021-01-19 01:52:57
1100,916,2,498,64,562,1087,2021-01-19 00:00:05
1101,886,2,698,90,788,1088,2021-01-18 16:23:08
1102,427,2,1098,142,1240,1089,2021-01-18 16:11:59
1103,460,3,947,123,1070,1090,2021-01-18 20:20:04
1104,572,2,398,51,449,1091,2021-01-19 21:58:33
1105,503,5,1217,158,1375,1092,2021-01-20 00:39:08
1106,842,3,597,77,674,1093,2021-01-19 23:12:11
1107,674,2,928,120,1048,1094,2021-01-20 01:06:55
1108,554,4,1496,194,1690,1095,2021-01-20 00:47:30
1109,337,2,598,77,675,1096,2021-01-19 22:00:59
1110,622,4,1037,134,1171,1097,2021-01-19 08:10:23
1111,446,3,558,72,630,1098,2021-01-19 15:05:50
1112,417,6,1355,176,1531,1099,2021-01-19 09:03:05
1113,999,2,459,59,518,1100,2021-01-19 09:09:05
1114,646,3,888,115,1003,1101,2021-01-19 02:59:58
1115,947,3,697,90,787,1102,2021-01-19 00:53:04
1116,247,2,498,64,562,1103,2021-01-18 18:30:11
1117,779,2,798,103,901,1104,2021-01-18 16:14:27
1118,137,3,558,72,630,1105,2021-01-18 20:30:12
1119,203,2,598,77,675,1106,2021-01-19 23:28:28
1120,22,2,648,84,732,1107,2021-01-20 01:50:51
1121,891,3,827,107,934,1108,2021-01-20 01:49:10
1122,999,3,697,90,787,1109,2021-01-20 03:04:30
1123,432,3,697,90,787,1110,2021-01-20 02:38:44
1124,40,2,429,55,484,1111,2021-01-19 23:16:48
1125,623,3,658,85,743,1112,2021-01-19 08:29:43
1126,511,5,937,121,1058,1113,2021-01-19 15:56:18
1127,786,3,688,89,777,1114,2021-01-19 10:28:43
1128,435,4,1096,142,1238,1115,2021-01-19 10:08:39
1129,83,5,1745,226,1971,1116,2021-01-19 04:19:47
1130,562,3,727,94,821,1117,2021-01-19 01:14:47
1131,955,3,558,72,630,1118,2021-01-18 19:25:45
1132,769,4,1587,206,1793,1119,2021-01-18 17:45:49
1133,962,5,1076,139,1215,1120,2021-01-18 21:07:38
1134,892,3,428,55,483,1121,2021-01-19 23:36:27
1135,282,3,658,85,743,1122,2021-01-20 01:52:19
1136,826,3,747,97,844,1123,2021-01-20 02:49:49
1137,304,3,1247,162,1409,1124,2021-01-20 03:17:38
1138,145,3,1047,136,1183,1125,2021-01-20 04:15:21
1139,353,5,1456,189,1645,1126,2021-01-20 00:20:06
1140,566,3,558,72,630,1127,2021-01-19 08:42:29
1141,430,3,997,129,1126,1128,2021-01-19 18:34:21
1142,440,3,1197,155,1352,1129,2021-01-19 11:15:53
1143,203,3,658,85,743,1130,2021-01-19 11:00:00
1144,11,3,478,62,540,1131,2021-01-19 04:58:19
1145,571,3,697,90,787,1132,2021-01-19 02:49:37
1146,965,2,329,42,371,1133,2021-01-18 21:42:17
1147,24,2,898,116,1014,1134,2021-01-18 18:37:20
1148,659,2,898,116,1014,1135,2021-01-18 22:50:11
1149,914,3,1327,172,1499,1136,2021-01-20 02:01:29
1150,615,3,827,107,934,1137,2021-01-20 02:22:10
1151,788,3,578,75,653,1138,2021-01-20 03:21:13
1152,165,3,997,129,1126,1139,2021-01-20 04:09:09
1153,106,2,698,90,788,1140,2021-01-20 04:47:21
1154,155,1,399,51,450,1141,2021-01-20 02:10:50
1155,860,2,898,116,1014,1142,2021-01-19 10:21:34
1156,968,3,558,72,630,1143,2021-01-19 20:07:53
1157,843,2,1098,142,1240,1144,2021-01-19 11:40:34
1158,745,1,699,90,789,1145,2021-01-19 13:33:51
1159,65,1,499,64,563,1146,2021-01-19 05:39:24
1160,328,3,947,123,1070,1147,2021-01-19 04:46:17
1161,485,2,498,64,562,1148,2021-01-18 23:40:11
1162,92,3,558,72,630,1149,2021-01-18 20:04:06
1163,384,6,1805,234,2039,1150,2021-01-19 00:19:42
1164,490,3,947,123,1070,1151,2021-01-20 03:00:59
1165,932,3,808,105,913,1152,2021-01-20 02:28:08
1166,637,3,1247,162,1409,1153,2021-01-20 05:36:45
1167,691,2,898,116,1014,1154,2021-01-20 05:28:17
1168,691,2,898,116,1014,1154,2021-01-20 05:28:17
1169,213,1,699,90,789,1155,2021-01-20 05:29:03
1170,213,1,699,90,789,1155,2021-01-20 05:29:03
1171,440,3,697,90,787,1156,2021-01-20 02:56:36
1172,328,3,558,72,630,1157,2021-01-19 11:28:26
1173,352,3,827,107,934,1158,2021-01-19 20:25:28
1174,554,5,2095,272,2367,1159,2021-01-19 13:51:47
1175,179,3,1047,136,1183,1160,2021-01-19 15:04:28
1176,885,3,608,79,687,1161,2021-01-19 05:57:23
1177,870,3,797,103,900,1162,2021-01-19 06:09:37
1178,632,6,1575,204,1779,1163,2021-01-19 00:41:48
1179,785,3,747,97,844,1164,2021-01-18 21:00:37
1180,799,4,1157,150,1307,1165,2021-01-19 02:00:25
1181,364,2,659,85,744,1166,2021-01-20 03:29:20
1182,837,3,827,107,934,1167,2021-01-20 04:33:33
1183,979,2,1098,142,1240,1168,2021-01-20 05:38:16
1184,633,3,888,115,1003,1169,2021-01-20 05:34:47
1185,24,3,688,89,777,1170,2021-01-20 07:29:15
1186,587,3,597,77,674,1171,2021-01-20 06:16:20
1187,733,1,499,64,563,1172,2021-01-20 06:01:17
1188,643,4,1646,213,1859,1173,2021-01-20 05:01:05
1189,508,3,1047,136,1183,1174,2021-01-19 13:00:36
1190,363,3,827,107,934,1175,2021-01-19 22:45:10
1191,146,3,797,103,900,1176,2021-01-19 15:03:16
1192,616,5,1686,219,1905,1177,2021-01-19 15:07:02
1193,309,3,688,89,777,1178,2021-01-19 07:19:49
1194,803,5,1675,217,1892,1179,2021-01-19 07:22:24
1195,919,2,329,42,371,1180,2021-01-19 03:28:11
1196,585,5,1276,165,1441,1181,2021-01-18 21:05:02
1197,267,2,598,77,675,1182,2021-01-19 02:33:36
1198,475,3,747,97,844,1183,2021-01-20 06:03:14
1199,285,2,898,116,1014,1184,2021-01-20 06:45:04
1200,933,2,1098,142,1240,1185,2021-01-20 06:22:28
1201,956,3,827,107,934,1186,2021-01-20 07:00:56
1202,318,3,597,77,674,1187,2021-01-20 08:32:26
1203,290,3,1127,146,1273,1188,2021-01-20 08:40:00
1204,449,2,329,42,371,1189,2021-01-20 06:08:04
1205,722,1,499,64,563,1190,2021-01-20 05:10:36
1206,319,1,699,90,789,1191,2021-01-19 14:40:14
1207,631,2,598,77,675,1192,2021-01-19 23:30:49
1208,594,3,1327,172,1499,1193,2021-01-19 16:53:51
1209,641,2,329,42,371,1194,2021-01-19 17:07:50
1210,370,2,898,116,1014,1195,2021-01-19 08:18:43
1211,553,3,747,97,844,1196,2021-01-19 08:23:56
1212,271,2,898,116,1014,1197,2021-01-19 04:29:17
1213,141,2,498,64,562,1198,2021-01-18 22:10:38
1214,334,2,1098,142,1240,1199,2021-01-19 05:04:57
1215,986,2,1098,142,1240,1200,2021-01-20 08:07:42
1216,954,6,1455,189,1644,1201,2021-01-20 08:27:13
1217,92,3,1197,155,1352,1202,2021-01-20 07:53:40
1218,715,3,558,72,630,1203,2021-01-20 07:11:57
1219,428,3,847,110,957,1204,2021-01-20 10:54:31
1220,614,3,927,120,1047,1205,2021-01-20 10:12:51
1221,844,3,578,75,653,1206,2021-01-20 06:35:24
1222,400,3,897,116,1013,1207,2021-01-20 06:29:56
1223,750,2,798,103,901,1208,2021-01-19 16:16:38
1224,499,2,728,94,822,1209,2021-01-20 00:40:19
1225,95,6,1654,215,1869,1210,2021-01-19 18:02:43
1226,627,3,1047,136,1183,1211,2021-01-19 18:27:24
1227,361,2,498,64,562,1212,2021-01-19 11:04:46
1228,86,3,697,90,787,1213,2021-01-19 10:16:16
1229,89,3,1197,155,1352,1214,2021-01-19 04:43:16
1230,893,3,558,72,630,1215,2021-01-18 23:06:59
1231,342,3,1127,146,1273,1216,2021-01-19 07:17:59
1232,986,3,647,84,731,1217,2021-01-20 08:59:36
1233,718,2,498,64,562,1218,2021-01-20 08:28:17
1234,330,2,798,103,901,1219,2021-01-20 08:00:19
1235,761,1,229,29,258,1220,2021-01-20 09:11:52
1236,282,3,997,129,1126,1221,2021-01-20 11:42:05
1237,241,3,1047,136,1183,1222,2021-01-20 10:53:25
1238,894,3,847,110,957,1223,2021-01-20 07:47:12
1239,797,3,808,105,913,1224,2021-01-20 06:30:21
1240,82,5,1306,169,1475,1225,2021-01-19 17:08:01
1241,931,5,1426,185,1611,1226,2021-01-20 01:00:27
1242,460,3,578,75,653,1227,2021-01-19 19:28:44
1243,929,2,598,77,675,1228,2021-01-19 18:52:19
1244,115,2,329,42,371,1229,2021-01-19 12:53:41
1245,400,2,498,64,562,1230,2021-01-19 12:23:29
1246,173,1,499,64,563,1231,2021-01-19 05:24:58
1247,960,2,748,97,845,1232,2021-01-19 01:06:35
1248,254,2,498,64,562,1233,2021-01-19 09:04:59
1249,89,2,659,85,744,1234,2021-01-20 10:20:43
1250,813,4,957,124,1081,1235,2021-01-20 10:04:56
1251,348,2,698,90,788,1236,2021-01-20 10:14:30
1252,47,3,747,97,844,1237,2021-01-20 11:09:40
1253,998,3,747,97,844,1238,2021-01-20 11:42:49
1254,940,3,927,120,1047,1239,2021-01-20 11:17:21
1255,124,2,659,85,744,1240,2021-01-20 09:07:48
1256,516,3,827,107,934,1241,2021-01-20 07:06:57
1257,17,3,747,97,844,1242,2021-01-19 17:22:59
1258,649,2,598,77,675,1243,2021-01-20 01:14:14
1259,528,5,1126,146,1272,1244,2021-01-19 21:04:33
1260,73,2,548,71,619,1245,2021-01-19 21:01:21
1261,369,3,597,77,674,1246,2021-01-19 15:30:06
1262,156,3,808,105,913,1247,2021-01-19 14:29:43
1263,235,6,1216,158,1374,1248,2021-01-19 07:17:42
1264,582,3,847,110,957,1249,2021-01-19 01:13:46
1265,67,3,697,90,787,1250,2021-01-19 09:22:08
1266,449,2,498,64,562,1251,2021-01-20 10:59:33
1267,469,5,1725,224,1949,1252,2021-01-20 12:03:15
1268,431,3,1027,133,1160,1253,2021-01-20 12:57:03
1269,921,3,747,97,844,1254,2021-01-20 13:06:29
1270,850,3,697,90,787,1255,2021-01-20 13:35:52
1271,376,2,659,85,744,1256,2021-01-20 13:04:39
1272,217,3,927,120,1047,1257,2021-01-20 10:06:43
1273,1,3,797,103,900,1258,2021-01-20 08:30:12
1274,340,4,877,114,991,1259,2021-01-19 19:33:53
1275,425,2,798,103,901,1260,2021-01-20 02:16:37
1276,853,3,1197,155,1352,1261,2021-01-19 22:22:09
1277,671,5,1436,186,1622,1262,2021-01-19 23:34:58
1278,657,3,608,79,687,1263,2021-01-19 17:22:23
1279,994,3,428,55,483,1264,2021-01-19 16:21:52
1280,406,2,659,85,744,1265,2021-01-19 08:42:26
1281,883,3,1027,133,1160,1266,2021-01-19 02:14:10
1282,822,2,528,68,596,1267,2021-01-19 10:37:49
1283,809,3,478,62,540,1268,2021-01-20 11:00:05
1284,80,1,699,90,789,1269,2021-01-20 13:42:43
1285,424,3,697,90,787,1270,2021-01-20 13:36:36
1286,15,4,1587,206,1793,1271,2021-01-20 13:40:17
1287,260,3,658,85,743,1272,2021-01-20 14:21:21
1288,125,3,558,72,630,1273,2021-01-20 14:52:19
1289,724,2,598,77,675,1274,2021-01-20 11:50:40
1290,540,3,1247,162,1409,1275,2021-01-20 09:57:18
1291,689,3,658,85,743,1276,2021-01-19 19:36:03
1292,339,2,459,59,518,1277,2021-01-20 04:42:57
1293,706,2,798,103,901,1278,2021-01-20 00:39:30
1294,317,2,498,64,562,1279,2021-01-20 00:35:45
1295,23,2,698,90,788,1280,2021-01-19 18:06:57
1296,391,6,1624,211,1835,1281,2021-01-19 18:50:31
1297,345,2,798,103,901,1282,2021-01-19 10:18:03
1298,24,2,898,116,1014,1283,2021-01-19 04:12:56
1299,474,5,1925,250,2175,1284,2021-01-19 12:40:23
1300,492,3,847,110,957,1285,2021-01-20 13:27:47
1301,917,2,1098,142,1240,1286,2021-01-20 15:29:50
1302,836,2,329,42,371,1287,2021-01-20 14:18:10
1303,85,2,1098,142,1240,1288,2021-01-20 15:03:38
1304,137,2,598,77,675,1289,2021-01-20 16:22:39
1305,148,3,1047,136,1183,1290,2021-01-20 17:29:16
1306,120,6,1544,200,1744,1291,2021-01-20 14:26:10
1307,471,3,1197,155,1352,1292,2021-01-20 10:35:50
1308,716,3,1027,133,1160,1293,2021-01-19 20:42:08
1309,436,2,898,116,1014,1294,2021-01-20 04:52:47
1310,476,2,698,90,788,1295,2021-01-20 03:22:56
1311,671,3,727,94,821,1296,2021-01-20 03:17:01
1312,611,4,1246,161,1407,1297,2021-01-19 18:10:59
1313,135,4,1496,194,1690,1298,2021-01-19 19:59:06
1314,399,6,1874,243,2117,1299,2021-01-19 11:46:48
1315,216,2,429,55,484,1300,2021-01-19 04:27:55
1316,487,3,647,84,731,1301,2021-01-19 13:19:25
1317,639,3,747,97,844,1302,2021-01-20 14:50:41
1318,963,3,927,120,1047,1303,2021-01-20 17:08:59
1319,302,2,798,103,901,1304,2021-01-20 15:48:15
1320,951,3,558,72,630,1305,2021-01-20 16:02:59
1321,895,3,688,89,777,1306,2021-01-20 18:17:39
1322,375,3,847,110,957,1307,2021-01-20 19:58:15
1323,434,1,599,77,676,1308,2021-01-20 15:49:18
1324,917,2,898,116,1014,1309,2021-01-20 11:45:42
1325,161,2,598,77,675,1310,2021-01-19 22:26:35
1326,340,3,658,85,743,1311,2021-01-20 06:54:12
1327,6,3,578,75,653,1312,2021-01-20 04:06:33
1328,964,1,399,51,450,1313,2021-01-20 05:29:56
1329,404,2,459,59,518,1314,2021-01-19 18:40:22
1330,387,3,747,97,844,1315,2021-01-19 20:53:17
1331,349,2,898,116,1014,1316,2021-01-19 12:30:34
1332,391,3,608,79,687,1317,2021-01-19 07:08:40
1333,558,3,1027,133,1160,1318,2021-01-19 14:40:20
1334,529,5,1786,232,2018,1319,2021-01-20 15:09:51
1335,470,2,329,42,371,1320,2021-01-20 17:37:31
1336,420,2,429,55,484,1321,2021-01-20 15:56:11
1337,262,3,1197,155,1352,1322,2021-01-20 16:48:18
1338,585,3,947,123,1070,1323,2021-01-20 20:22:15
1339,555,2,698,90,788,1324,2021-01-20 21:56:02
1340,442,5,1225,159,1384,1325,2021-01-20 17:38:05
1341,876,2,598,77,675,1326,2021-01-20 13:42:30
1342,725,3,827,107,934,1327,2021-01-20 00:39:52
1343,24,2,498,64,562,1328,2021-01-20 08:30:22
1344,935,3,578,75,653,1329,2021-01-20 05:54:36
1345,434,3,697,90,787,1330,2021-01-20 05:44:00
1346,449,2,498,64,562,1331,2021-01-19 18:43:31
1347,29,2,329,42,371,1332,2021-01-19 21:00:20
1348,673,2,828,107,935,1333,2021-01-19 13:07:25
1349,731,3,827,107,934,1334,2021-01-19 08:18:14
1350,760,3,808,105,913,1335,2021-01-19 16:00:04
1351,505,2,628,81,709,1336,2021-01-20 16:13:38
1352,726,3,478,62,540,1337,2021-01-20 20:00:46
1353,327,2,1098,142,1240,1338,2021-01-20 17:21:11
1354,707,3,1197,155,1352,1339,2021-01-20 17:48:05
1355,397,2,598,77,675,1340,2021-01-20 22:04:06
1356,946,3,758,98,856,1341,2021-01-21 00:32:38
1357,363,3,528,68,596,1342,2021-01-20 18:52:54
1358,911,1,99,12,111,1343,2021-01-20 16:24:31
1359,618,3,558,72,630,1344,2021-01-20 01:29:40
1360,897,2,459,59,518,1345,2021-01-20 10:39:57
1361,877,3,1027,133,1160,1346,2021-01-20 07:00:52
1362,197,3,947,123,1070,1347,2021-01-20 07:44:57
1363,666,3,1127,146,1273,1348,2021-01-19 20:46:19
1364,412,2,429,55,484,1349,2021-01-19 23:40:47
1365,892,3,1247,162,1409,1350,2021-01-19 14:46:58
1366,923,2,798,103,901,1351,2021-01-19 08:30:02
1367,847,3,827,107,934,1352,2021-01-19 17:55:08
1368,265,3,1247,162,1409,1353,2021-01-20 18:09:13
1369,667,5,1206,156,1362,1354,2021-01-20 20:56:56
1370,808,1,399,51,450,1355,2021-01-20 18:36:22
1371,349,4,796,103,899,1356,2021-01-20 18:01:11
1372,120,5,1456,189,1645,1357,2021-01-20 23:44:36
1373,184,5,1295,168,1463,1358,2021-01-21 01:38:41
1374,204,2,798,103,901,1359,2021-01-20 19:52:44
1375,463,2,648,84,732,1360,2021-01-20 17:46:24
1376,689,3,697,90,787,1361,2021-01-20 02:46:12
1377,904,3,847,110,957,1362,2021-01-20 12:12:29
1378,321,3,1047,136,1183,1363,2021-01-20 07:07:25
1379,326,3,758,98,856,1364,2021-01-20 08:49:04
1380,253,4,1207,156,1363,1365,2021-01-19 21:35:03
1381,514,3,558,72,630,1366,2021-01-20 00:20:44
1382,470,2,898,116,1014,1367,2021-01-19 15:05:52
1383,581,3,688,89,777,1368,2021-01-19 10:47:30
1384,43,3,727,94,821,1369,2021-01-19 18:40:17
1385,163,3,1197,155,1352,1370,2021-01-20 20:13:09
1386,188,2,548,71,619,1371,2021-01-20 23:22:33
1387,353,2,698,90,788,1372,2021-01-20 18:45:44
1388,572,2,459,59,518,1373,2021-01-20 20:17:41
1389,790,3,747,97,844,1374,2021-01-21 01:07:38
1390,286,2,459,59,518,1375,2021-01-21 02:05:56
1391,778,3,528,68,596,1376,2021-01-20 22:00:49
1392,508,2,898,116,1014,1377,2021-01-20 19:01:47
1393,692,3,997,129,1126,1378,2021-01-20 03:14:25
1394,305,2,329,42,371,1379,2021-01-20 13:18:48
1395,221,4,1426,185,1611,1380,2021-01-20 08:19:41
1396,331,2,1098,142,1240,1381,2021-01-20 10:24:42
1397,434,2,898,116,1014,1382,2021-01-19 23:51:17
1398,73,3,1197,155,1352,1383,2021-01-20 02:18:20
1399,992,2,548,71,619,1384,2021-01-19 17:43:01
1400,450,4,1096,142,1238,1385,2021-01-19 10:49:02
1401,716,3,827,107,934,1386,2021-01-19 21:24:24
1402,773,3,1127,146,1273,1387,2021-01-20 20:53:19
1403,6,2,329,42,371,1388,2021-01-21 01:12:27
1404,32,3,688,89,777,1389,2021-01-20 20:18:14
1405,150,3,797,103,900,1390,2021-01-20 23:03:03
1406,671,4,1307,169,1476,1391,2021-01-21 02:34:10
1407,358,2,498,64,562,1392,2021-01-21 03:10:37
1408,25,2,329,42,371,1393,2021-01-20 23:26:19
1409,170,3,888,115,1003,1394,2021-01-20 21:00:30
1410,401,2,898,116,1014,1395,2021-01-20 03:31:32
1411,831,2,598,77,675,1396,2021-01-20 14:51:45
1412,720,1,229,29,258,1397,2021-01-20 08:42:45
1413,55,4,1296,168,1464,1398,2021-01-20 12:39:22
1414,832,3,997,129,1126,1399,2021-01-20 01:52:25
1415,845,3,1047,136,1183,1400,2021-01-20 02:56:54
1416,404,3,697,90,787,1401,2021-01-19 19:44:25
1417,644,2,498,64,562,1402,2021-01-19 12:05:53
1418,133,2,748,97,845,1403,2021-01-19 21:54:34
1419,729,2,898,116,1014,1404,2021-01-20 23:34:50
1420,443,3,558,72,630,1405,2021-01-21 02:50:20
1421,456,2,429,55,484,1406,2021-01-20 22:37:42
1422,273,2,1098,142,1240,1407,2021-01-20 23:48:44
1423,377,3,1047,136,1183,1408,2021-01-21 04:04:56
1424,874,1,99,12,111,1409,2021-01-21 05:15:20
1425,483,3,947,123,1070,1410,2021-01-21 00:22:00
1426,722,3,688,89,777,1411,2021-01-20 23:09:02
1427,300,3,847,110,957,1412,2021-01-20 05:02:03
1428,535,3,647,84,731,1413,2021-01-20 16:50:19
1429,807,3,1127,146,1273,1414,2021-01-20 09:44:45
1430,766,2,898,116,1014,1415,2021-01-20 13:32:25
1431,842,2,398,51,449,1416,2021-01-20 02:12:28
1432,243,2,598,77,675,1417,2021-01-20 04:42:19
1433,889,2,548,71,619,1418,2021-01-19 20:17:27
1434,956,2,659,85,744,1419,2021-01-19 14:01:53
1435,73,2,728,94,822,1420,2021-01-19 22:31:12
1436,860,2,598,77,675,1421,2021-01-21 00:18:32
1437,371,5,1495,194,1689,1422,2021-01-21 05:15:49
1438,187,2,459,59,518,1423,2021-01-20 23:11:24
1439,652,3,558,72,630,1424,2021-01-21 02:02:26
1440,961,3,897,116,1013,1425,2021-01-21 06:21:40
1441,599,3,697,90,787,1426,2021-01-21 05:45:49
1442,564,1,399,51,450,1427,2021-01-21 00:29:52
1443,670,2,459,59,518,1428,2021-01-21 00:45:16
1444,974,5,1176,152,1328,1429,2021-01-20 07:29:43
1445,484,3,1047,136,1183,1430,2021-01-20 18:25:25
1446,560,2,429,55,484,1431,2021-01-20 10:05:25
1447,946,3,1127,146,1273,1432,2021-01-20 15:54:44
1448,245,2,459,59,518,1433,2021-01-20 04:25:21
1449,25,2,698,90,788,1434,2021-01-20 06:20:22
1450,218,2,1098,142,1240,1435,2021-01-19 21:34:01
1451,218,2,1098,142,1240,1435,2021-01-19 21:34:01
1452,705,3,428,55,483,1436,2021-01-19 15:05:51
1453,352,3,997,129,1126,1437,2021-01-19 23:16:51
1454,327,5,1325,172,1497,1438,2021-01-21 02:00:54
1455,818,3,647,84,731,1439,2021-01-21 06:45:41
1456,999,3,597,77,674,1440,2021-01-21 01:57:29
1457,325,3,608,79,687,1441,2021-01-21 03:02:18
1458,989,2,598,77,675,1442,2021-01-21 07:36:06
1459,805,3,897,116,1013,1443,2021-01-21 08:24:10
1460,909,1,149,19,168,1444,2021-01-21 02:08:04
1461,26,2,798,103,901,1445,2021-01-21 03:20:39
1462,997,3,1127,146,1273,1446,2021-01-20 08:17:20
1463,955,2,598,77,675,1447,2021-01-20 19:39:43
1464,695,3,478,62,540,1448,2021-01-20 10:45:09
1465,714,3,897,116,1013,1449,2021-01-20 16:42:31
1466,115,5,1356,176,1532,1450,2021-01-20 06:55:28
1467,499,2,329,42,371,1451,2021-01-20 08:04:43
1468,731,4,1027,133,1160,1452,2021-01-19 22:00:31
1469,792,1,699,90,789,1453,2021-01-19 23:32:39
1470,154,6,1694,220,1914,1454,2021-01-19 15:29:43
1471,576,3,747,97,844,1455,2021-01-20 00:25:57
1472,15,5,1395,181,1576,1456,2021-01-21 04:24:14
1473,861,6,1794,233,2027,1457,2021-01-21 08:12:13
1474,553,5,1525,198,1723,1458,2021-01-21 02:56:08
1475,864,5,2125,276,2401,1459,2021-01-21 05:22:18
1476,840,2,528,68,596,1460,2021-01-21 09:56:01
1477,148,3,997,129,1126,1461,2021-01-21 08:42:22
1478,815,3,688,89,777,1462,2021-01-21 02:18:13
1479,202,3,1127,146,1273,1463,2021-01-21 03:44:47
1480,868,3,1127,146,1273,1464,2021-01-20 10:57:14
1481,63,2,498,64,562,1465,2021-01-20 20:47:28
1482,780,5,1056,137,1193,1466,2021-01-20 11:00:11
1483,716,6,1575,204,1779,1467,2021-01-20 18:38:22
1484,895,5,1725,224,1949,1468,2021-01-20 07:20:06
1485,407,5,1595,207,1802,1469,2021-01-20 08:09:57
1486,971,3,1047,136,1183,1470,2021-01-19 22:55:42
1487,238,2,698,90,788,1471,2021-01-19 23:42:56
1488,87,3,797,103,900,1472,2021-01-19 17:49:51
1489,130,3,758,98,856,1473,2021-01-20 01:25:22
1490,985,2,598,77,675,1474,2021-01-21 05:40:18
1491,556,3,578,75,653,1475,2021-01-21 09:56:39
1492,445,3,897,116,1013,1476,2021-01-21 03:19:29
1493,467,3,847,110,957,1477,2021-01-21 07:09:57
1494,364,3,897,116,1013,1478,2021-01-21 12:19:04
1495,982,3,927,120,1047,1479,2021-01-21 09:15:21
1496,686,2,448,58,506,1480,2021-01-21 02:36:22
1497,368,3,747,97,844,1481,2021-01-21 04:25:21
1498,427,3,758,98,856,1482,2021-01-20 13:26:18
1499,856,3,827,107,934,1483,2021-01-20 23:18:23
1500,134,3,1247,162,1409,1484,2021-01-20 12:17:36
1501,381,3,647,84,731,1485,2021-01-20 18:55:00
1502,168,2,329,42,371,1486,2021-01-20 08:04:12
1503,74,2,329,42,371,1487,2021-01-20 08:40:34
1504,326,5,1645,213,1858,1488,2021-01-20 01:14:12
1505,913,2,659,85,744,1489,2021-01-20 01:32:01
1506,173,4,727,94,821,1490,2021-01-19 20:01:05
1507,439,3,697,90,787,1491,2021-01-20 03:00:23
1508,487,3,947,123,1070,1492,2021-01-21 08:22:32
1509,567,2,329,42,371,1493,2021-01-21 12:12:09
1510,779,2,329,42,371,1494,2021-01-21 04:34:38
1511,288,3,697,90,787,1495,2021-01-21 08:36:27
1512,631,3,947,123,1070,1496,2021-01-21 13:26:45
1513,740,3,1127,146,1273,1497,2021-01-21 11:35:07
1514,180,2,459,59,518,1498,2021-01-21 03:59:15
1515,574,4,1357,176,1533,1499,2021-01-21 06:31:15
1516,861,2,1098,142,1240,1500,2021-01-20 15:19:45
1517,572,3,997,129,1126,1501,2021-01-21 00:48:02
1518,475,3,608,79,687,1502,2021-01-20 14:50:04
1519,662,5,1345,174,1519,1503,2021-01-20 20:43:19
1520,776,3,597,77,674,1504,2021-01-20 08:56:35
1521,845,3,1327,172,1499,1505,2021-01-20 09:18:55
1522,15,3,1047,136,1183,1506,2021-01-20 02:36:33
1523,557,2,498,64,562,1507,2021-01-20 02:56:03
1524,334,3,997,129,1126,1508,2021-01-19 21:32:09
1525,145,2,548,71,619,1509,2021-01-20 03:57:35
1526,775,3,847,110,957,1510,2021-01-21 08:55:18
1527,678,4,627,81,708,1511,2021-01-21 14:40:02
1528,783,3,528,68,596,1512,2021-01-21 05:22:15
1529,849,3,758,98,856,1513,2021-01-21 10:11:39
1530,424,3,758,98,856,1514,2021-01-21 14:10:19
1531,650,5,1645,213,1858,1515,2021-01-21 12:23:40
1532,992,2,459,59,518,1516,2021-01-21 04:06:41
1533,902,2,459,59,518,1517,2021-01-21 07:30:36
1534,681,3,1047,136,1183,1518,2021-01-20 17:08:06
1535,241,3,808,105,913,1519,2021-01-21 01:18:48
1536,612,2,598,77,675,1520,2021-01-20 15:43:21
1537,815,2,698,90,788,1521,2021-01-20 22:12:12
1538,689,3,1127,146,1273,1522,2021-01-20 11:19:04
1539,117,3,897,116,1013,1523,2021-01-20 09:38:00
1540,467,3,1127,146,1273,1524,2021-01-20 03:59:03
1541,368,3,927,120,1047,1525,2021-01-20 04:42:27
1542,894,3,827,107,934,1526,2021-01-20 00:18:22
1543,651,5,1425,185,1610,1527,2021-01-20 06:43:30
1544,854,3,558,72,630,1528,2021-01-21 10:03:32
1545,195,3,558,72,630,1529,2021-01-21 16:30:34
1546,154,3,1027,133,1160,1530,2021-01-21 06:47:14
1547,793,3,1197,155,1352,1531,2021-01-21 11:52:46
1548,532,2,898,116,1014,1532,2021-01-21 16:08:49
1549,985,4,1296,168,1464,1533,2021-01-21 12:56:00
1550,393,3,897,116,1013,1534,2021-01-21 05:30:28
1551,986,3,997,129,1126,1535,2021-01-21 08:03:30
1552,82,4,857,111,968,1536,2021-01-20 17:36:03
1553,384,3,688,89,777,1537,2021-01-21 02:22:16
1554,910,3,1327,172,1499,1538,2021-01-20 17:14:09
1555,368,5,1475,191,1666,1539,2021-01-20 22:30:34
1556,617,3,1027,133,1160,1540,2021-01-20 12:39:26
1557,946,3,1247,162,1409,1541,2021-01-20 11:33:35
1558,321,3,927,120,1047,1542,2021-01-20 05:45:08
1559,740,1,299,38,337,1543,2021-01-20 05:43:25
1560,177,3,997,129,1126,1544,2021-01-20 01:46:02
1561,827,4,1196,155,1351,1545,2021-01-20 09:01:21
1562,641,5,1545,200,1745,1546,2021-01-21 12:17:29
1563,247,3,528,68,596,1547,2021-01-21 17:04:05
1564,437,2,329,42,371,1548,2021-01-21 08:36:17
1565,737,4,1207,156,1363,1549,2021-01-21 14:20:57
1566,535,3,647,84,731,1550,2021-01-21 16:37:19
1567,395,6,2015,261,2276,1551,2021-01-21 13:55:21
1568,188,3,558,72,630,1552,2021-01-21 06:52:54
1569,155,2,598,77,675,1553,2021-01-21 10:12:36
1570,457,2,329,42,371,1554,2021-01-20 20:19:08
1571,388,3,428,55,483,1555,2021-01-21 02:56:19
1572,907,2,698,90,788,1556,2021-01-20 19:35:29
1573,123,3,1027,133,1160,1557,2021-01-21 00:11:38
1574,416,2,598,77,675,1558,2021-01-20 15:19:17
1575,233,3,658,85,743,1559,2021-01-20 13:32:45
1576,90,5,1395,181,1576,1560,2021-01-20 06:17:50
1577,363,2,329,42,371,1561,2021-01-20 06:22:10
1578,295,2,1098,142,1240,1562,2021-01-20 02:25:23
1579,979,2,598,77,675,1563,2021-01-20 10:58:03
1580,199,3,808,105,913,1564,2021-01-21 13:55:34
1581,664,3,808,105,913,1565,2021-01-21 17:57:45
1582,319,3,1247,162,1409,1566,2021-01-21 10:06:43
1583,435,2,848,110,958,1567,2021-01-21 15:50:09
1584,538,2,429,55,484,1568,2021-01-21 19:19:25
1585,239,3,697,90,787,1569,2021-01-21 16:33:38
1586,350,3,597,77,674,1570,2021-01-21 08:10:06
1587,754,2,828,107,935,1571,2021-01-21 12:51:44
1588,799,3,1047,136,1183,1572,2021-01-20 21:12:45
1589,2,3,428,55,483,1573,2021-01-21 03:20:12
1590,313,3,758,98,856,1574,2021-01-20 20:56:45
1591,781,2,598,77,675,1575,2021-01-21 02:00:46
1592,535,3,597,77,674,1576,2021-01-20 16:24:42
1593,924,3,997,129,1126,1577,2021-01-20 14:47:55
1594,953,3,558,72,630,1578,2021-01-20 06:37:01
1595,744,3,1197,155,1352,1579,2021-01-20 08:12:41
1596,212,1,499,64,563,1580,2021-01-20 03:21:06
1597,185,3,758,98,856,1581,2021-01-20 11:32:26
1598,560,3,797,103,900,1582,2021-01-21 15:26:38
1599,190,5,1226,159,1385,1583,2021-01-21 19:22:51
1600,370,4,887,115,1002,1584,2021-01-21 10:58:29
1601,304,3,1027,133,1160,1585,2021-01-21 17:29:01
1602,740,2,659,85,744,1586,2021-01-21 20:34:53
1603,108,2,798,103,901,1587,2021-01-21 18:12:36
1604,723,6,1494,194,1688,1588,2021-01-21 10:19:26
1605,579,3,528,68,596,1589,2021-01-21 13:14:17
1606,617,5,1625,211,1836,1590,2021-01-20 22:57:46
1607,207,2,459,59,518,1591,2021-01-21 04:25:29
1608,103,3,847,110,957,1592,2021-01-20 21:05:16
1609,729,3,688,89,777,1593,2021-01-21 02:22:44
1610,729,3,688,89,777,1593,2021-01-21 02:22:44
1611,585,4,1396,181,1577,1594,2021-01-20 18:28:35
1612,235,2,698,90,788,1595,2021-01-20 17:25:28
1613,436,2,459,59,518,1596,2021-01-20 06:43:37
1614,572,3,747,97,844,1597,2021-01-20 10:00:34
1615,931,3,1197,155,1352,1598,2021-01-20 05:46:26
1616,315,3,897,116,1013,1599,2021-01-20 13:16:41
1617,702,6,1854,241,2095,1600,2021-01-21 15:43:14
1618,454,3,688,89,777,1601,2021-01-21 21:22:22
1619,688,3,528,68,596,1602,2021-01-21 11:28:31
1620,176,1,499,64,563,1603,2021-01-21 18:32:42
1621,519,1,399,51,450,1604,2021-01-21 21:34:50
1622,583,2,898,116,1014,1605,2021-01-21 18:45:09
1623,818,3,827,107,934,1606,2021-01-21 10:56:29
1624,816,3,997,129,1126,1607,2021-01-21 15:48:25
1625,318,2,659,85,744,1608,2021-01-20 23:40:54
1626,64,3,827,107,934,1609,2021-01-21 04:27:07
1627,103,3,558,72,630,1610,2021-01-20 22:38:09
1628,714,3,847,110,957,1611,2021-01-21 05:00:07
1629,4,3,1027,133,1160,1612,2021-01-21 04:44:34
1630,63,5,1436,186,1622,1613,2021-01-20 19:03:56
1631,458,3,428,55,483,1614,2021-01-20 18:48:18
1632,685,3,797,103,900,1615,2021-01-20 06:46:20
1633,439,3,697,90,787,1616,2021-01-20 10:35:35
1634,222,3,888,115,1003,1617,2021-01-20 07:39:56
1635,22,3,747,97,844,1618,2021-01-20 15:23:43
1636,955,5,1295,168,1463,1619,2021-01-21 15:48:07
1637,199,2,498,64,562,1620,2021-01-21 23:20:37
1638,83,3,1047,136,1183,1621,2021-01-21 12:53:48
1639,274,3,1197,155,1352,1622,2021-01-21 19:03:39
1640,782,2,598,77,675,1623,2021-01-21 23:41:37
1641,313,2,928,120,1048,1624,2021-01-21 20:00:59
1642,770,3,608,79,687,1625,2021-01-21 11:15:53
1643,88,2,828,107,935,1626,2021-01-21 16:07:19
1644,998,2,429,55,484,1627,2021-01-21 01:21:36
1645,520,3,1197,155,1352,1628,2021-01-21 04:37:24
1646,164,2,898,116,1014,1629,2021-01-20 23:06:26
1647,33,2,1098,142,1240,1630,2021-01-21 05:24:05
1648,833,5,1736,225,1961,1631,2021-01-21 05:16:13
1649,122,1,149,19,168,1632,2021-01-20 20:48:20
1650,808,2,498,64,562,1633,2021-01-20 19:27:50
1651,568,2,898,116,1014,1634,2021-01-20 09:20:26
1652,565,2,798,103,901,1635,2021-01-20 10:40:35
1653,492,5,1725,224,1949,1636,2021-01-20 08:22:14
1654,860,3,947,123,1070,1637,2021-01-20 17:23:56
1655,388,3,747,97,844,1638,2021-01-21 16:22:39
1656,505,3,1197,155,1352,1639,2021-01-21 23:36:14
1657,355,3,747,97,844,1640,2021-01-21 14:20:11
1658,68,3,1027,133,1160,1641,2021-01-21 20:14:11
1659,462,3,797,103,900,1642,2021-01-22 01:05:09
1660,740,2,329,42,371,1643,2021-01-21 20:13:14
1661,554,3,1247,162,1409,1644,2021-01-21 12:11:47
1662,968,5,1256,163,1419,1645,2021-01-21 16:43:04
1663,818,5,1345,174,1519,1646,2021-01-21 03:17:03
1664,794,3,827,107,934,1647,2021-01-21 04:41:05
1665,647,1,229,29,258,1648,2021-01-20 23:54:53
1666,483,3,1047,136,1183,1649,2021-01-21 05:45:05
1667,24,6,1644,213,1857,1650,2021-01-21 07:15:24
1668,975,3,997,129,1126,1651,2021-01-20 23:30:04
1669,648,3,697,90,787,1652,2021-01-20 21:41:02
1670,827,3,1047,136,1183,1653,2021-01-20 11:56:28
1671,69,3,827,107,934,1654,2021-01-20 12:48:45
1672,915,3,528,68,596,1655,2021-01-20 09:55:15
1673,27,2,898,116,1014,1656,2021-01-20 18:04:41
1674,166,2,398,51,449,1657,2021-01-21 16:56:58
1675,165,2,898,116,1014,1658,2021-01-22 00:06:09
1676,854,2,698,90,788,1659,2021-01-21 17:03:58
1677,257,3,1127,146,1273,1660,2021-01-21 22:57:58
1678,158,2,429,55,484,1661,2021-01-22 02:09:03
1679,638,3,558,72,630,1662,2021-01-21 20:18:30
1680,527,3,597,77,674,1663,2021-01-21 14:33:24
1681,638,5,1395,181,1576,1664,2021-01-21 19:14:36
1682,733,2,648,84,732,1665,2021-01-21 03:44:22
1683,222,3,428,55,483,1666,2021-01-21 05:44:20
1684,56,2,598,77,675,1667,2021-01-21 00:11:27
1685,652,1,399,51,450,1668,2021-01-21 08:24:45
1686,150,3,688,89,777,1669,2021-01-21 08:55:42
1687,893,3,478,62,540,1670,2021-01-20 23:42:59
1688,364,3,797,103,900,1671,2021-01-20 23:09:53
1689,88,2,898,116,1014,1672,2021-01-20 13:23:52
1690,338,2,898,116,1014,1673,2021-01-20 14:40:15
1691,396,3,897,116,1013,1674,2021-01-20 11:59:16
1692,170,3,808,105,913,1675,2021-01-20 19:22:17
1693,816,2,798,103,901,1676,2021-01-21 17:54:19
1694,761,3,947,123,1070,1677,2021-01-22 02:44:47
1695,710,3,608,79,687,1678,2021-01-21 18:47:37
1696,972,2,429,55,484,1679,2021-01-21 23:14:03
1697,594,2,1098,142,1240,1680,2021-01-22 03:29:35
1698,763,4,1046,135,1181,1681,2021-01-21 22:05:41
1699,663,3,597,77,674,1682,2021-01-21 16:55:54
1700,608,2,498,64,562,1683,2021-01-21 20:40:14
1701,895,3,888,115,1003,1684,2021-01-21 06:10:53
1702,33,3,608,79,687,1685,2021-01-21 06:46:06
1703,919,2,598,77,675,1686,2021-01-21 01:05:31
1704,919,2,598,77,675,1686,2021-01-21 01:05:31
1705,292,2,1098,142,1240,1687,2021-01-21 10:47:06
1706,980,2,898,116,1014,1688,2021-01-21 10:55:00
1707,409,1,299,38,337,1689,2021-01-21 01:51:28
1708,40,2,528,68,596,1690,2021-01-21 00:04:05
1709,545,5,1786,232,2018,1691,2021-01-20 14:13:14
1710,502,2,698,90,788,1692,2021-01-20 15:15:35
1711,629,5,1555,202,1757,1693,2021-01-20 12:10:43
1712,786,3,847,110,957,1694,2021-01-20 20:29:29
1713,847,5,1545,200,1745,1695,2021-01-21 19:00:46
1714,297,3,1247,162,1409,1696,2021-01-22 03:43:41
1715,2,6,1175,152,1327,1697,2021-01-21 20:25:41
1716,578,5,1206,156,1362,1698,2021-01-21 23:19:50
1717,875,3,1127,146,1273,1699,2021-01-22 05:55:58
1718,651,2,598,77,675,1700,2021-01-22 00:09:10
1719,136,3,697,90,787,1701,2021-01-21 18:24:49
1720,510,2,429,55,484,1702,2021-01-21 22:47:26
1721,408,3,608,79,687,1703,2021-01-21 06:18:30
1722,472,2,898,116,1014,1704,2021-01-21 08:08:07
1723,637,3,1027,133,1160,1705,2021-01-21 02:11:00
1724,992,3,558,72,630,1706,2021-01-21 03:12:35
1725,793,5,1375,178,1553,1707,2021-01-21 11:59:18
1726,954,3,558,72,630,1708,2021-01-21 10:59:06
1727,450,6,1685,219,1904,1709,2021-01-21 02:16:34
1728,305,2,459,59,518,1710,2021-01-21 01:10:57
1729,106,5,1786,232,2018,1711,2021-01-20 16:10:25
1730,738,2,659,85,744,1712,2021-01-20 17:44:46
1731,928,3,558,72,630,1713,2021-01-20 14:39:12
1732,570,3,697,90,787,1714,2021-01-20 22:06:08
1733,827,2,329,42,371,1715,2021-01-21 21:06:40
1734,135,2,498,64,562,1716,2021-01-22 05:15:59
1735,32,1,149,19,168,1717,2021-01-21 22:14:09
1736,383,2,898,116,1014,1718,2021-01-22 01:40:07
1737,780,4,1226,159,1385,1719,2021-01-22 06:19:32
1738,410,2,459,59,518,1720,2021-01-22 02:07:06
1739,934,3,997,129,1126,1721,2021-01-21 19:52:05
1740,535,3,997,129,1126,1722,2021-01-22 00:15:27
1741,182,3,697,90,787,1723,2021-01-21 08:26:07
1742,86,2,928,120,1048,1724,2021-01-21 10:22:48
1743,586,3,1047,136,1183,1725,2021-01-21 04:18:53
1744,970,2,528,68,596,1726,2021-01-21 05:02:48
1745,12,3,758,98,856,1727,2021-01-21 14:31:35
1746,519,3,847,110,957,1728,2021-01-21 12:48:46
1747,304,3,847,110,957,1729,2021-01-21 04:22:17
1748,192,3,688,89,777,1730,2021-01-21 01:56:46
1749,481,3,888,115,1003,1731,2021-01-20 16:51:34
1750,177,3,827,107,934,1732,2021-01-20 20:13:55
1751,945,2,598,77,675,1733,2021-01-20 16:16:12
1752,839,2,398,51,449,1734,2021-01-20 23:24:07
1753,538,3,827,107,934,1735,2021-01-21 23:33:43
1754,581,3,688,89,777,1736,2021-01-22 07:38:49
1755,543,3,1247,162,1409,1737,2021-01-21 23:02:47
1756,726,2,798,103,901,1738,2021-01-22 02:44:41
1757,669,3,808,105,913,1739,2021-01-22 07:31:50
1758,384,3,558,72,630,1740,2021-01-22 03:23:09
1759,799,3,827,107,934,1741,2021-01-21 20:52:20
1760,127,2,898,116,1014,1742,2021-01-22 02:13:58
1761,466,3,1247,162,1409,1743,2021-01-21 08:50:11
1762,855,6,1424,185,1609,1744,2021-01-21 10:37:14
1763,22,3,1127,146,1273,1745,2021-01-21 06:12:05
1764,876,2,598,77,675,1746,2021-01-21 07:15:30
1765,338,3,558,72,630,1747,2021-01-21 15:29:21
1766,666,2,928,120,1048,1748,2021-01-21 12:57:12
1767,75,6,1715,222,1937,1749,2021-01-21 04:34:18
1768,294,2,698,90,788,1750,2021-01-21 03:42:12
1769,715,5,1906,247,2153,1751,2021-01-20 16:53:07
1770,949,3,747,97,844,1752,2021-01-20 20:58:16
1771,308,3,1327,172,1499,1753,2021-01-20 18:28:14
1772,206,3,808,105,913,1754,2021-01-21 00:38:35
1773,72,2,598,77,675,1755,2021-01-22 01:46:38
1774,847,5,1745,226,1971,1756,2021-01-22 10:01:55
1775,247,3,558,72,630,1757,2021-01-22 01:25:00
1776,26,2,798,103,901,1758,2021-01-22 05:13:49
1777,863,3,997,129,1126,1759,2021-01-22 10:09:16
1778,988,3,578,75,653,1760,2021-01-22 05:41:08
1779,913,3,797,103,900,1761,2021-01-21 21:37:36
1780,768,3,597,77,674,1762,2021-01-22 04:27:27
1781,625,3,897,116,1013,1763,2021-01-21 10:55:02
1782,670,2,698,90,788,1764,2021-01-21 10:40:27
1783,49,3,558,72,630,1765,2021-01-21 07:04:54
1784,796,3,1327,172,1499,1766,2021-01-21 09:33:30
1785,971,2,598,77,675,1767,2021-01-21 18:03:04
1786,149,3,897,116,1013,1768,2021-01-21 14:53:34
1787,415,2,429,55,484,1769,2021-01-21 05:34:01
1788,518,5,1256,163,1419,1770,2021-01-21 05:27:16
1789,953,3,697,90,787,1771,2021-01-20 17:45:30
1790,376,5,1556,202,1758,1772,2021-01-20 21:44:13
1791,294,1,399,51,450,1773,2021-01-20 20:14:50
1792,209,3,808,105,913,1774,2021-01-21 00:38:58
1793,907,3,797,103,900,1775,2021-01-22 04:22:42
1794,627,3,797,103,900,1776,2021-01-22 10:33:37
1795,872,3,578,75,653,1777,2021-01-22 01:31:56
1796,939,2,898,116,1014,1778,2021-01-22 06:18:53
1797,377,5,1745,226,1971,1779,2021-01-22 10:56:29
1798,78,2,598,77,675,1780,2021-01-22 07:50:54
1799,675,2,429,55,484,1781,2021-01-21 22:25:16
1800,398,3,808,105,913,1782,2021-01-22 04:29:34
1801,902,3,1127,146,1273,1783,2021-01-21 13:29:38
1802,120,3,1047,136,1183,1784,2021-01-21 10:41:21
1803,48,2,598,77,675,1785,2021-01-21 08:10:22
1804,13,2,598,77,675,1786,2021-01-21 10:34:25
1805,15,2,848,110,958,1787,2021-01-21 20:04:14
1806,349,2,898,116,1014,1788,2021-01-21 16:25:03
1807,677,3,1327,172,1499,1789,2021-01-21 08:09:10
1808,492,3,827,107,934,1790,2021-01-21 07:49:21
1809,468,2,1098,142,1240,1791,2021-01-20 19:28:10
1810,380,2,728,94,822,1792,2021-01-20 22:16:15
1811,832,3,478,62,540,1793,2021-01-20 20:43:54
1812,7,3,1127,146,1273,1794,2021-01-21 02:05:29
1813,936,3,658,85,743,1795,2021-01-22 06:10:48
1814,407,3,1127,146,1273,1796,2021-01-22 11:04:36
1815,174,2,498,64,562,1797,2021-01-22 02:27:27
1816,734,1,229,29,258,1798,2021-01-22 08:05:27
1817,538,2,329,42,371,1799,2021-01-22 13:10:29
1818,398,4,1196,155,1351,1800,2021-01-22 08:02:35
1819,863,2,928,120,1048,1801,2021-01-21 23:27:40
1820,176,1,499,64,563,1802,2021-01-22 06:49:37
1821,762,3,888,115,1003,1803,2021-01-21 15:32:28
1822,587,3,608,79,687,1804,2021-01-21 13:22:24
1823,475,3,528,68,596,1805,2021-01-21 10:43:59
1824,22,3,528,68,596,1806,2021-01-21 12:50:27
1825,3,4,1246,161,1407,1807,2021-01-21 21:21:28
1826,532,3,808,105,913,1808,2021-01-21 17:18:25
1827,896,3,558,72,630,1809,2021-01-21 10:40:42
1828,795,3,897,116,1013,1810,2021-01-21 10:02:54
1829,768,6,1255,163,1418,1811,2021-01-20 20:06:03
1830,531,3,747,97,844,1812,2021-01-21 00:21:38
1831,526,3,897,116,1013,1813,2021-01-20 22:55:16
1832,726,6,2174,282,2456,1814,2021-01-21 04:40:50
1833,92,4,1027,133,1160,1815,2021-01-22 06:26:42
1834,521,2,598,77,675,1816,2021-01-22 12:40:13
1835,979,3,997,129,1126,1817,2021-01-22 04:38:51
1836,197,2,329,42,371,1818,2021-01-22 10:41:51
1837,143,3,758,98,856,1819,2021-01-22 14:22:37
1838,237,2,598,77,675,1820,2021-01-22 09:58:14
1839,645,2,459,59,518,1821,2021-01-21 23:58:04
1840,807,4,1526,198,1724,1822,2021-01-22 08:08:56
1841,811,3,758,98,856,1823,2021-01-21 16:56:20
1842,771,3,558,72,630,1824,2021-01-21 14:21:16
1843,475,2,898,116,1014,1825,2021-01-21 11:29:20
1844,327,2,429,55,484,1826,2021-01-21 14:50:46
1845,370,3,1197,155,1352,1827,2021-01-22 00:03:13
1846,93,2,698,90,788,1828,2021-01-21 17:53:55
1847,765,3,688,89,777,1829,2021-01-21 12:47:11
1848,664,1,99,12,111,1830,2021-01-21 10:25:38
1849,645,3,758,98,856,1831,2021-01-20 21:12:37
1850,167,3,758,98,856,1832,2021-01-21 01:15:40
1851,878,3,827,107,934,1833,2021-01-21 01:09:57
1852,228,3,888,115,1003,1834,2021-01-21 06:28:23
1853,309,5,1456,189,1645,1835,2021-01-22 08:06:55
1854,764,3,727,94,821,1836,2021-01-22 14:01:29
1855,707,5,1556,202,1758,1837,2021-01-22 06:29:24
1856,326,3,1247,162,1409,1838,2021-01-22 11:22:25
1857,149,2,1098,142,1240,1839,2021-01-22 15:42:44
1858,675,3,888,115,1003,1840,2021-01-22 12:19:51
1859,991,2,698,90,788,1841,2021-01-22 02:34:07
1860,589,3,688,89,777,1842,2021-01-22 10:38:50
1861,328,3,688,89,777,1843,2021-01-21 19:09:30
1862,494,2,898,116,1014,1844,2021-01-21 14:24:30
1863,976,2,598,77,675,1845,2021-01-21 13:46:03
1864,66,2,329,42,371,1846,2021-01-21 15:35:03
1865,315,3,727,94,821,1847,2021-01-22 01:56:04
1866,919,3,888,115,1003,1848,2021-01-21 18:07:31
1867,526,2,748,97,845,1849,2021-01-21 14:23:03
1868,347,2,329,42,371,1850,2021-01-21 12:32:40
1869,739,3,697,90,787,1851,2021-01-20 23:54:43
1870,647,3,688,89,777,1852,2021-01-21 01:18:46
1871,849,2,548,71,619,1853,2021-01-21 01:17:38
1872,935,3,688,89,777,1854,2021-01-21 07:12:15
1873,606,3,528,68,596,1855,2021-01-22 08:43:56
1874,109,6,1255,163,1418,1856,2021-01-22 16:06:43
1875,96,3,428,55,483,1857,2021-01-22 07:27:20
1876,611,3,947,123,1070,1858,2021-01-22 13:59:52
1877,878,2,698,90,788,1859,2021-01-22 17:46:32
1878,85,3,727,94,821,1860,2021-01-22 14:37:20
1879,828,2,628,81,709,1861,2021-01-22 05:15:00
1880,795,5,1026,133,1159,1862,2021-01-22 12:10:15
1881,157,3,747,97,844,1863,2021-01-21 20:27:04
1882,336,3,1047,136,1183,1864,2021-01-21 14:46:34
1883,713,3,558,72,630,1865,2021-01-21 14:01:30
1884,954,4,1196,155,1351,1866,2021-01-21 16:58:27
1885,701,2,848,110,958,1867,2021-01-22 04:39:27
1886,983,3,428,55,483,1868,2021-01-21 20:24:54
1887,445,2,329,42,371,1869,2021-01-21 15:09:48
1888,895,2,598,77,675,1870,2021-01-21 14:58:07
1889,671,2,798,103,901,1871,2021-01-21 00:12:51
1890,671,2,798,103,901,1871,2021-01-21 00:12:51
1891,687,3,747,97,844,1872,2021-01-21 02:11:48
1892,76,3,658,85,743,1873,2021-01-21 03:39:24
1893,664,2,898,116,1014,1874,2021-01-21 08:58:17
1894,489,1,599,77,676,1875,2021-01-22 10:46:57
1895,772,2,459,59,518,1876,2021-01-22 18:20:00
1896,903,3,1247,162,1409,1877,2021-01-22 09:04:45
1897,270,3,1047,136,1183,1878,2021-01-22 14:08:26
1898,332,3,608,79,687,1879,2021-01-22 19:25:46
1899,209,2,898,116,1014,1880,2021-01-22 16:27:13
1900,824,2,659,85,744,1881,2021-01-22 06:53:17
1901,930,2,329,42,371,1882,2021-01-22 14:09:21
1902,196,2,329,42,371,1883,2021-01-21 21:11:38
1903,680,2,798,103,901,1884,2021-01-21 16:37:37
1904,740,3,1247,162,1409,1885,2021-01-21 14:37:09
1905,476,3,647,84,731,1886,2021-01-21 19:03:32
1906,110,1,399,51,450,1887,2021-01-22 06:56:13
1907,461,5,1555,202,1757,1888,2021-01-21 22:56:54
1908,432,5,1326,172,1498,1889,2021-01-21 16:47:56
1909,994,3,1327,172,1499,1890,2021-01-21 16:38:13
1910,54,3,997,129,1126,1891,2021-01-21 01:36:10
1911,162,3,758,98,856,1892,2021-01-21 00:48:05
1912,604,3,647,84,731,1893,2021-01-21 04:04:01
1913,963,3,897,116,1013,1894,2021-01-21 03:42:18
1914,209,2,898,116,1014,1895,2021-01-21 10:55:10
1915,272,2,659,85,744,1896,2021-01-22 11:34:34
1916,624,2,598,77,675,1897,2021-01-22 18:53:41
1917,843,3,747,97,844,1898,2021-01-22 11:32:21
1918,405,3,428,55,483,1899,2021-01-22 14:42:11
1919,291,4,1426,185,1611,1900,2021-01-22 20:28:12
1920,180,3,1047,136,1183,1901,2021-01-22 17:54:24
1921,205,3,528,68,596,1902,2021-01-22 07:58:04
1922,517,3,827,107,934,1903,2021-01-22 16:08:21
1923,273,1,99,12,111,1904,2021-01-21 22:43:03
1924,559,3,608,79,687,1905,2021-01-21 17:47:58
1925,281,6,1644,213,1857,1906,2021-01-21 17:10:04
1926,696,3,927,120,1047,1907,2021-01-21 21:20:47
1927,147,2,798,103,901,1908,2021-01-22 08:36:15
1928,874,2,698,90,788,1909,2021-01-21 23:48:02
1929,238,2,498,64,562,1910,2021-01-21 17:52:22
1930,128,2,448,58,506,1911,2021-01-21 18:22:44
1931,636,2,659,85,744,1912,2021-01-21 02:38:24
1932,575,3,827,107,934,1913,2021-01-21 00:57:04
1933,853,3,947,123,1070,1914,2021-01-21 04:11:07
1934,260,2,429,55,484,1915,2021-01-21 04:44:53
1935,148,3,888,115,1003,1916,2021-01-21 13:13:23
1936,787,3,688,89,777,1917,2021-01-22 13:33:54
1937,141,2,698,90,788,1918,2021-01-22 21:12:43
1938,817,3,1127,146,1273,1919,2021-01-22 13:52:55
1939,295,2,898,116,1014,1920,2021-01-22 16:21:31
1940,260,5,1486,193,1679,1921,2021-01-22 21:08:02
1941,33,6,1305,169,1474,1922,2021-01-22 18:38:54
1942,156,6,1475,191,1666,1923,2021-01-22 10:12:50
1943,17,2,848,110,958,1924,2021-01-22 16:53:12
1944,652,5,1495,194,1689,1925,2021-01-22 01:23:10
1945,237,2,898,116,1014,1926,2021-01-21 19:01:44
1946,404,3,997,129,1126,1927,2021-01-21 17:27:52
1947,815,3,597,77,674,1928,2021-01-21 23:28:56
1948,425,2,798,103,901,1929,2021-01-22 10:23:31
1949,201,3,827,107,934,1930,2021-01-22 01:02:46
1950,856,6,1275,165,1440,1931,2021-01-21 20:09:26
1951,501,2,598,77,675,1932,2021-01-21 18:48:16
1952,77,2,459,59,518,1933,2021-01-21 05:15:57
1953,545,2,798,103,901,1934,2021-01-21 01:19:49
1954,950,3,688,89,777,1935,2021-01-21 04:50:25
1955,920,3,1247,162,1409,1936,2021-01-21 06:01:04
1956,371,2,598,77,675,1937,2021-01-21 14:34:49
1957,804,2,528,68,596,1938,2021-01-22 15:46:33
1958,604,4,977,127,1104,1939,2021-01-22 21:43:12
1959,180,3,947,123,1070,1940,2021-01-22 13:57:31
1960,52,2,628,81,709,1941,2021-01-22 18:48:46
1961,751,6,1905,247,2152,1942,2021-01-22 21:57:47
1962,509,2,329,42,371,1943,2021-01-22 18:54:50
1963,122,4,1196,155,1351,1944,2021-01-22 12:10:26
1964,399,2,798,103,901,1945,2021-01-22 19:11:30
1965,931,3,1247,162,1409,1946,2021-01-22 02:17:55
1966,49,3,897,116,1013,1947,2021-01-21 19:57:06
1967,175,5,1245,161,1406,1948,2021-01-21 19:28:36
1968,421,2,748,97,845,1949,2021-01-22 02:13:03
1969,507,3,658,85,743,1950,2021-01-22 11:13:54
1970,83,3,1197,155,1352,1951,2021-01-22 03:00:15
1971,1000,2,1098,142,1240,1952,2021-01-21 21:31:06
1972,509,2,498,64,562,1953,2021-01-21 20:33:07
1973,427,5,1555,202,1757,1954,2021-01-21 05:51:31
1974,733,3,1047,136,1183,1955,2021-01-21 02:38:14
1975,628,3,428,55,483,1956,2021-01-21 06:15:07
1976,235,6,1535,199,1734,1957,2021-01-21 08:30:03
1977,455,5,1495,194,1689,1958,2021-01-21 14:46:29
1978,310,2,459,59,518,1959,2021-01-22 17:57:28
1979,999,2,898,116,1014,1960,2021-01-23 00:00:58
1980,202,3,1247,162,1409,1961,2021-01-22 16:33:41
1981,331,3,1027,133,1160,1962,2021-01-22 19:54:51
1982,893,6,2074,269,2343,1963,2021-01-23 00:43:23
1983,768,3,478,62,540,1964,2021-01-22 21:30:17
1984,280,2,598,77,675,1965,2021-01-22 13:43:15
1985,711,2,848,110,958,1966,2021-01-22 21:04:56
1986,521,2,659,85,744,1967,2021-01-22 03:13:21
1987,417,2,498,64,562,1968,2021-01-21 21:27:20
1988,7,4,1846,239,2085,1969,2021-01-21 22:14:47
1989,708,6,1505,195,1700,1970,2021-01-22 03:14:03
1990,567,3,428,55,483,1971,2021-01-22 13:39:27
1991,672,3,697,90,787,1972,2021-01-22 03:53:41
1992,609,2,459,59,518,1973,2021-01-21 21:34:41
1993,39,4,1176,152,1328,1974,2021-01-21 22:40:15
1994,924,3,847,110,957,1975,2021-01-21 07:57:58
1995,62,2,898,116,1014,1976,2021-01-21 04:56:50
1996,988,2,598,77,675,1977,2021-01-21 08:04:28
1997,672,5,1656,215,1871,1978,2021-01-21 08:32:47
1998,697,5,1625,211,1836,1979,2021-01-21 16:19:50
1999,114,2,498,64,562,1980,2021-01-22 19:05:33
2000,671,3,697,90,787,1981,2021-01-23 00:03:05
2001,807,3,758,98,856,1982,2021-01-22 17:47:51
2002,473,3,558,72,630,1983,2021-01-22 21:02:07
2003,142,2,598,77,675,1984,2021-01-23 02:35:15
2004,679,3,1247,162,1409,1985,2021-01-22 22:59:54
2005,566,3,927,120,1047,1986,2021-01-22 15:15:10
2006,421,2,498,64,562,1987,2021-01-22 22:45:48
2007,168,2,598,77,675,1988,2021-01-22 04:36:54
2008,398,3,1327,172,1499,1989,2021-01-21 22:39:52
2009,746,3,528,68,596,1990,2021-01-21 23:45:56
2010,427,5,1445,187,1632,1991,2021-01-22 05:05:31
2011,62,2,659,85,744,1992,2021-01-22 14:39:34
2012,544,2,548,71,619,1993,2021-01-22 05:02:14
2013,15,3,558,72,630,1994,2021-01-21 22:49:19
2014,325,4,1946,252,2198,1995,2021-01-22 00:34:24
2015,680,3,1027,133,1160,1996,2021-01-21 10:05:21
2016,436,2,498,64,562,1997,2021-01-21 06:17:08
2017,562,3,758,98,856,1998,2021-01-21 09:56:33
2018,219,3,1027,133,1160,1999,2021-01-21 10:03:04
2019,436,3,1047,136,1183,2000,2021-01-21 17:42:21
2020,734,3,897,116,1013,2001,2021-01-22 20:40:45
2021,76,3,697,90,787,2002,2021-01-23 02:24:43
2022,946,5,1056,137,1193,2003,2021-01-22 19:39:04
2023,884,3,947,123,1070,2004,2021-01-22 22:25:13
2024,160,3,697,90,787,2005,2021-01-23 03:49:49
2025,873,2,498,64,562,2006,2021-01-23 00:49:52
2026,620,3,688,89,777,2007,2021-01-22 15:31:41
2027,82,5,926,120,1046,2008,2021-01-22 23:06:59
2028,362,3,697,90,787,2009,2021-01-22 05:24:30
2029,961,3,827,107,934,2010,2021-01-21 23:00:37
2030,158,3,428,55,483,2011,2021-01-22 00:53:01
2031,170,3,797,103,900,2012,2021-01-22 06:01:49
2032,304,3,578,75,653,2013,2021-01-22 15:05:01
2033,811,3,478,62,540,2014,2021-01-22 05:31:51
2034,221,3,558,72,630,2015,2021-01-21 23:11:20
2035,903,1,399,51,450,2016,2021-01-22 01:48:31
2036,408,3,558,72,630,2017,2021-01-21 10:32:43
2037,344,3,597,77,674,2018,2021-01-21 09:00:18
2038,404,3,927,120,1047,2019,2021-01-21 10:07:28
2039,305,3,888,115,1003,2020,2021-01-21 11:37:55
2040,399,6,1605,208,1813,2021,2021-01-21 19:51:26
2041,927,3,1247,162,1409,2022,2021-01-22 22:38:17
2042,34,3,797,103,900,2023,2021-01-23 03:29:00
2043,265,5,1045,135,1180,2024,2021-01-22 19:50:20
2044,667,3,797,103,900,2025,2021-01-22 23:47:11
2045,982,3,558,72,630,2026,2021-01-23 05:39:53
2046,520,3,847,110,957,2027,2021-01-23 03:33:40
2047,788,2,798,103,901,2028,2021-01-22 17:54:53
2048,608,3,827,107,934,2029,2021-01-23 01:52:14
2049,565,2,329,42,371,2030,2021-01-22 07:59:05
2050,62,2,498,64,562,2031,2021-01-22 01:26:43
2051,958,2,598,77,675,2032,2021-01-22 03:29:13
2052,977,5,1195,155,1350,2033,2021-01-22 08:01:27
2053,37,2,329,42,371,2034,2021-01-22 17:46:50
2054,396,2,1098,142,1240,2035,2021-01-22 06:37:36
2055,958,3,1047,136,1183,2036,2021-01-21 23:43:35
2056,635,2,329,42,371,2037,2021-01-22 04:27:27
2057,823,5,1525,198,1723,2038,2021-01-21 12:12:24
2058,877,3,827,107,934,2039,2021-01-21 11:29:55
2059,550,5,1345,174,1519,2040,2021-01-21 11:59:01
2060,432,3,758,98,856,2041,2021-01-21 12:43:59
2061,881,5,1825,237,2062,2042,2021-01-21 22:28:05
2062,283,2,459,59,518,2043,2021-01-23 01:04:33
2063,499,1,699,90,789,2044,2021-01-23 04:31:47
2064,265,3,1027,133,1160,2045,2021-01-22 21:56:35
2065,419,5,1975,256,2231,2046,2021-01-23 01:26:22
2066,958,5,1195,155,1350,2047,2021-01-23 08:02:02
2067,258,3,688,89,777,2048,2021-01-23 04:45:33
2068,159,3,1047,136,1183,2049,2021-01-22 20:38:30
2069,551,5,1686,219,1905,2050,2021-01-23 03:38:56
2070,73,3,528,68,596,2051,2021-01-22 09:27:38
2071,685,2,598,77,675,2052,2021-01-22 02:14:48
2072,919,3,947,123,1070,2053,2021-01-22 03:59:41
2073,266,2,648,84,732,2054,2021-01-22 09:15:22
2074,854,3,727,94,821,2055,2021-01-22 20:26:56
2075,468,3,608,79,687,2056,2021-01-22 07:55:52
2076,196,3,1127,146,1273,2057,2021-01-22 00:07:34
2077,327,5,1456,189,1645,2058,2021-01-22 05:24:27
2078,807,2,598,77,675,2059,2021-01-21 13:31:02
2079,455,3,428,55,483,2060,2021-01-21 12:11:11
2080,156,3,847,110,957,2061,2021-01-21 14:11:18
2081,674,3,747,97,844,2062,2021-01-21 14:36:43
2082,603,3,558,72,630,2063,2021-01-21 23:13:50
2083,603,3,558,72,630,2063,2021-01-21 23:13:50
2084,470,3,927,120,1047,2064,2021-01-23 03:38:05
2085,436,3,558,72,630,2065,2021-01-23 04:32:56
2086,716,3,827,107,934,2066,2021-01-22 22:51:15
2087,475,3,658,85,743,2067,2021-01-23 02:13:03
2088,501,3,478,62,540,2068,2021-01-23 08:32:33
2089,292,3,727,94,821,2069,2021-01-23 07:22:52
2090,443,3,697,90,787,2070,2021-01-22 21:15:47
2091,919,5,1725,224,1949,2071,2021-01-23 05:50:43
2092,541,5,1576,204,1780,2072,2021-01-22 12:00:58
2093,372,3,997,129,1126,2073,2021-01-22 04:11:13
2094,389,5,1395,181,1576,2074,2021-01-22 06:39:51
2095,115,3,897,116,1013,2075,2021-01-22 10:25:09
2096,747,3,827,107,934,2076,2021-01-22 21:47:32
2097,895,3,747,97,844,2077,2021-01-22 10:04:15
2098,122,3,558,72,630,2078,2021-01-22 00:51:43
2099,566,2,698,90,788,2079,2021-01-22 07:51:21
2100,858,2,459,59,518,2080,2021-01-21 15:59:43
2101,984,3,927,120,1047,2081,2021-01-21 12:29:42
2102,35,2,429,55,484,2082,2021-01-21 15:58:03
2103,900,3,558,72,630,2083,2021-01-21 16:55:58
2104,814,2,459,59,518,2084,2021-01-22 00:01:45
2105,124,3,578,75,653,2085,2021-01-21 23:43:08
2106,418,3,528,68,596,2086,2021-01-23 06:06:45
2107,331,5,1206,156,1362,2087,2021-01-23 04:34:16
2108,501,3,558,72,630,2088,2021-01-23 01:22:08
2109,711,3,1327,172,1499,2089,2021-01-23 03:04:43
2110,484,3,428,55,483,2090,2021-01-23 09:00:58
2111,765,3,997,129,1126,2091,2021-01-23 08:38:31
2112,454,3,697,90,787,2092,2021-01-22 21:18:57
2113,741,3,597,77,674,2093,2021-01-23 08:34:37
2114,921,2,429,55,484,2094,2021-01-22 12:55:46
2115,445,3,647,84,731,2095,2021-01-22 06:34:27
2116,980,3,478,62,540,2096,2021-01-22 08:06:44
2117,767,3,997,129,1126,2097,2021-01-22 10:56:20
2118,729,2,498,64,562,2098,2021-01-22 22:35:23
2119,892,2,459,59,518,2099,2021-01-22 10:08:06
2120,620,3,658,85,743,2100,2021-01-22 01:00:03
2121,62,5,1425,185,1610,2101,2021-01-22 08:21:40
2122,168,5,956,124,1080,2102,2021-01-21 17:42:49
2123,207,2,598,77,675,2103,2021-01-21 14:59:50
2124,464,3,1127,146,1273,2104,2021-01-21 16:03:53
2125,842,3,747,97,844,2105,2021-01-21 18:40:04
2126,714,2,429,55,484,2106,2021-01-22 01:08:18
2127,8,5,1595,207,1802,2107,2021-01-22 01:11:07
2128,710,6,1605,208,1813,2108,2021-01-23 08:33:21
2129,249,2,698,90,788,2109,2021-01-23 05:10:58
2130,546,3,727,94,821,2110,2021-01-23 03:54:21
2131,790,2,329,42,371,2111,2021-01-23 03:31:19
2132,361,6,2294,298,2592,2112,2021-01-23 10:26:32
2133,36,3,697,90,787,2113,2021-01-23 10:42:47
2134,565,2,798,103,901,2114,2021-01-22 22:47:31
2135,84,1,99,12,111,2115,2021-01-23 09:07:08
2136,809,3,997,129,1126,2116,2021-01-22 15:13:13
2137,428,2,459,59,518,2117,2021-01-22 06:56:28
2138,330,3,747,97,844,2118,2021-01-22 10:24:53
2139,389,3,658,85,743,2119,2021-01-22 13:15:50
2140,389,3,658,85,743,2119,2021-01-22 13:15:50
2141,675,4,1356,176,1532,2120,2021-01-22 23:51:49
2142,697,4,1626,211,1837,2121,2021-01-22 11:24:37
2143,518,3,647,84,731,2122,2021-01-22 02:44:41
2144,559,3,1127,146,1273,2123,2021-01-22 09:01:47
2145,682,6,1446,187,1633,2124,2021-01-21 19:11:13
2146,667,4,1326,172,1498,2125,2021-01-21 15:42:13
2147,495,2,459,59,518,2126,2021-01-21 16:04:22
2148,181,3,697,90,787,2127,2021-01-21 20:28:31
2149,948,2,429,55,484,2128,2021-01-22 03:49:05
2150,407,3,1047,136,1183,2129,2021-01-22 02:37:35
2151,954,3,797,103,900,2130,2021-01-23 10:39:16
2152,687,1,399,51,450,2131,2021-01-23 06:08:26
2153,45,5,1445,187,1632,2132,2021-01-23 04:02:15
2154,406,3,997,129,1126,2133,2021-01-23 03:52:02
2155,988,2,748,97,845,2134,2021-01-23 10:51:53
2156,51,3,797,103,900,2135,2021-01-23 12:55:00
2157,416,3,997,129,1126,2136,2021-01-23 00:08:45
2158,280,5,1645,213,1858,2137,2021-01-23 09:32:36
2159,287,3,947,123,1070,2138,2021-01-22 16:17:56
2160,772,3,927,120,1047,2139,2021-01-22 07:29:04
2161,159,3,747,97,844,2140,2021-01-22 11:40:31
2162,186,3,808,105,913,2141,2021-01-22 14:16:02
2163,690,3,827,107,934,2142,2021-01-22 14:48:56
2164,46,3,758,98,856,2143,2021-01-23 00:28:42
2165,550,3,428,55,483,2144,2021-01-22 12:34:37
2166,851,3,697,90,787,2145,2021-01-22 03:31:56
2167,800,3,747,97,844,2146,2021-01-22 10:06:27
2168,463,2,498,64,562,2147,2021-01-21 21:20:15
2169,11,2,598,77,675,2148,2021-01-21 18:25:11
2170,883,2,898,116,1014,2149,2021-01-21 17:37:52
2171,329,4,1596,207,1803,2150,2021-01-21 22:01:24
2172,992,3,888,115,1003,2151,2021-01-22 05:18:21
2173,652,3,1047,136,1183,2152,2021-01-22 02:45:57
2174,224,3,947,123,1070,2153,2021-01-23 11:58:14
2175,816,3,478,62,540,2154,2021-01-23 07:19:57
2176,717,3,697,90,787,2155,2021-01-23 04:14:10
2177,967,3,1327,172,1499,2156,2021-01-23 04:14:23
2178,121,3,1127,146,1273,2157,2021-01-23 11:41:23
2179,377,3,727,94,821,2158,2021-01-23 15:32:33
2180,586,2,898,116,1014,2159,2021-01-23 02:09:17
2181,100,3,827,107,934,2160,2021-01-23 09:50:28
2182,105,4,1746,226,1972,2161,2021-01-22 17:05:28
2183,709,2,329,42,371,2162,2021-01-22 10:05:08
2184,333,3,697,90,787,2163,2021-01-22 11:53:32
2185,303,3,478,62,540,2164,2021-01-22 15:45:09
2186,98,3,647,84,731,2165,2021-01-22 15:57:23
2187,680,3,747,97,844,2166,2021-01-23 02:20:30
2188,986,2,1098,142,1240,2167,2021-01-22 15:17:34
2189,173,3,808,105,913,2168,2021-01-22 06:11:59
2190,531,3,897,116,1013,2169,2021-01-22 11:48:18
2191,368,3,558,72,630,2170,2021-01-21 22:29:07
2192,194,3,827,107,934,2171,2021-01-21 19:09:49
2193,499,3,697,90,787,2172,2021-01-21 19:08:12
2194,117,3,658,85,743,2173,2021-01-21 23:06:40
2195,390,2,659,85,744,2174,2021-01-22 07:55:48
2196,106,2,798,103,901,2175,2021-01-22 05:25:06
2197,842,3,808,105,913,2176,2021-01-23 12:23:25
2198,746,5,1575,204,1779,2177,2021-01-23 07:30:16
2199,686,3,1027,133,1160,2178,2021-01-23 05:34:31
2200,831,2,898,116,1014,2179,2021-01-23 06:50:24
2201,621,3,897,116,1013,2180,2021-01-23 13:01:32
2202,800,3,558,72,630,2181,2021-01-23 17:20:33
2203,609,3,827,107,934,2182,2021-01-23 03:40:37
2204,288,3,747,97,844,2183,2021-01-23 10:38:46
2205,257,3,658,85,743,2184,2021-01-22 19:09:32
2206,191,5,1506,195,1701,2185,2021-01-22 12:15:15
2207,458,3,697,90,787,2186,2021-01-22 13:02:44
2208,957,3,1327,172,1499,2187,2021-01-22 17:47:25
2209,995,2,798,103,901,2188,2021-01-22 17:36:41
2210,938,2,728,94,822,2189,2021-01-23 03:42:29
2211,447,2,498,64,562,2190,2021-01-22 16:25:26
2212,379,3,1127,146,1273,2191,2021-01-22 06:41:03
2213,725,3,747,97,844,2192,2021-01-22 12:34:21
2214,175,3,478,62,540,2193,2021-01-21 22:52:57
2215,890,2,1098,142,1240,2194,2021-01-21 19:50:13
2216,345,4,876,113,989,2195,2021-01-21 20:12:06
2217,763,6,2174,282,2456,2196,2021-01-22 01:22:28
2218,891,3,1247,162,1409,2197,2021-01-22 10:30:42
2219,866,3,997,129,1126,2198,2021-01-22 06:16:32
2220,635,3,697,90,787,2199,2021-01-23 12:42:06
2221,465,2,698,90,788,2200,2021-01-23 08:41:54
2222,498,1,299,38,337,2201,2021-01-23 07:58:04
2223,64,3,997,129,1126,2202,2021-01-23 08:30:30
2224,392,6,1755,228,1983,2203,2021-01-23 14:55:56
2225,560,3,888,115,1003,2204,2021-01-23 18:10:55
2226,707,2,598,77,675,2205,2021-01-23 05:26:42
2227,389,3,927,120,1047,2206,2021-01-23 11:47:32
2228,560,6,1944,252,2196,2207,2021-01-22 21:38:56
2229,726,3,697,90,787,2208,2021-01-22 14:08:29
2230,704,3,727,94,821,2209,2021-01-22 13:45:31
2231,253,4,1496,194,1690,2210,2021-01-22 20:07:05
2232,835,2,698,90,788,2211,2021-01-22 19:12:13
2233,513,3,1047,136,1183,2212,2021-01-23 05:16:31
2234,905,3,847,110,957,2213,2021-01-22 18:20:30
2235,701,2,898,116,1014,2214,2021-01-22 08:31:22
2236,980,3,578,75,653,2215,2021-01-22 13:20:13
2237,118,5,1395,181,1576,2216,2021-01-21 23:38:07
2238,300,2,798,103,901,2217,2021-01-21 22:06:24
2239,423,2,628,81,709,2218,2021-01-21 21:37:59
2240,456,3,688,89,777,2219,2021-01-22 03:35:15
2241,772,3,697,90,787,2220,2021-01-22 12:17:27
2242,783,6,1855,241,2096,2221,2021-01-22 08:50:52
2243,277,2,659,85,744,2222,2021-01-23 14:30:54
2244,350,5,1245,161,1406,2223,2021-01-23 09:02:20
2245,970,2,898,116,1014,2224,2021-01-23 08:11:30
2246,584,3,927,120,1047,2225,2021-01-23 10:56:23
2247,603,3,827,107,934,2226,2021-01-23 16:42:53
2248,364,3,578,75,653,2227,2021-01-23 19:31:25
2249,276,3,428,55,483,2228,2021-01-23 07:09:20
2250,929,3,558,72,630,2229,2021-01-23 12:19:12
2251,630,3,1327,172,1499,2230,2021-01-22 23:18:46
2252,630,3,1327,172,1499,2230,2021-01-22 23:18:46
2253,507,2,659,85,744,2231,2021-01-22 15:26:18
2254,708,3,1127,146,1273,2232,2021-01-22 14:33:37
2255,765,2,329,42,371,2233,2021-01-22 20:59:17
2256,542,2,659,85,744,2234,2021-01-22 21:13:01
2257,705,3,558,72,630,2235,2021-01-23 05:28:40
2258,862,3,428,55,483,2236,2021-01-22 18:51:19
2259,176,3,428,55,483,2237,2021-01-22 09:21:18
2260,325,3,927,120,1047,2238,2021-01-22 14:51:55
2261,465,2,329,42,371,2239,2021-01-22 02:03:37
2262,770,2,598,77,675,2240,2021-01-21 23:34:36
2263,954,3,827,107,934,2241,2021-01-21 22:53:02
2264,399,2,459,59,518,2242,2021-01-22 04:20:30
2265,143,1,99,12,111,2243,2021-01-22 14:45:10
2266,960,2,429,55,484,2244,2021-01-22 08:53:41
2267,484,3,1047,136,1183,2245,2021-01-23 15:55:14
2268,391,2,498,64,562,2246,2021-01-23 09:07:06
2269,938,3,1027,133,1160,2247,2021-01-23 10:22:51
2270,163,1,229,29,258,2248,2021-01-23 13:19:30
2271,96,2,798,103,901,2249,2021-01-23 19:26:09
2272,362,3,697,90,787,2250,2021-01-23 22:12:49
2273,916,3,727,94,821,2251,2021-01-23 07:59:53
2274,439,2,728,94,822,2252,2021-01-23 14:40:28
2275,438,5,1645,213,1858,2253,2021-01-23 00:31:10
2276,381,2,598,77,675,2254,2021-01-23 00:22:45
2277,969,3,797,103,900,2255,2021-01-22 17:35:11
2278,354,2,498,64,562,2256,2021-01-22 15:52:33
2279,475,1,229,29,258,2257,2021-01-22 21:16:51
2280,771,3,1127,146,1273,2258,2021-01-22 22:21:01
2281,113,2,598,77,675,2259,2021-01-23 05:51:21
2282,957,3,658,85,743,2260,2021-01-22 20:44:38
2283,327,1,149,19,168,2261,2021-01-22 10:21:00
2284,83,3,478,62,540,2262,2021-01-22 17:18:12
2285,525,3,747,97,844,2263,2021-01-22 04:13:03
2286,322,3,827,107,934,2264,2021-01-21 23:51:37
2287,956,3,997,129,1126,2265,2021-01-22 00:42:11
2288,30,3,428,55,483,2266,2021-01-22 07:06:20
2289,421,3,697,90,787,2267,2021-01-22 16:04:16
2290,887,3,758,98,856,2268,2021-01-22 09:25:24
2291,843,3,747,97,844,2269,2021-01-23 18:38:13
2292,272,3,558,72,630,2270,2021-01-23 11:22:40
2293,353,2,498,64,562,2271,2021-01-23 10:28:23
2294,869,2,459,59,518,2272,2021-01-23 13:53:18
2295,806,3,1027,133,1160,2273,2021-01-23 19:57:02
2296,738,6,2254,293,2547,2274,2021-01-23 22:53:16
2297,454,3,1027,133,1160,2275,2021-01-23 10:21:18
2298,354,3,1127,146,1273,2276,2021-01-23 15:25:13
2299,230,5,1506,195,1701,2277,2021-01-23 02:39:00
2300,887,3,847,110,957,2278,2021-01-23 01:16:06
2301,560,1,599,77,676,2279,2021-01-22 17:36:21
2302,262,2,798,103,901,2280,2021-01-22 18:27:52
2303,736,3,847,110,957,2281,2021-01-22 23:45:13
2304,714,3,1047,136,1183,2282,2021-01-22 23:03:52
2305,379,3,528,68,596,2283,2021-01-23 06:54:14
2306,198,1,699,90,789,2284,2021-01-22 22:34:21
2307,837,3,1047,136,1183,2285,2021-01-22 12:42:11
2308,990,3,947,123,1070,2286,2021-01-22 19:49:30
2309,634,4,957,124,1081,2287,2021-01-22 04:21:38
2310,778,3,1047,136,1183,2288,2021-01-22 00:35:19
2311,105,3,727,94,821,2289,2021-01-22 00:43:50
2312,346,3,927,120,1047,2290,2021-01-22 09:44:25
2313,569,6,1855,241,2096,2291,2021-01-22 18:33:58
2314,897,2,429,55,484,2292,2021-01-22 10:47:40
2315,636,1,149,19,168,2293,2021-01-23 20:38:44
2316,932,2,848,110,958,2294,2021-01-23 11:31:37
2317,73,4,1276,165,1441,2295,2021-01-23 13:13:29
2318,164,3,847,110,957,2296,2021-01-23 15:28:45
2319,167,2,429,55,484,2297,2021-01-23 21:18:31
2320,777,2,598,77,675,2298,2021-01-24 01:07:22
2321,808,2,728,94,822,2299,2021-01-23 11:07:05
2322,663,3,747,97,844,2300,2021-01-23 17:28:08
2323,735,6,2024,263,2287,2301,2021-01-23 04:09:38
2324,376,3,1327,172,1499,2302,2021-01-23 03:07:26
2325,185,3,888,115,1003,2303,2021-01-22 17:49:04
2326,617,2,659,85,744,2304,2021-01-22 19:37:55
2327,702,3,758,98,856,2305,2021-01-23 01:38:52
2328,101,2,329,42,371,2306,2021-01-23 00:39:27
2329,163,6,1455,189,1644,2307,2021-01-23 08:23:41
2330,859,3,847,110,957,2308,2021-01-23 01:05:43
2331,671,2,1098,142,1240,2309,2021-01-22 14:36:17
2332,459,3,578,75,653,2310,2021-01-22 22:01:40
2333,831,4,1346,174,1520,2311,2021-01-22 05:16:58
2334,514,3,797,103,900,2312,2021-01-22 02:37:19
2335,503,3,888,115,1003,2313,2021-01-22 02:03:22
2336,845,3,827,107,934,2314,2021-01-22 10:38:09
2337,343,3,697,90,787,2315,2021-01-22 21:00:52
2338,557,3,827,107,934,2316,2021-01-22 11:22:40
2339,772,3,808,105,913,2317,2021-01-23 22:18:03
2340,213,4,1396,181,1577,2318,2021-01-23 11:40:35
2341,213,4,1396,181,1577,2318,2021-01-23 11:40:35
2342,11,2,548,71,619,2319,2021-01-23 15:17:45
2343,423,2,398,51,449,2320,2021-01-23 16:55:00
2344,651,3,558,72,630,2321,2021-01-23 22:33:40
2345,760,2,898,116,1014,2322,2021-01-24 02:36:25
2346,197,3,578,75,653,2323,2021-01-23 13:14:23
2347,575,2,459,59,518,2324,2021-01-23 18:11:35
2348,335,3,927,120,1047,2325,2021-01-23 06:38:59
2349,240,3,697,90,787,2326,2021-01-23 05:18:23
2350,949,3,697,90,787,2327,2021-01-22 18:37:42
2351,949,3,697,90,787,2327,2021-01-22 18:37:42
2352,921,3,847,110,957,2328,2021-01-22 20:48:13
2353,804,3,647,84,731,2329,2021-01-23 03:34:58
2354,247,6,1576,204,1780,2330,2021-01-23 01:02:53
2355,263,3,897,116,1013,2331,2021-01-23 09:57:58
2356,250,3,888,115,1003,2332,2021-01-23 03:11:43
2357,373,3,827,107,934,2333,2021-01-22 17:06:27
2358,600,2,898,116,1014,2334,2021-01-22 22:17:58
2359,577,3,808,105,913,2335,2021-01-22 07:52:59
2360,764,3,558,72,630,2336,2021-01-22 02:52:33
2361,946,3,478,62,540,2337,2021-01-22 04:23:00
2362,707,4,1296,168,1464,2338,2021-01-22 12:28:16
2363,147,2,598,77,675,2339,2021-01-22 23:01:19
2364,749,4,1526,198,1724,2340,2021-01-22 11:34:47
2365,749,4,1526,198,1724,2340,2021-01-22 11:34:47
2366,190,3,428,55,483,2341,2021-01-24 00:28:16
2367,876,3,727,94,821,2342,2021-01-23 12:24:35
2368,486,3,997,129,1126,2343,2021-01-23 13:07:10
2369,883,6,1405,182,1587,2344,2021-01-23 16:47:46
2370,683,3,658,85,743,2345,2021-01-23 17:13:17
2371,132,6,1544,200,1744,2346,2021-01-24 00:12:40
2372,286,3,1027,133,1160,2347,2021-01-24 03:59:16
2373,649,3,697,90,787,2348,2021-01-23 15:43:01
2374,785,3,747,97,844,2349,2021-01-23 20:49:21
2375,658,6,1885,245,2130,2350,2021-01-23 09:09:37
2376,810,2,459,59,518,2351,2021-01-23 05:21:42
2377,870,3,827,107,934,2352,2021-01-22 20:25:36
2378,461,3,658,85,743,2353,2021-01-22 18:55:58
2379,435,3,1327,172,1499,2354,2021-01-22 22:04:14
2380,110,6,1275,165,1440,2355,2021-01-23 05:25:13
2381,79,3,827,107,934,2356,2021-01-23 02:45:13
2382,165,3,688,89,777,2357,2021-01-23 11:03:48
2383,764,3,428,55,483,2358,2021-01-23 05:14:41
2384,778,2,898,116,1014,2359,2021-01-22 19:14:37
2385,720,4,837,108,945,2360,2021-01-23 00:38:48
2386,216,3,927,120,1047,2361,2021-01-22 08:31:18
2387,62,3,1197,155,1352,2362,2021-01-22 03:19:15
2388,848,3,647,84,731,2363,2021-01-22 06:03:31
2389,191,3,808,105,913,2364,2021-01-22 12:35:15
2390,400,4,857,111,968,2365,2021-01-23 01:00:12
2391,47,2,659,85,744,2366,2021-01-22 13:14:22
2392,960,3,1027,133,1160,2367,2021-01-22 13:46:57
2393,634,3,428,55,483,2368,2021-01-24 00:42:20
2394,241,3,1047,136,1183,2369,2021-01-23 14:54:09
2395,858,3,647,84,731,2370,2021-01-23 15:02:12
2396,668,1,299,38,337,2371,2021-01-23 19:26:38
2397,780,3,747,97,844,2372,2021-01-23 19:01:52
2398,924,3,747,97,844,2373,2021-01-24 01:11:34
2399,75,3,428,55,483,2374,2021-01-24 04:15:59
2400,331,2,459,59,518,2375,2021-01-23 16:59:39
2401,857,3,558,72,630,2376,2021-01-23 20:59:44
2402,341,3,997,129,1126,2377,2021-01-23 10:53:12
2403,957,3,1047,136,1183,2378,2021-01-23 06:51:33
2404,713,3,1027,133,1160,2379,2021-01-22 23:07:09
2405,845,3,747,97,844,2380,2021-01-22 20:22:50
2406,356,3,897,116,1013,2381,2021-01-22 23:07:39
2407,832,3,897,116,1013,2382,2021-01-23 06:55:21
2408,753,3,747,97,844,2383,2021-01-23 03:27:38
2409,750,2,598,77,675,2384,2021-01-23 11:40:53
2410,233,3,558,72,630,2385,2021-01-23 06:29:44
2411,281,2,498,64,562,2386,2021-01-22 19:34:35
2412,339,3,647,84,731,2387,2021-01-23 02:18:31
2413,217,3,428,55,483,2388,2021-01-22 10:58:34
2414,646,1,599,77,676,2389,2021-01-22 03:32:59
2415,673,3,847,110,957,2390,2021-01-22 06:15:00
2416,33,5,1356,176,1532,2391,2021-01-22 13:05:33
2417,461,3,558,72,630,2392,2021-01-23 01:57:09
2418,829,3,558,72,630,2393,2021-01-22 14:57:45
2419,606,3,597,77,674,2394,2021-01-22 14:26:14
2420,576,1,599,77,676,2395,2021-01-24 02:36:54
2421,343,3,558,72,630,2396,2021-01-23 15:18:18
2422,179,3,827,107,934,2397,2021-01-23 17:39:34
2423,342,3,1047,136,1183,2398,2021-01-23 21:42:16
2424,101,2,659,85,744,2399,2021-01-23 21:42:53
2425,871,2,898,116,1014,2400,2021-01-24 03:40:57
2426,941,3,428,55,483,2401,2021-01-24 05:13:07
2427,353,3,747,97,844,2402,2021-01-23 18:56:59
2428,924,3,647,84,731,2403,2021-01-23 21:47:54
2429,770,2,429,55,484,2404,2021-01-23 11:23:22
2430,399,2,548,71,619,2405,2021-01-23 08:06:41
2431,741,3,927,120,1047,2406,2021-01-23 01:32:57
2432,952,3,758,98,856,2407,2021-01-22 20:33:12
2433,127,3,847,110,957,2408,2021-01-22 23:18:25
2434,89,1,599,77,676,2409,2021-01-23 09:41:41
2435,48,2,898,116,1014,2410,2021-01-23 04:23:51
2436,131,2,698,90,788,2411,2021-01-23 13:24:33
2437,397,3,927,120,1047,2412,2021-01-23 06:46:42
2438,669,3,578,75,653,2413,2021-01-22 20:20:35
2439,613,3,1247,162,1409,2414,2021-01-23 02:55:36
2440,817,3,947,123,1070,2415,2021-01-22 11:47:41
2441,705,3,528,68,596,2416,2021-01-22 04:42:49
2442,93,3,578,75,653,2417,2021-01-22 08:13:13
2443,718,3,827,107,934,2418,2021-01-22 14:17:16
2444,543,3,697,90,787,2419,2021-01-23 04:00:10
2445,420,2,498,64,562,2420,2021-01-22 15:09:12
2446,2,2,598,77,675,2421,2021-01-22 16:02:08
2447,946,2,659,85,744,2422,2021-01-24 03:12:23
2448,720,5,1486,193,1679,2423,2021-01-23 18:02:44
2449,710,2,498,64,562,2424,2021-01-23 19:11:06
2450,588,2,798,103,901,2425,2021-01-23 22:51:36
2451,835,3,847,110,957,2426,2021-01-23 21:56:58
2452,926,3,528,68,596,2427,2021-01-24 06:12:21
2453,328,3,847,110,957,2428,2021-01-24 06:10:50
2454,1,3,647,84,731,2429,2021-01-23 19:06:51
2455,232,2,698,90,788,2430,2021-01-23 21:51:35
2456,684,5,1245,161,1406,2431,2021-01-23 12:29:54
2457,639,1,699,90,789,2432,2021-01-23 09:16:02
2458,662,3,808,105,913,2433,2021-01-23 03:01:41
2459,959,5,1395,181,1576,2434,2021-01-22 20:48:11
2460,51,2,329,42,371,2435,2021-01-23 00:30:21
2461,308,3,608,79,687,2436,2021-01-23 10:26:44
2462,698,3,1127,146,1273,2437,2021-01-23 05:17:50
2463,5,2,798,103,901,2438,2021-01-23 13:27:21
2464,220,5,1745,226,1971,2439,2021-01-23 07:13:16
2465,71,3,658,85,743,2440,2021-01-22 21:38:26
2466,172,1,149,19,168,2441,2021-01-23 05:08:44
2467,988,3,927,120,1047,2442,2021-01-22 14:14:23
2468,838,1,699,90,789,2443,2021-01-22 07:02:22
2469,705,2,548,71,619,2444,2021-01-22 09:28:09
2470,488,3,597,77,674,2445,2021-01-22 14:28:55
2471,352,4,746,96,842,2446,2021-01-23 04:40:16
2472,408,4,1257,163,1420,2447,2021-01-22 16:02:26
2473,758,2,528,68,596,2448,2021-01-22 16:21:42
2474,653,3,528,68,596,2449,2021-01-24 05:44:26
2475,625,1,149,19,168,2450,2021-01-23 18:39:51
2476,256,4,1396,181,1577,2451,2021-01-23 20:03:13
2477,976,3,847,110,957,2452,2021-01-24 00:08:48
2478,341,2,828,107,935,2453,2021-01-23 22:53:04
2479,795,2,728,94,822,2454,2021-01-24 06:20:43
2480,189,2,498,64,562,2455,2021-01-24 08:06:57
2481,189,2,498,64,562,2455,2021-01-24 08:06:57
2482,899,2,659,85,744,2456,2021-01-23 20:55:11
2483,465,5,1895,246,2141,2457,2021-01-23 22:18:12
2484,831,6,1475,191,1666,2458,2021-01-23 13:23:12
2485,244,5,1856,241,2097,2459,2021-01-23 11:46:39
2486,524,2,329,42,371,2460,2021-01-23 03:34:10
2487,720,3,1127,146,1273,2461,2021-01-22 21:02:54
2488,173,3,1197,155,1352,2462,2021-01-23 01:42:35
2489,296,2,898,116,1014,2463,2021-01-23 11:03:36
2490,642,3,697,90,787,2464,2021-01-23 06:07:48
2491,958,2,898,116,1014,2465,2021-01-23 15:22:48
2492,685,2,598,77,675,2466,2021-01-23 07:31:16
2493,175,1,229,29,258,2467,2021-01-22 22:29:30
2494,175,1,229,29,258,2467,2021-01-22 22:29:30
2495,409,2,598,77,675,2468,2021-01-23 06:03:07
2496,740,2,429,55,484,2469,2021-01-22 15:56:16
2497,957,6,2244,291,2535,2470,2021-01-22 08:51:13
2498,43,2,698,90,788,2471,2021-01-22 11:56:15
2499,43,2,698,90,788,2471,2021-01-22 11:56:15
2500,279,6,1744,226,1970,2472,2021-01-22 16:50:06
2501,105,3,1047,136,1183,2473,2021-01-23 05:00:59
2502,651,3,747,97,844,2474,2021-01-22 17:26:02
2503,532,2,898,116,1014,2475,2021-01-22 16:53:13
2504,546,2,698,90,788,2476,2021-01-24 05:46:42
2505,689,2,898,116,1014,2477,2021-01-23 20:40:49
2506,145,4,1426,185,1611,2478,2021-01-23 22:13:10
2507,257,3,688,89,777,2479,2021-01-24 02:21:35
2508,508,2,1098,142,1240,2480,2021-01-24 00:21:49
2509,688,3,927,120,1047,2481,2021-01-24 06:28:14
2510,179,6,1385,180,1565,2482,2021-01-24 10:43:56
2511,533,2,498,64,562,2483,2021-01-24 08:29:21
2512,587,3,1047,136,1183,2484,2021-01-23 22:27:24
2513,767,3,1127,146,1273,2485,2021-01-23 22:44:28
2514,950,3,578,75,653,2486,2021-01-23 15:09:46
2515,868,2,798,103,901,2487,2021-01-23 11:53:39
2516,84,2,498,64,562,2488,2021-01-23 04:48:41
2517,736,2,1098,142,1240,2489,2021-01-22 21:40:21
2518,160,3,697,90,787,2490,2021-01-23 03:05:31
2519,920,2,1098,142,1240,2491,2021-01-23 13:34:16
2520,250,5,1136,147,1283,2492,2021-01-23 06:23:01
2521,606,2,659,85,744,2493,2021-01-23 16:48:22
2522,591,1,699,90,789,2494,2021-01-23 08:25:03
2523,728,2,798,103,901,2495,2021-01-23 01:05:00
2524,156,5,1525,198,1723,2496,2021-01-22 23:51:04
2525,27,3,727,94,821,2497,2021-01-23 07:51:28
2526,534,1,149,19,168,2498,2021-01-22 16:25:48
2527,959,3,1047,136,1183,2499,2021-01-22 09:23:28
2528,924,3,647,84,731,2500,2021-01-22 13:04:44
2529,736,2,898,116,1014,2501,2021-01-22 14:11:15
2530,728,2,698,90,788,2502,2021-01-22 18:34:50
2531,393,2,1098,142,1240,2503,2021-01-23 06:32:10
2532,856,3,927,120,1047,2504,2021-01-22 20:08:02
2533,739,2,898,116,1014,2505,2021-01-22 17:37:41
2534,62,1,499,64,563,2506,2021-01-24 06:01:32
2535,917,3,697,90,787,2507,2021-01-23 21:58:12
2536,59,3,608,79,687,2508,2021-01-23 22:36:44
2537,493,3,797,103,900,2509,2021-01-24 04:22:23
2538,251,2,429,55,484,2510,2021-01-24 01:10:26
2539,308,6,1624,211,1835,2511,2021-01-24 08:34:26
2540,429,2,498,64,562,2512,2021-01-24 12:57:53
2541,617,3,1027,133,1160,2513,2021-01-24 10:57:45
2542,246,3,888,115,1003,2514,2021-01-23 22:39:17
2543,568,6,2094,272,2366,2515,2021-01-24 00:09:40
2544,386,4,977,127,1104,2516,2021-01-23 15:49:15
2545,804,4,837,108,945,2517,2021-01-23 11:55:25
2546,848,3,727,94,821,2518,2021-01-23 07:25:00
2547,848,3,727,94,821,2518,2021-01-23 07:25:00
2548,15,2,628,81,709,2519,2021-01-22 22:36:40
2549,363,2,548,71,619,2520,2021-01-23 04:54:46
2550,209,3,1327,172,1499,2521,2021-01-23 13:34:52
2551,565,3,658,85,743,2522,2021-01-23 08:05:03
2552,32,5,1925,250,2175,2523,2021-01-23 18:51:32
2553,27,5,1486,193,1679,2524,2021-01-23 09:41:59
2554,944,3,808,105,913,2525,2021-01-23 02:08:35
2555,847,2,598,77,675,2526,2021-01-23 00:49:58
2556,330,3,658,85,743,2527,2021-01-23 08:17:55
2557,574,1,399,51,450,2528,2021-01-22 19:10:37
2558,501,1,99,12,111,2529,2021-01-22 10:28:41
2559,831,3,947,123,1070,2530,2021-01-22 14:18:56
2560,900,1,599,77,676,2531,2021-01-22 16:40:38
2561,141,2,598,77,675,2532,2021-01-22 20:48:51
2562,53,5,1425,185,1610,2533,2021-01-23 08:20:28
2563,173,3,658,85,743,2534,2021-01-22 21:18:41
2564,857,2,459,59,518,2535,2021-01-22 20:11:11
2565,563,3,428,55,483,2536,2021-01-24 08:03:37
2566,274,2,1098,142,1240,2537,2021-01-23 22:07:33
2567,11,3,1197,155,1352,2538,2021-01-23 23:00:28
2568,455,3,608,79,687,2539,2021-01-24 05:14:32
2569,540,5,1695,220,1915,2540,2021-01-24 02:03:45
2570,420,3,697,90,787,2541,2021-01-24 09:56:29
2571,387,3,658,85,743,2542,2021-01-24 13:11:31
2572,239,3,947,123,1070,2543,2021-01-24 11:25:58
2573,798,3,1047,136,1183,2544,2021-01-23 22:56:02
2574,496,2,429,55,484,2545,2021-01-24 00:54:07
2575,495,3,697,90,787,2546,2021-01-23 18:14:48
2576,169,2,659,85,744,2547,2021-01-23 13:20:35
2577,498,1,99,12,111,2548,2021-01-23 08:59:08
2578,139,3,827,107,934,2549,2021-01-23 08:16:21
2579,122,3,747,97,844,2550,2021-01-23 00:55:36
2580,79,2,659,85,744,2551,2021-01-23 06:26:55
2581,307,3,597,77,674,2552,2021-01-23 14:52:16
2582,488,3,478,62,540,2553,2021-01-23 08:55:49
2583,930,3,997,129,1126,2554,2021-01-23 19:52:58
2584,940,1,499,64,563,2555,2021-01-23 11:30:31
2585,91,2,498,64,562,2556,2021-01-23 03:08:59
2586,697,3,1127,146,1273,2557,2021-01-23 02:50:35
2587,979,2,1098,142,1240,2558,2021-01-23 09:18:09
2588,190,2,598,77,675,2559,2021-01-22 21:10:32
2589,295,6,1246,161,1407,2560,2021-01-22 12:29:50
2590,773,3,608,79,687,2561,2021-01-22 14:41:00
2591,860,3,1047,136,1183,2562,2021-01-22 17:03:35
2592,821,3,1197,155,1352,2563,2021-01-22 21:33:23
2593,263,3,827,107,934,2564,2021-01-23 08:46:17
2594,560,3,1027,133,1160,2565,2021-01-22 22:35:19
2595,702,3,947,123,1070,2566,2021-01-22 22:28:39
2596,18,2,1098,142,1240,2567,2021-01-24 09:57:29
2597,143,2,898,116,1014,2568,2021-01-23 22:30:57
2598,430,1,699,90,789,2569,2021-01-23 23:19:33
2599,110,3,647,84,731,2570,2021-01-24 05:16:51
2600,585,3,597,77,674,2571,2021-01-24 03:25:46
2601,728,6,1644,213,1857,2572,2021-01-24 10:55:26
2602,149,2,898,116,1014,2573,2021-01-24 13:27:36
2603,970,3,1027,133,1160,2574,2021-01-24 12:50:31
2604,905,3,1247,162,1409,2575,2021-01-24 00:37:03
2605,991,3,1247,162,1409,2576,2021-01-24 03:08:27
2606,743,3,558,72,630,2577,2021-01-23 18:32:19
2607,402,3,688,89,777,2578,2021-01-23 15:58:33
2608,138,3,597,77,674,2579,2021-01-23 10:08:13
2609,638,5,1345,174,1519,2580,2021-01-23 09:44:04
2610,640,5,1306,169,1475,2581,2021-01-23 02:05:52
2611,388,2,628,81,709,2582,2021-01-23 08:00:26
2612,359,3,697,90,787,2583,2021-01-23 15:55:50
2613,189,5,1745,226,1971,2584,2021-01-23 10:09:37
2614,94,4,1396,181,1577,2585,2021-01-23 20:27:13
2615,982,3,747,97,844,2586,2021-01-23 13:09:30
2616,789,5,1376,178,1554,2587,2021-01-23 03:40:42
2617,817,2,659,85,744,2588,2021-01-23 03:13:35
2618,610,4,1596,207,1803,2589,2021-01-23 10:03:36
2619,865,3,1047,136,1183,2590,2021-01-22 23:10:05
2620,441,5,1986,258,2244,2591,2021-01-22 12:40:10
2621,945,3,558,72,630,2592,2021-01-22 17:06:23
2622,154,3,897,116,1013,2593,2021-01-22 19:31:13
2623,788,3,997,129,1126,2594,2021-01-23 00:14:15
2624,161,3,758,98,856,2595,2021-01-23 11:14:14
2625,155,2,1098,142,1240,2596,2021-01-22 22:58:02
2626,289,6,2124,276,2400,2597,2021-01-22 23:42:47
2627,525,3,1047,136,1183,2598,2021-01-24 10:06:07
2628,330,6,1344,174,1518,2599,2021-01-23 23:55:25
2629,373,4,1646,213,1859,2600,2021-01-24 00:28:42
2630,950,6,1355,176,1531,2601,2021-01-24 06:24:04
2631,893,3,597,77,674,2602,2021-01-24 04:32:56
2632,676,4,946,122,1068,2603,2021-01-24 10:59:07
2633,55,3,697,90,787,2604,2021-01-24 13:43:46
2634,959,3,997,129,1126,2605,2021-01-24 13:46:13
2635,745,3,747,97,844,2606,2021-01-24 03:06:46
2636,26,3,1127,146,1273,2607,2021-01-24 03:58:38
2637,248,3,947,123,1070,2608,2021-01-23 21:06:55
2638,157,3,647,84,731,2609,2021-01-23 18:30:16
2639,47,3,1027,133,1160,2610,2021-01-23 11:20:11
2640,131,2,798,103,901,2611,2021-01-23 12:27:34
2641,555,2,329,42,371,2612,2021-01-23 04:33:55
2642,86,2,429,55,484,2613,2021-01-23 10:41:40
2643,94,3,1127,146,1273,2614,2021-01-23 17:51:44
2644,361,3,578,75,653,2615,2021-01-23 11:14:46
2645,499,3,1247,162,1409,2616,2021-01-23 21:20:48
2646,284,2,898,116,1014,2617,2021-01-23 13:45:37
2647,924,2,698,90,788,2618,2021-01-23 05:05:30
2648,425,3,1127,146,1273,2619,2021-01-23 05:27:44
2649,648,2,598,77,675,2620,2021-01-23 12:34:09
2650,918,4,657,85,742,2621,2021-01-23 01:22:05
2651,44,2,548,71,619,2622,2021-01-22 13:37:53
2652,159,3,697,90,787,2623,2021-01-22 17:29:11
2653,938,3,558,72,630,2624,2021-01-22 20:04:47
2654,293,1,99,12,111,2625,2021-01-23 02:45:26
2655,4,6,1574,204,1778,2626,2021-01-23 11:14:28
2656,615,2,898,116,1014,2627,2021-01-23 00:30:51
2657,665,2,498,64,562,2628,2021-01-23 01:18:32
2658,604,2,798,103,901,2629,2021-01-24 11:47:07
2659,252,2,429,55,484,2630,2021-01-24 00:19:50
2660,82,3,478,62,540,2631,2021-01-24 02:21:32
2661,657,2,498,64,562,2632,2021-01-24 06:47:47
2662,277,3,597,77,674,2633,2021-01-24 05:22:19
2663,619,3,727,94,821,2634,2021-01-24 11:49:58
2664,552,3,997,129,1126,2635,2021-01-24 14:10:49
2665,121,6,1575,204,1779,2636,2021-01-24 16:01:22
2666,633,4,996,129,1125,2637,2021-01-24 05:53:22
2667,722,2,459,59,518,2638,2021-01-24 05:42:39
2668,923,3,1327,172,1499,2639,2021-01-23 23:46:47
2669,699,3,827,107,934,2640,2021-01-23 21:02:11
2670,896,3,608,79,687,2641,2021-01-23 12:43:01
2671,622,3,578,75,653,2642,2021-01-23 13:12:56
2672,341,3,808,105,913,2643,2021-01-23 07:05:34
2673,135,1,499,64,563,2644,2021-01-23 10:43:34
2674,874,3,888,115,1003,2645,2021-01-23 20:34:51
2675,6,3,608,79,687,2646,2021-01-23 12:52:14
2676,417,2,698,90,788,2647,2021-01-23 23:02:43
2677,416,3,997,129,1126,2648,2021-01-23 13:58:23
2678,324,3,528,68,596,2649,2021-01-23 06:06:19
2679,292,3,528,68,596,2650,2021-01-23 06:55:35
2680,100,2,398,51,449,2651,2021-01-23 14:19:59
2681,562,3,558,72,630,2652,2021-01-23 01:57:22
2682,695,2,798,103,901,2653,2021-01-22 14:30:19
2683,773,3,1327,172,1499,2654,2021-01-22 17:50:20
2684,579,2,898,116,1014,2655,2021-01-22 20:25:49
2685,527,1,299,38,337,2656,2021-01-23 04:30:12
2686,527,1,299,38,337,2656,2021-01-23 04:30:12
2687,991,3,658,85,743,2657,2021-01-23 12:24:13
2688,4,3,1127,146,1273,2658,2021-01-23 00:32:34
2689,464,3,1047,136,1183,2659,2021-01-23 02:18:13
2690,904,3,578,75,653,2660,2021-01-24 13:51:12
2691,972,3,747,97,844,2661,2021-01-24 02:54:16
2692,801,2,598,77,675,2662,2021-01-24 02:52:35
2693,808,3,528,68,596,2663,2021-01-24 06:49:42
2694,781,3,1127,146,1273,2664,2021-01-24 06:43:51
2695,613,3,1047,136,1183,2665,2021-01-24 14:12:05
2696,120,3,578,75,653,2666,2021-01-24 14:19:30
2697,615,2,628,81,709,2667,2021-01-24 17:23:55
2698,221,2,329,42,371,2668,2021-01-24 07:35:15
2699,28,3,847,110,957,2669,2021-01-24 05:43:58
2700,922,3,1127,146,1273,2670,2021-01-24 01:06:06
2701,167,3,647,84,731,2671,2021-01-23 21:23:41
2702,570,3,727,94,821,2672,2021-01-23 13:54:42
2703,322,2,698,90,788,2673,2021-01-23 14:21:21
2704,991,3,888,115,1003,2674,2021-01-23 09:05:47
2705,873,2,659,85,744,2675,2021-01-23 10:52:43
2706,121,2,928,120,1048,2676,2021-01-23 23:21:09
2707,19,2,498,64,562,2677,2021-01-23 13:11:55
2708,25,2,848,110,958,2678,2021-01-24 01:41:33
2709,394,2,598,77,675,2679,2021-01-23 15:34:46
2710,722,2,498,64,562,2680,2021-01-23 07:05:30
2711,989,2,898,116,1014,2681,2021-01-23 07:59:47
2712,803,4,1546,200,1746,2682,2021-01-23 16:06:49
2713,545,6,1205,156,1361,2683,2021-01-23 03:44:24
2714,187,3,827,107,934,2684,2021-01-22 15:05:59
2715,981,5,1156,150,1306,2685,2021-01-22 18:14:16
2716,326,2,898,116,1014,2686,2021-01-22 23:05:16
2717,483,1,499,64,563,2687,2021-01-23 05:31:38
2718,144,3,827,107,934,2688,2021-01-23 06:26:43
2719,485,3,1047,136,1183,2689,2021-01-23 14:13:38
2720,977,3,1327,172,1499,2690,2021-01-23 01:55:48
2721,187,3,947,123,1070,2691,2021-01-23 04:26:04
2722,408,3,697,90,787,2692,2021-01-24 15:31:51
2723,657,2,398,51,449,2693,2021-01-24 03:50:26
2724,919,3,1197,155,1352,2694,2021-01-24 04:28:50
2725,430,3,578,75,653,2695,2021-01-24 08:41:23
2726,455,3,1027,133,1160,2696,2021-01-24 06:45:32
2727,723,4,1946,252,2198,2697,2021-01-24 15:33:07
2728,834,3,1327,172,1499,2698,2021-01-24 16:11:08
2729,955,3,558,72,630,2699,2021-01-24 18:15:32
2730,254,5,1286,167,1453,2700,2021-01-24 09:32:42
2731,708,3,727,94,821,2701,2021-01-24 08:15:45
2732,561,6,1344,174,1518,2702,2021-01-24 03:19:28
2733,286,3,1027,133,1160,2703,2021-01-23 23:06:27
2734,99,2,659,85,744,2704,2021-01-23 14:22:38
2735,383,6,1275,165,1440,2705,2021-01-23 15:40:10
2736,301,2,598,77,675,2706,2021-01-23 10:39:20
2737,5,3,428,55,483,2707,2021-01-23 13:33:15
2738,897,2,1098,142,1240,2708,2021-01-23 23:22:44
2739,173,3,608,79,687,2709,2021-01-23 15:17:55
2740,270,5,1486,193,1679,2710,2021-01-24 03:26:19
2741,257,3,927,120,1047,2711,2021-01-23 18:06:09
2742,385,5,987,128,1115,2712,2021-01-23 08:56:15
2743,808,5,1825,237,2062,2713,2021-01-23 08:32:11
2744,323,3,647,84,731,2714,2021-01-23 17:42:06
2745,268,3,658,85,743,2715,2021-01-23 05:59:09
2746,46,2,459,59,518,2716,2021-01-22 16:40:04
2747,272,2,648,84,732,2717,2021-01-22 19:32:28
2748,78,3,1327,172,1499,2718,2021-01-23 00:26:43
2749,500,3,1027,133,1160,2719,2021-01-23 05:52:34
2750,580,3,558,72,630,2720,2021-01-23 06:34:41
2751,521,2,459,59,518,2721,2021-01-23 15:18:47
2752,45,3,808,105,913,2722,2021-01-23 02:21:35
2753,1,3,997,129,1126,2723,2021-01-23 04:58:49
2754,18,1,499,64,563,2724,2021-01-24 17:00:11
2755,920,3,727,94,821,2725,2021-01-24 05:20:21
2756,663,5,1675,217,1892,2726,2021-01-24 05:48:50
2757,783,3,847,110,957,2727,2021-01-24 10:15:40
2758,428,3,428,55,483,2728,2021-01-24 09:23:27
2759,32,3,827,107,934,2729,2021-01-24 16:44:59
2760,566,2,598,77,675,2730,2021-01-24 18:52:53
2761,107,1,399,51,450,2731,2021-01-24 19:36:23
2762,812,3,758,98,856,2732,2021-01-24 12:16:15
2763,40,2,898,116,1014,2733,2021-01-24 10:28:10
2764,365,1,299,38,337,2734,2021-01-24 04:44:59
2765,237,5,1406,182,1588,2735,2021-01-23 23:09:42
2766,2,3,1047,136,1183,2736,2021-01-23 15:01:20
2767,845,2,429,55,484,2737,2021-01-23 16:53:18
2768,200,4,1346,174,1520,2738,2021-01-23 11:46:26
2769,627,6,1574,204,1778,2739,2021-01-23 14:28:40
2770,265,3,997,129,1126,2740,2021-01-23 23:39:23
2771,722,3,647,84,731,2741,2021-01-23 17:15:43
2772,167,4,1246,161,1407,2742,2021-01-24 05:44:27
2773,277,3,528,68,596,2743,2021-01-23 19:18:44
2774,94,2,429,55,484,2744,2021-01-23 10:49:54
2775,421,3,1047,136,1183,2745,2021-01-23 11:16:56
2776,950,2,429,55,484,2746,2021-01-23 20:13:52
2777,136,2,698,90,788,2747,2021-01-23 06:08:38
2778,247,2,498,64,562,2748,2021-01-22 17:41:31
2779,763,2,659,85,744,2749,2021-01-22 21:51:37
2780,89,2,498,64,562,2750,2021-01-23 00:52:54
2781,786,2,898,116,1014,2751,2021-01-23 07:05:54
2782,155,3,658,85,743,2752,2021-01-23 08:12:42
2783,58,3,578,75,653,2753,2021-01-23 16:43:30
2784,167,3,647,84,731,2754,2021-01-23 02:54:28
2785,758,2,898,116,1014,2755,2021-01-23 05:27:31
2786,668,2,598,77,675,2756,2021-01-24 17:40:36
2787,580,2,898,116,1014,2757,2021-01-24 05:37:55
2788,9,2,429,55,484,2758,2021-01-24 08:26:03
2789,174,3,927,120,1047,2759,2021-01-24 11:21:15
2790,174,3,927,120,1047,2759,2021-01-24 11:21:15
2791,567,3,658,85,743,2760,2021-01-24 10:02:04
2792,954,3,997,129,1126,2761,2021-01-24 17:48:11
2793,789,3,997,129,1126,2762,2021-01-24 21:11:16
2794,429,2,898,116,1014,2763,2021-01-24 22:19:09
2795,746,5,1495,194,1689,2764,2021-01-24 13:05:35
2796,841,6,1355,176,1531,2765,2021-01-24 13:03:45
2797,71,2,798,103,901,2766,2021-01-24 05:29:54
2798,172,5,1145,148,1293,2767,2021-01-24 01:09:15
2799,274,3,558,72,630,2768,2021-01-23 15:24:35
2800,872,3,428,55,483,2769,2021-01-23 17:18:26
2801,307,3,528,68,596,2770,2021-01-23 13:52:35
2802,82,2,898,116,1014,2771,2021-01-23 15:57:50
2803,528,2,898,116,1014,2772,2021-01-24 01:31:03
2804,739,3,947,123,1070,2773,2021-01-23 19:27:10
2805,564,3,647,84,731,2774,2021-01-24 08:08:46
2806,673,2,628,81,709,2775,2021-01-23 20:11:03
2807,919,3,747,97,844,2776,2021-01-23 11:54:23
2808,414,5,2145,278,2423,2777,2021-01-23 12:05:18
2809,948,3,608,79,687,2778,2021-01-23 20:44:26
2810,468,1,599,77,676,2779,2021-01-23 07:19:58
2811,27,4,577,75,652,2780,2021-01-22 18:09:12
2812,514,2,898,116,1014,2781,2021-01-22 23:51:51
2813,811,3,1127,146,1273,2782,2021-01-23 01:54:11
2814,334,2,928,120,1048,2783,2021-01-23 08:33:11
2815,518,3,658,85,743,2784,2021-01-23 09:47:05
2816,674,3,797,103,900,2785,2021-01-23 17:11:20
2817,909,3,847,110,957,2786,2021-01-23 04:38:12
2818,107,3,927,120,1047,2787,2021-01-23 05:45:03
2819,247,3,827,107,934,2788,2021-01-24 20:14:05
2820,250,2,548,71,619,2789,2021-01-24 07:05:03
2821,830,3,428,55,483,2790,2021-01-24 08:44:32
2822,952,3,997,129,1126,2791,2021-01-24 13:20:16
2823,952,3,997,129,1126,2791,2021-01-24 13:20:16
2824,45,3,827,107,934,2792,2021-01-24 13:06:43
2825,119,3,688,89,777,2793,2021-01-24 10:51:10
2826,214,1,229,29,258,2794,2021-01-24 19:36:51
2827,284,2,748,97,845,2795,2021-01-24 21:28:42
2828,558,3,727,94,821,2796,2021-01-24 23:44:46
2829,404,2,898,116,1014,2797,2021-01-24 14:04:27
2830,208,2,329,42,371,2798,2021-01-24 15:45:13
2831,401,2,798,103,901,2799,2021-01-24 06:04:06
2832,424,4,1346,174,1520,2800,2021-01-24 02:08:34
2833,622,3,747,97,844,2801,2021-01-23 17:17:23
2834,388,3,1327,172,1499,2802,2021-01-23 18:15:57
2835,981,3,747,97,844,2803,2021-01-23 16:21:54
2836,611,3,558,72,630,2804,2021-01-23 17:23:17
2837,296,3,1047,136,1183,2805,2021-01-24 02:18:51
2838,506,3,747,97,844,2806,2021-01-23 21:38:01
2839,499,2,848,110,958,2807,2021-01-24 08:29:43
2840,979,3,697,90,787,2808,2021-01-23 20:54:38
2841,147,5,1656,215,1871,2809,2021-01-23 14:23:58
2842,330,3,758,98,856,2810,2021-01-23 12:11:17
2843,286,3,647,84,731,2811,2021-01-23 21:43:07
2844,318,5,1745,226,1971,2812,2021-01-23 07:25:08
2845,545,3,647,84,731,2813,2021-01-22 20:30:34
2846,944,1,399,51,450,2814,2021-01-23 02:14:36
2847,313,2,1098,142,1240,2815,2021-01-23 02:48:19
2848,40,1,229,29,258,2816,2021-01-23 08:53:20
2849,120,2,548,71,619,2817,2021-01-23 12:01:06
2850,584,4,1346,174,1520,2818,2021-01-23 17:46:32
2851,336,3,1047,136,1183,2819,2021-01-23 05:07:58
2852,306,3,647,84,731,2820,2021-01-23 07:50:18
2853,529,6,2254,293,2547,2821,2021-01-24 20:49:26
2854,327,3,997,129,1126,2822,2021-01-24 07:45:10
2855,558,2,1098,142,1240,2823,2021-01-24 09:52:29
2856,45,4,1396,181,1577,2824,2021-01-24 14:31:20
2857,218,2,498,64,562,2825,2021-01-24 15:42:31
2858,520,6,1475,191,1666,2826,2021-01-24 14:10:42
2859,359,3,747,97,844,2827,2021-01-24 11:07:57
2860,884,5,1945,252,2197,2828,2021-01-24 21:18:12
2861,161,3,697,90,787,2829,2021-01-24 22:26:15
2862,88,3,608,79,687,2830,2021-01-25 00:28:41
2863,499,3,528,68,596,2831,2021-01-24 16:17:47
2864,851,3,927,120,1047,2832,2021-01-24 17:13:15
2865,909,3,1247,162,1409,2833,2021-01-24 06:08:24
2866,661,2,848,110,958,2834,2021-01-24 02:17:48
2867,608,2,659,85,744,2835,2021-01-23 19:34:07
2868,97,1,229,29,258,2836,2021-01-23 18:33:37
2869,654,2,598,77,675,2837,2021-01-23 17:04:03
2870,176,3,697,90,787,2838,2021-01-23 18:52:48
2871,856,3,1027,133,1160,2839,2021-01-24 04:10:52
2872,527,2,1098,142,1240,2840,2021-01-23 23:21:43
2873,193,6,1824,237,2061,2841,2021-01-24 09:22:07
2874,280,5,1595,207,1802,2842,2021-01-23 21:39:33
2875,690,3,1197,155,1352,2843,2021-01-23 16:08:43
2876,48,2,498,64,562,2844,2021-01-23 14:36:17
2877,621,6,2244,291,2535,2845,2021-01-23 21:50:55
2878,561,3,847,110,957,2846,2021-01-23 08:52:46
2879,965,3,797,103,900,2847,2021-01-22 21:56:44
2880,788,3,747,97,844,2848,2021-01-23 04:57:12
2881,598,6,1954,254,2208,2849,2021-01-23 02:48:49
2882,834,2,728,94,822,2850,2021-01-23 09:27:23
2883,244,3,478,62,540,2851,2021-01-23 13:52:58
2884,824,5,1545,200,1745,2852,2021-01-23 18:59:30
2885,948,2,329,42,371,2853,2021-01-23 06:34:24
2886,118,3,578,75,653,2854,2021-01-23 10:14:15
2887,597,2,329,42,371,2855,2021-01-24 21:47:41
2888,967,2,798,103,901,2856,2021-01-24 08:40:43
2889,998,2,459,59,518,2857,2021-01-24 11:01:32
2890,329,3,428,55,483,2858,2021-01-24 16:19:27
2891,869,2,598,77,675,2859,2021-01-24 16:15:59
2892,250,3,808,105,913,2860,2021-01-24 16:39:43
2893,130,3,888,115,1003,2861,2021-01-24 12:18:27
2894,699,3,997,129,1126,2862,2021-01-24 23:15:50
2895,189,6,1535,199,1734,2863,2021-01-25 00:20:43
2896,173,3,827,107,934,2864,2021-01-25 01:11:51
2897,333,3,888,115,1003,2865,2021-01-24 17:36:54
2898,437,3,808,105,913,2866,2021-01-24 19:43:56
2899,46,6,1744,226,1970,2867,2021-01-24 08:17:36
2900,459,2,798,103,901,2868,2021-01-24 04:04:05
2901,175,3,528,68,596,2869,2021-01-23 22:01:30
2902,689,3,658,85,743,2870,2021-01-23 20:25:31
2903,182,3,597,77,674,2871,2021-01-23 19:43:31
2904,273,3,647,84,731,2872,2021-01-23 19:19:04
2905,92,3,1127,146,1273,2873,2021-01-24 06:53:09
2906,444,2,748,97,845,2874,2021-01-24 01:08:43
2907,919,3,558,72,630,2875,2021-01-24 11:56:32
2908,965,3,997,129,1126,2876,2021-01-23 23:49:42
2909,778,2,898,116,1014,2877,2021-01-23 18:33:21
2910,257,2,898,116,1014,2878,2021-01-23 16:47:27
2911,859,2,628,81,709,2879,2021-01-24 00:01:37
2912,177,3,1127,146,1273,2880,2021-01-23 09:33:54
2913,224,4,1256,163,1419,2881,2021-01-22 23:26:08
2914,558,3,697,90,787,2882,2021-01-23 05:37:06
2915,729,3,528,68,596,2883,2021-01-23 02:56:27
2916,285,4,1307,169,1476,2884,2021-01-23 12:13:17
2917,889,3,1327,172,1499,2885,2021-01-23 15:31:40
2918,230,6,1225,159,1384,2886,2021-01-23 19:31:39
2919,785,3,758,98,856,2887,2021-01-23 08:40:28
2920,32,2,628,81,709,2888,2021-01-23 12:22:13
2921,46,2,598,77,675,2889,2021-01-24 23:48:48
2922,142,3,608,79,687,2890,2021-01-24 10:16:14
2923,384,2,698,90,788,2891,2021-01-24 12:02:52
2924,674,3,997,129,1126,2892,2021-01-24 18:23:51
2925,630,6,1935,251,2186,2893,2021-01-24 17:08:27
2926,728,2,429,55,484,2894,2021-01-24 18:41:03
2927,999,3,827,107,934,2895,2021-01-24 14:31:32
2928,380,3,827,107,934,2896,2021-01-24 23:16:26
2929,286,3,658,85,743,2897,2021-01-25 03:01:02
2930,373,3,1047,136,1183,2898,2021-01-25 01:48:44
2931,219,3,1027,133,1160,2899,2021-01-24 20:14:23
2932,129,3,997,129,1126,2900,2021-01-24 21:50:52
2933,821,3,1047,136,1183,2901,2021-01-24 10:44:12
2934,752,1,699,90,789,2902,2021-01-24 05:37:03
2935,433,2,329,42,371,2903,2021-01-23 22:10:28
2936,285,5,1376,178,1554,2904,2021-01-23 21:43:37
2937,395,2,698,90,788,2905,2021-01-23 22:06:41
2938,271,3,758,98,856,2906,2021-01-23 21:56:34
2939,816,2,698,90,788,2907,2021-01-24 07:59:49
2940,137,1,599,77,676,2908,2021-01-24 03:16:47
2941,935,3,727,94,821,2909,2021-01-24 12:13:54
2942,991,2,898,116,1014,2910,2021-01-24 02:28:00
2943,488,1,399,51,450,2911,2021-01-23 20:51:18
2944,891,3,608,79,687,2912,2021-01-23 18:31:44
2945,642,3,827,107,934,2913,2021-01-24 02:40:59
2946,912,3,647,84,731,2914,2021-01-23 12:00:37
2947,591,3,1197,155,1352,2915,2021-01-23 00:48:50
2948,57,3,888,115,1003,2916,2021-01-23 06:22:12
2949,57,3,888,115,1003,2916,2021-01-23 06:22:12
2950,246,3,1327,172,1499,2917,2021-01-23 04:48:42
2951,689,2,798,103,901,2918,2021-01-23 13:39:03
2952,322,3,1247,162,1409,2919,2021-01-23 17:11:32
2953,899,5,1845,239,2084,2920,2021-01-23 21:51:12
2954,729,1,229,29,258,2921,2021-01-23 08:47:14
2955,973,3,897,116,1013,2922,2021-01-23 14:36:08
2956,830,5,1256,163,1419,2923,2021-01-25 00:58:11
2957,413,1,229,29,258,2924,2021-01-24 10:55:44
2958,564,3,888,115,1003,2925,2021-01-24 13:19:40
2959,560,3,578,75,653,2926,2021-01-24 18:31:18
2960,715,2,898,116,1014,2927,2021-01-24 19:29:52
2961,573,3,847,110,957,2928,2021-01-24 18:50:44
2962,738,3,1327,172,1499,2929,2021-01-24 15:13:42
2963,326,3,1047,136,1183,2930,2021-01-24 23:20:35
2964,569,3,528,68,596,2931,2021-01-25 04:27:47
2965,522,3,947,123,1070,2932,2021-01-25 02:57:43
2966,656,3,727,94,821,2933,2021-01-24 21:30:41
2967,729,2,598,77,675,2934,2021-01-25 00:16:19
2968,415,5,1195,155,1350,2935,2021-01-24 12:59:35
2969,617,3,1027,133,1160,2936,2021-01-24 07:27:49
2970,39,3,528,68,596,2937,2021-01-23 23:13:41
2971,282,2,898,116,1014,2938,2021-01-24 00:27:14
2972,155,2,498,64,562,2939,2021-01-23 23:34:14
2973,795,3,1027,133,1160,2940,2021-01-24 00:13:55
2974,206,3,688,89,777,2941,2021-01-24 08:53:02
2975,59,3,927,120,1047,2942,2021-01-24 03:58:35
2976,18,6,1525,198,1723,2943,2021-01-24 13:31:07
2977,232,3,697,90,787,2944,2021-01-24 03:10:14
2978,905,3,847,110,957,2945,2021-01-23 21:59:51
2979,559,3,428,55,483,2946,2021-01-23 20:02:05
2980,630,2,898,116,1014,2947,2021-01-24 04:26:00
2981,259,3,1127,146,1273,2948,2021-01-23 13:16:29
2982,944,3,697,90,787,2949,2021-01-23 01:48:43
2983,366,2,898,116,1014,2950,2021-01-23 06:42:32
2984,789,5,1725,224,1949,2951,2021-01-23 07:32:41
2985,22,5,1575,204,1779,2952,2021-01-23 06:16:04
2986,803,5,1626,211,1837,2953,2021-01-23 14:13:31
2987,624,2,448,58,506,2954,2021-01-23 18:50:26
2988,761,3,1047,136,1183,2955,2021-01-23 23:44:33
2989,830,3,808,105,913,2956,2021-01-23 10:41:27
2990,418,3,927,120,1047,2957,2021-01-23 17:14:45
2991,829,2,548,71,619,2958,2021-01-25 02:11:16
2992,789,2,898,116,1014,2959,2021-01-24 11:45:55
2993,477,3,1127,146,1273,2960,2021-01-24 15:17:38
2994,33,1,499,64,563,2961,2021-01-24 18:48:12
2995,977,2,798,103,901,2962,2021-01-24 21:29:05
2996,538,3,808,105,913,2963,2021-01-24 21:05:06
2997,208,2,1098,142,1240,2964,2021-01-24 15:29:58
2998,383,3,927,120,1047,2965,2021-01-25 00:42:11
2999,834,2,598,77,675,2966,2021-01-25 05:21:35
3000,885,3,658,85,743,2967,2021-01-25 04:23:30
3001,622,2,628,81,709,2968,2021-01-24 21:31:10
3002,196,3,647,84,731,2969,2021-01-25 00:43:05
3003,177,4,1596,207,1803,2970,2021-01-24 14:49:35
3004,856,3,797,103,900,2971,2021-01-24 08:10:20
3005,961,2,848,110,958,2972,2021-01-24 01:58:38
3006,630,3,888,115,1003,2973,2021-01-24 01:21:10
3007,796,2,898,116,1014,2974,2021-01-23 23:51:46
3008,277,5,1556,202,1758,2975,2021-01-24 00:47:58
3009,745,2,459,59,518,2976,2021-01-24 09:00:26
3010,895,2,698,90,788,2977,2021-01-24 04:11:15
3011,675,3,558,72,630,2978,2021-01-24 13:54:45
3012,165,2,698,90,788,2979,2021-01-24 03:59:53
3013,411,3,558,72,630,2980,2021-01-23 23:46:33
3014,363,6,2074,269,2343,2981,2021-01-23 22:07:13
3015,313,3,827,107,934,2982,2021-01-24 06:16:49
3016,90,5,1456,189,1645,2983,2021-01-23 15:08:28
3017,90,3,647,84,731,2984,2021-01-23 02:19:19
3018,246,2,498,64,562,2985,2021-01-23 07:49:21
3019,948,2,498,64,562,2986,2021-01-23 08:29:04
3020,606,2,798,103,901,2987,2021-01-23 08:21:02
3021,7,3,558,72,630,2988,2021-01-23 14:16:17
3022,710,2,1098,142,1240,2989,2021-01-23 20:19:20
3023,634,2,598,77,675,2990,2021-01-24 01:17:12
3024,511,3,808,105,913,2991,2021-01-23 12:33:03
3025,357,3,1327,172,1499,2992,2021-01-23 18:18:00
3026,883,2,329,42,371,2993,2021-01-25 04:37:02
3027,249,3,478,62,540,2994,2021-01-24 14:29:11
3028,580,3,827,107,934,2995,2021-01-24 17:13:35
3029,271,3,1047,136,1183,2996,2021-01-24 21:11:29
3030,799,3,658,85,743,2997,2021-01-24 23:54:02
3031,660,3,997,129,1126,2998,2021-01-24 23:49:57
3032,475,2,329,42,371,2999,2021-01-24 16:51:28
3033,504,3,1127,146,1273,3000,2021-01-25 00:49:13
3034,693,3,797,103,900,3001,2021-01-25 08:00:09
3035,858,2,898,116,1014,3002,2021-01-25 06:09:07
3036,792,3,758,98,856,3003,2021-01-24 23:09:07
3037,967,6,1624,211,1835,3004,2021-01-25 02:31:08
3038,428,4,1496,194,1690,3005,2021-01-24 16:11:15
3039,970,3,747,97,844,3006,2021-01-24 10:39:03
3040,640,1,599,77,676,3007,2021-01-24 03:40:47
3041,413,4,1446,187,1633,3008,2021-01-24 01:21:57
3042,667,3,647,84,731,3009,2021-01-24 00:16:08
3043,317,3,827,107,934,3010,2021-01-24 01:51:19
3044,98,2,898,116,1014,3011,2021-01-24 09:30:34
3045,464,2,528,68,596,3012,2021-01-24 06:05:59
3046,2,2,898,116,1014,3013,2021-01-24 15:39:00
3047,93,2,598,77,675,3014,2021-01-24 04:48:34
3048,940,4,1446,187,1633,3015,2021-01-24 01:52:31
3049,598,1,399,51,450,3016,2021-01-23 22:21:47
3050,163,4,896,116,1012,3017,2021-01-24 07:42:07
3051,729,2,798,103,901,3018,2021-01-23 16:46:17
3052,235,2,498,64,562,3019,2021-01-23 02:31:44
3053,267,2,828,107,935,3020,2021-01-23 09:42:39
3054,545,3,727,94,821,3021,2021-01-23 10:44:42
3055,35,3,808,105,913,3022,2021-01-23 10:47:49
3056,473,2,459,59,518,3023,2021-01-23 16:13:46
3057,150,3,658,85,743,3024,2021-01-23 22:04:21
3058,781,2,928,120,1048,3025,2021-01-24 03:22:29
3059,821,3,847,110,957,3026,2021-01-23 13:52:21
3060,982,2,698,90,788,3027,2021-01-23 20:32:04
3061,953,2,898,116,1014,3028,2021-01-25 05:46:16
3062,617,2,898,116,1014,3029,2021-01-24 16:20:06
3063,390,1,499,64,563,3030,2021-01-24 18:23:51
3064,846,3,1127,146,1273,3031,2021-01-24 22:06:14
3065,381,1,99,12,111,3032,2021-01-25 00:38:44
3066,265,5,1286,167,1453,3033,2021-01-25 00:42:15
3067,520,3,428,55,483,3034,2021-01-24 19:05:37
3068,338,3,888,115,1003,3035,2021-01-25 03:08:18
3069,29,2,329,42,371,3036,2021-01-25 10:10:26
3070,878,2,429,55,484,3037,2021-01-25 07:57:34
3071,609,3,697,90,787,3038,2021-01-24 23:18:19
3072,51,2,429,55,484,3039,2021-01-25 03:42:25
3073,801,3,1127,146,1273,3040,2021-01-24 17:00:35
3074,805,3,1247,162,1409,3041,2021-01-24 13:02:50
3075,867,3,827,107,934,3042,2021-01-24 04:56:12
3076,239,1,299,38,337,3043,2021-01-24 03:45:46
3077,21,2,898,116,1014,3044,2021-01-24 02:39:08
3078,30,3,528,68,596,3045,2021-01-24 04:31:44
3079,536,2,659,85,744,3046,2021-01-24 11:09:41
3080,543,4,1177,153,1330,3047,2021-01-24 08:32:12
3081,732,3,747,97,844,3048,2021-01-24 15:40:53
3082,472,2,659,85,744,3049,2021-01-24 06:55:41
3083,62,3,997,129,1126,3050,2021-01-24 04:13:39
3084,787,2,698,90,788,3051,2021-01-23 22:44:54
3085,692,3,697,90,787,3052,2021-01-24 09:51:30
3086,243,3,658,85,743,3053,2021-01-23 18:52:00
3087,317,2,898,116,1014,3054,2021-01-23 05:17:51
3088,646,2,398,51,449,3055,2021-01-23 10:04:20
3089,366,2,1098,142,1240,3056,2021-01-23 12:47:04
3090,280,3,597,77,674,3057,2021-01-23 11:07:11
3091,488,3,1047,136,1183,3058,2021-01-23 18:50:23
3092,488,2,598,77,675,3059,2021-01-23 22:54:34
3093,992,3,688,89,777,3060,2021-01-24 04:58:43
3094,94,2,928,120,1048,3061,2021-01-23 14:39:41
3095,877,2,898,116,1014,3062,2021-01-23 20:55:23
3096,121,3,1127,146,1273,3063,2021-01-25 06:53:30
3097,684,3,897,116,1013,3064,2021-01-24 17:40:10
3098,876,1,399,51,450,3065,2021-01-24 19:07:43
3099,224,5,1745,226,1971,3066,2021-01-24 23:33:41
3100,218,3,697,90,787,3067,2021-01-25 02:30:11
3101,849,6,1544,200,1744,3068,2021-01-25 01:38:16
3102,868,3,1027,133,1160,3069,2021-01-24 20:29:14
3103,276,5,1406,182,1588,3070,2021-01-25 04:30:23
3104,960,3,1247,162,1409,3071,2021-01-25 10:33:05
3105,612,3,1027,133,1160,3072,2021-01-25 09:33:36
3106,906,3,797,103,900,3073,2021-01-25 01:52:25
3107,452,3,1127,146,1273,3074,2021-01-25 04:37:49
3108,648,2,1098,142,1240,3075,2021-01-24 19:05:26
3109,441,3,658,85,743,3076,2021-01-24 14:18:29
3110,492,3,658,85,743,3077,2021-01-24 06:03:17
3111,755,2,898,116,1014,3078,2021-01-24 05:12:09
3112,549,2,598,77,675,3079,2021-01-24 05:09:20
3113,770,3,558,72,630,3080,2021-01-24 05:46:22
3114,462,1,149,19,168,3081,2021-01-24 11:50:17
3115,586,2,598,77,675,3082,2021-01-24 08:58:38
3116,725,2,598,77,675,3083,2021-01-24 16:31:18
3117,874,3,608,79,687,3084,2021-01-24 08:41:36
3118,691,2,1098,142,1240,3085,2021-01-24 04:26:51
3119,527,3,927,120,1047,3086,2021-01-24 00:21:08
3120,959,2,329,42,371,3087,2021-01-24 11:57:59
3121,120,3,697,90,787,3088,2021-01-23 18:53:23
3122,244,3,647,84,731,3089,2021-01-23 08:04:15
3123,451,3,608,79,687,3090,2021-01-23 11:22:40
3124,187,2,659,85,744,3091,2021-01-23 15:28:10
3125,375,3,897,116,1013,3092,2021-01-23 11:32:43
3126,849,3,747,97,844,3093,2021-01-23 20:42:40
3127,926,3,658,85,743,3094,2021-01-24 00:50:52
3128,667,2,329,42,371,3095,2021-01-24 06:35:07
3129,472,2,398,51,449,3096,2021-01-23 16:31:38
3130,472,2,398,51,449,3096,2021-01-23 16:31:38
3131,409,5,1406,182,1588,3097,2021-01-23 22:02:55
3132,840,5,1356,176,1532,3098,2021-01-25 07:00:17
3133,711,3,428,55,483,3099,2021-01-24 18:08:09
3134,352,3,1097,142,1239,3100,2021-01-24 20:35:32
3135,222,2,659,85,744,3101,2021-01-25 02:11:16
3136,204,3,558,72,630,3102,2021-01-25 03:38:39
3137,693,3,758,98,856,3103,2021-01-25 02:17:57
3138,240,4,1426,185,1611,3104,2021-01-24 22:32:40
3139,184,3,1327,172,1499,3105,2021-01-25 07:08:30
3140,519,2,898,116,1014,3106,2021-01-25 13:05:14
3141,315,2,628,81,709,3107,2021-01-25 10:47:02
3142,380,3,1047,136,1183,3108,2021-01-25 02:25:55
3143,634,3,658,85,743,3109,2021-01-25 07:10:14
3144,289,5,1425,185,1610,3110,2021-01-24 20:25:44
3145,515,3,897,116,1013,3111,2021-01-24 14:33:55
3146,214,3,747,97,844,3112,2021-01-24 07:05:31
3147,492,3,558,72,630,3113,2021-01-24 05:50:57
3148,100,2,598,77,675,3114,2021-01-24 07:29:10
3149,567,3,1197,155,1352,3115,2021-01-24 06:35:10
3150,759,3,897,116,1013,3116,2021-01-24 11:51:00
3151,797,2,448,58,506,3117,2021-01-24 09:45:28
3152,125,3,897,116,1013,3118,2021-01-24 16:34:17
3153,885,3,747,97,844,3119,2021-01-24 11:22:11
3154,148,3,997,129,1126,3120,2021-01-24 07:04:21
3155,800,3,647,84,731,3121,2021-01-24 02:02:19
3156,503,3,558,72,630,3122,2021-01-24 14:04:04
3157,574,3,997,129,1126,3123,2021-01-23 20:50:25
3158,43,2,598,77,675,3124,2021-01-23 08:12:57
3159,86,5,1556,202,1758,3125,2021-01-23 13:29:50
3160,564,1,229,29,258,3126,2021-01-23 18:01:27
3161,234,3,597,77,674,3127,2021-01-23 13:57:17
3162,354,3,688,89,777,3128,2021-01-23 21:04:11
3163,144,3,888,115,1003,3129,2021-01-24 01:22:02
3164,120,3,658,85,743,3130,2021-01-24 09:04:20
3165,896,3,847,110,957,3131,2021-01-23 17:10:11
3166,117,6,2015,261,2276,3132,2021-01-23 18:48:24
3167,264,2,459,59,518,3133,2021-01-23 22:41:01
3168,422,3,697,90,787,3134,2021-01-25 09:08:18
3169,567,3,808,105,913,3135,2021-01-24 18:58:18
3170,912,3,808,105,913,3136,2021-01-24 23:20:47
3171,656,3,747,97,844,3137,2021-01-25 03:12:00
3172,506,4,1196,155,1351,3138,2021-01-25 05:45:13
3173,114,2,698,90,788,3139,2021-01-25 04:12:15
3174,972,3,927,120,1047,3140,2021-01-25 00:55:21
3175,298,2,898,116,1014,3141,2021-01-25 08:25:40
3176,914,2,898,116,1014,3142,2021-01-25 14:47:28
3177,61,3,997,129,1126,3143,2021-01-25 13:08:29
3178,645,6,1594,207,1801,3144,2021-01-25 02:52:30
3179,899,5,1406,182,1588,3145,2021-01-25 08:15:04
3180,645,1,599,77,676,3146,2021-01-24 22:23:48
3181,5,2,798,103,901,3147,2021-01-24 16:32:41
3182,245,3,578,75,653,3148,2021-01-24 08:38:26
3183,515,2,329,42,371,3149,2021-01-24 07:42:43
3184,843,4,1246,161,1407,3150,2021-01-24 09:45:40
3185,267,3,1327,172,1499,3151,2021-01-24 07:20:56
3186,841,2,598,77,675,3152,2021-01-24 14:02:52
3187,970,3,997,129,1126,3153,2021-01-24 12:12:53
3188,970,3,597,77,674,3154,2021-01-24 17:29:58
3189,428,3,827,107,934,3155,2021-01-24 12:28:07
3190,734,3,647,84,731,3156,2021-01-24 08:08:07
3191,17,3,608,79,687,3157,2021-01-24 02:42:25
3192,186,2,698,90,788,3158,2021-01-24 16:45:37
3193,414,2,898,116,1014,3159,2021-01-23 22:30:24
3194,833,3,727,94,821,3160,2021-01-23 10:33:18
3195,665,3,947,123,1070,3161,2021-01-23 16:08:28
3196,303,3,758,98,856,3162,2021-01-23 18:29:12
3197,152,3,1027,133,1160,3163,2021-01-23 16:06:49
3198,740,2,848,110,958,3164,2021-01-23 21:13:17
3199,999,2,848,110,958,3165,2021-01-24 02:34:42
3200,272,2,898,116,1014,3166,2021-01-24 10:08:02
3201,559,2,498,64,562,3167,2021-01-23 19:18:35
3202,872,4,1096,142,1238,3168,2021-01-23 21:03:16
3203,941,2,498,64,562,3169,2021-01-24 00:17:34
3204,512,5,1276,165,1441,3170,2021-01-25 10:18:33
3205,966,3,478,62,540,3171,2021-01-24 19:14:49
3206,66,3,1197,155,1352,3172,2021-01-25 00:48:58
3207,148,5,1745,226,1971,3173,2021-01-25 03:23:47
3208,533,3,847,110,957,3174,2021-01-25 06:33:12
3209,417,4,1496,194,1690,3175,2021-01-25 05:37:35
3210,178,4,1796,233,2029,3176,2021-01-25 02:11:42
3211,827,2,798,103,901,3177,2021-01-25 09:32:13
3212,833,1,99,12,111,3178,2021-01-25 17:21:46
3213,449,3,927,120,1047,3179,2021-01-25 13:25:22
3214,310,3,478,62,540,3180,2021-01-25 03:15:49
3215,747,2,728,94,822,3181,2021-01-25 09:07:33
3216,191,5,1345,174,1519,3182,2021-01-25 00:45:31
3217,65,3,608,79,687,3183,2021-01-24 18:11:07
3218,362,3,808,105,913,3184,2021-01-24 09:04:29
3219,131,3,558,72,630,3185,2021-01-24 09:05:48
3220,410,3,528,68,596,3186,2021-01-24 12:31:39
3221,242,3,927,120,1047,3187,2021-01-24 07:37:38
3222,575,3,558,72,630,3188,2021-01-24 14:58:15
3223,575,3,558,72,630,3188,2021-01-24 14:58:15
3224,472,6,1924,250,2174,3189,2021-01-24 13:19:07
3225,207,5,1955,254,2209,3190,2021-01-24 18:13:36
3226,8,5,1725,224,1949,3191,2021-01-24 14:55:42
3227,162,2,598,77,675,3192,2021-01-24 10:44:58
3228,690,3,827,107,934,3193,2021-01-24 05:24:36
3229,655,3,558,72,630,3194,2021-01-24 17:03:59
3230,251,5,1275,165,1440,3195,2021-01-23 23:00:36
3231,572,6,2324,302,2626,3196,2021-01-23 11:25:28
3232,319,3,608,79,687,3197,2021-01-23 18:05:02
3233,959,3,608,79,687,3198,2021-01-23 19:10:04
3234,575,3,688,89,777,3199,2021-01-23 16:09:00
3235,925,3,827,107,934,3200,2021-01-23 21:44:22
3236,427,2,698,90,788,3201,2021-01-24 03:53:55
3237,400,3,1047,136,1183,3202,2021-01-24 12:04:02
3238,739,3,747,97,844,3203,2021-01-23 20:07:10
3239,404,6,1605,208,1813,3204,2021-01-23 21:09:52
3240,319,2,898,116,1014,3205,2021-01-24 01:55:30
3241,156,2,698,90,788,3206,2021-01-25 10:48:25
3242,552,3,688,89,777,3207,2021-01-24 21:36:52
3243,533,6,1424,185,1609,3208,2021-01-25 01:51:00
3244,935,2,898,116,1014,3209,2021-01-25 03:37:31
3245,995,3,947,123,1070,3210,2021-01-25 08:02:31
3246,281,3,1197,155,1352,3211,2021-01-25 05:37:44
3247,35,2,659,85,744,3212,2021-01-25 04:13:39
3248,305,4,1127,146,1273,3213,2021-01-25 12:15:58
3249,799,3,808,105,913,3214,2021-01-25 17:30:17
3250,861,3,658,85,743,3215,2021-01-25 14:59:11
3251,595,3,578,75,653,3216,2021-01-25 03:59:10
3252,201,3,428,55,483,3217,2021-01-25 11:43:46
3253,917,2,598,77,675,3218,2021-01-25 02:30:26
3254,230,2,1098,142,1240,3219,2021-01-24 20:39:14
3255,341,3,1047,136,1183,3220,2021-01-24 10:44:39
3256,833,2,459,59,518,3221,2021-01-24 09:53:24
3257,23,3,758,98,856,3222,2021-01-24 12:47:03
3258,907,3,578,75,653,3223,2021-01-24 10:14:44
3259,837,3,927,120,1047,3224,2021-01-24 17:16:15
3260,604,2,459,59,518,3225,2021-01-24 17:36:16
3261,739,3,827,107,934,3226,2021-01-24 14:44:48
3262,953,3,688,89,777,3227,2021-01-24 19:35:22
3263,207,2,498,64,562,3228,2021-01-24 16:17:47
3264,238,2,698,90,788,3229,2021-01-24 11:07:59
3265,741,2,728,94,822,3230,2021-01-24 06:06:40
3266,418,5,1056,137,1193,3231,2021-01-24 19:22:11
3267,697,3,528,68,596,3232,2021-01-24 01:10:53
3268,537,3,1047,136,1183,3233,2021-01-23 12:49:42
3269,125,2,1098,142,1240,3234,2021-01-23 20:40:41
3270,225,3,888,115,1003,3235,2021-01-23 20:58:16
3271,436,5,1645,213,1858,3236,2021-01-23 16:18:52
3272,930,3,1047,136,1183,3237,2021-01-23 22:15:12
3273,930,3,1047,136,1183,3237,2021-01-23 22:15:12
3274,630,2,498,64,562,3238,2021-01-24 05:48:26
3275,51,3,997,129,1126,3239,2021-01-24 14:17:45
3276,566,2,659,85,744,3240,2021-01-23 22:03:21
3277,754,5,1386,180,1566,3241,2021-01-23 23:55:46
3278,100,2,598,77,675,3242,2021-01-24 03:24:09
3279,199,3,808,105,913,3243,2021-01-25 11:50:39
3280,739,3,1327,172,1499,3244,2021-01-24 21:48:57
3281,246,3,578,75,653,3245,2021-01-25 02:24:58
3282,79,5,1506,195,1701,3246,2021-01-25 05:44:32
3283,664,2,928,120,1048,3247,2021-01-25 08:44:40
3284,929,3,897,116,1013,3248,2021-01-25 05:52:20
3285,844,3,1327,172,1499,3249,2021-01-25 04:52:37
3286,962,3,558,72,630,3250,2021-01-25 14:41:53
3287,950,3,608,79,687,3251,2021-01-25 19:18:30
3288,942,3,1027,133,1160,3252,2021-01-25 17:31:30
3289,117,3,478,62,540,3253,2021-01-25 05:18:29
3290,467,3,888,115,1003,3254,2021-01-25 14:26:29
3291,794,4,1207,156,1363,3255,2021-01-25 04:18:10
3292,119,2,429,55,484,3256,2021-01-24 21:47:07
3293,71,3,808,105,913,3257,2021-01-24 11:17:09
3294,861,2,429,55,484,3258,2021-01-24 10:41:53
3295,92,3,927,120,1047,3259,2021-01-24 15:32:34
3296,882,2,329,42,371,3260,2021-01-24 12:23:16
3297,187,2,329,42,371,3261,2021-01-24 20:00:11
3298,187,2,329,42,371,3261,2021-01-24 20:00:11
3299,323,3,758,98,856,3262,2021-01-24 17:41:30
3300,386,3,1327,172,1499,3263,2021-01-24 16:51:29
3301,735,3,797,103,900,3264,2021-01-24 21:57:08
3302,507,3,747,97,844,3265,2021-01-24 18:33:36
3303,222,3,727,94,821,3266,2021-01-24 11:50:51
3304,764,3,1327,172,1499,3267,2021-01-24 08:51:35
3305,597,3,688,89,777,3268,2021-01-24 19:47:27
3306,597,3,688,89,777,3268,2021-01-24 19:47:27
3307,875,3,827,107,934,3269,2021-01-24 03:31:49
3308,676,3,747,97,844,3270,2021-01-23 13:27:21
3309,316,2,329,42,371,3271,2021-01-23 23:19:51
3310,469,2,429,55,484,3272,2021-01-23 22:28:48
3311,898,3,1027,133,1160,3273,2021-01-23 16:35:56
3312,187,2,898,116,1014,3274,2021-01-23 23:28:50
3313,987,2,598,77,675,3275,2021-01-23 22:50:34
3314,980,3,747,97,844,3276,2021-01-24 06:30:25
3315,991,3,478,62,540,3277,2021-01-24 16:40:11
3316,555,2,1098,142,1240,3278,2021-01-23 23:35:57
3317,657,3,797,103,900,3279,2021-01-24 00:22:50
3318,254,3,478,62,540,3280,2021-01-24 04:24:09
3319,679,1,229,29,258,3281,2021-01-25 14:20:34
3320,776,2,898,116,1014,3282,2021-01-24 23:30:38
3321,531,2,698,90,788,3283,2021-01-25 03:06:53
3322,170,3,747,97,844,3284,2021-01-25 08:11:04
3323,259,1,499,64,563,3285,2021-01-25 08:53:57
3324,176,3,808,105,913,3286,2021-01-25 06:36:46
3325,478,3,1197,155,1352,3287,2021-01-25 06:50:45
3326,859,2,659,85,744,3288,2021-01-25 17:15:08
3327,969,2,659,85,744,3289,2021-01-25 20:40:56
3328,478,3,1247,162,1409,3290,2021-01-25 19:33:59
3329,49,3,927,120,1047,3291,2021-01-25 05:50:30
3330,930,2,498,64,562,3292,2021-01-25 16:03:48
3331,487,3,747,97,844,3293,2021-01-25 06:34:39
3332,759,3,1247,162,1409,3294,2021-01-24 22:55:35
3333,806,2,548,71,619,3295,2021-01-24 12:06:46
3334,366,3,528,68,596,3296,2021-01-24 12:59:58
3335,334,2,528,68,596,3297,2021-01-24 18:16:34
3336,380,3,1047,136,1183,3298,2021-01-24 13:12:24
3337,555,6,1974,256,2230,3299,2021-01-24 22:24:33
3338,974,3,747,97,844,3300,2021-01-24 20:54:59
3339,560,2,429,55,484,3301,2021-01-24 18:56:54
3340,45,2,498,64,562,3302,2021-01-24 17:20:34
3341,48,3,847,110,957,3303,2021-01-24 22:59:33
3342,764,3,428,55,483,3304,2021-01-24 21:03:45
3343,878,2,798,103,901,3305,2021-01-24 13:25:38
3344,676,3,747,97,844,3306,2021-01-24 09:24:57
3345,13,3,478,62,540,3307,2021-01-24 20:53:26
3346,539,3,1047,136,1183,3308,2021-01-24 21:22:27
3347,509,2,1098,142,1240,3309,2021-01-24 04:20:35
3348,257,3,1047,136,1183,3310,2021-01-23 13:40:28
3349,889,2,498,64,562,3311,2021-01-24 01:12:30
3350,875,3,1027,133,1160,3312,2021-01-23 22:49:33
3351,969,5,1895,246,2141,3313,2021-01-23 16:43:51
3352,49,3,528,68,596,3314,2021-01-24 01:52:07
3353,688,3,528,68,596,3315,2021-01-23 23:48:53
3354,713,3,747,97,844,3316,2021-01-24 08:35:41
3355,713,3,747,97,844,3316,2021-01-24 08:35:41
3356,77,2,898,116,1014,3317,2021-01-24 18:29:14
3357,62,3,558,72,630,3318,2021-01-24 00:32:25
3358,955,3,947,123,1070,3319,2021-01-24 01:30:31
3359,781,3,1047,136,1183,3320,2021-01-24 05:47:17
3360,780,2,848,110,958,3321,2021-01-25 15:10:57
3361,818,2,459,59,518,3322,2021-01-25 01:15:24
3362,818,2,459,59,518,3322,2021-01-25 01:15:24
3363,361,3,727,94,821,3323,2021-01-25 03:08:53
3364,414,5,1267,164,1431,3324,2021-01-25 10:52:34
3365,240,3,558,72,630,3325,2021-01-25 09:03:22
3366,718,2,728,94,822,3326,2021-01-25 06:54:48
3367,283,2,728,94,822,3327,2021-01-25 07:50:49
3368,844,2,598,77,675,3328,2021-01-25 18:22:37
3369,422,3,688,89,777,3329,2021-01-25 21:33:38
3370,36,3,1247,162,1409,3330,2021-01-25 22:16:27
3371,299,5,1276,165,1441,3331,2021-01-25 06:30:20
3372,31,5,1326,172,1498,3332,2021-01-25 17:45:19
3373,75,3,1327,172,1499,3333,2021-01-25 09:01:23
3374,106,3,1047,136,1183,3334,2021-01-24 23:59:00
3375,330,6,1425,185,1610,3335,2021-01-24 14:04:19
3376,330,6,1425,185,1610,3335,2021-01-24 14:04:19
3377,923,2,898,116,1014,3336,2021-01-24 14:34:03
3378,336,5,1725,224,1949,3337,2021-01-24 19:09:08
3379,15,2,628,81,709,3338,2021-01-24 15:29:46
3380,788,2,848,110,958,3339,2021-01-25 00:52:17
3381,565,3,888,115,1003,3340,2021-01-24 22:52:42
3382,221,1,99,12,111,3341,2021-01-24 19:58:36
3383,989,3,827,107,934,3342,2021-01-24 18:44:18
3384,611,2,598,77,675,3343,2021-01-25 00:04:04
3385,897,5,1575,204,1779,3344,2021-01-24 22:39:39
3386,106,3,688,89,777,3345,2021-01-24 13:26:51
3387,767,3,747,97,844,3346,2021-01-24 10:29:23
3388,732,3,658,85,743,3347,2021-01-24 22:10:31
3389,209,3,888,115,1003,3348,2021-01-24 22:34:29
3390,209,3,478,62,540,3349,2021-01-24 04:47:52
3391,943,3,747,97,844,3350,2021-01-23 14:20:18
3392,93,2,1098,142,1240,3351,2021-01-24 02:55:19
3393,705,3,997,129,1126,3352,2021-01-24 00:07:30
3394,576,1,229,29,258,3353,2021-01-23 18:28:18
3395,477,2,598,77,675,3354,2021-01-24 04:05:28
3396,358,2,498,64,562,3355,2021-01-24 00:34:43
3397,276,3,1047,136,1183,3356,2021-01-24 10:45:01
3398,334,1,99,12,111,3357,2021-01-24 10:10:56
3399,762,3,578,75,653,3358,2021-01-24 18:41:05
3400,324,3,528,68,596,3359,2021-01-24 03:06:58
3401,26,3,558,72,630,3360,2021-01-24 02:45:50
3402,936,3,597,77,674,3361,2021-01-24 08:11:53
3403,519,6,1744,226,1970,3362,2021-01-25 16:01:48
3404,227,3,808,105,913,3363,2021-01-25 02:29:58
3405,451,2,898,116,1014,3364,2021-01-25 02:06:06
3406,292,4,1356,176,1532,3365,2021-01-25 05:48:23
3407,730,2,459,59,518,3366,2021-01-25 12:43:02
3408,955,3,847,110,957,3367,2021-01-25 09:56:11
3409,548,3,897,116,1013,3368,2021-01-25 08:49:22
3410,144,3,897,116,1013,3369,2021-01-25 08:45:54
3411,709,3,927,120,1047,3370,2021-01-25 20:48:57
3412,415,3,697,90,787,3371,2021-01-25 22:12:25
3413,675,3,1047,136,1183,3372,2021-01-25 23:53:37
3414,679,3,1247,162,1409,3373,2021-01-25 07:59:53
3415,6,3,478,62,540,3374,2021-01-25 20:18:54
3416,8,3,747,97,844,3375,2021-01-25 10:59:33
3417,682,6,1655,215,1870,3376,2021-01-25 02:35:17
3418,819,3,727,94,821,3377,2021-01-24 16:09:04
3419,14,3,647,84,731,3378,2021-01-24 15:48:32
3420,372,5,1475,191,1666,3379,2021-01-24 16:32:48
3421,375,2,598,77,675,3380,2021-01-24 21:27:13
3422,460,2,928,120,1048,3381,2021-01-24 17:28:49
3423,570,3,747,97,844,3382,2021-01-25 03:12:07
3424,765,2,798,103,901,3383,2021-01-25 00:40:39
3425,353,1,599,77,676,3384,2021-01-24 20:27:36
3426,192,3,658,85,743,3385,2021-01-24 20:56:19
3427,527,6,1635,212,1847,3386,2021-01-25 01:02:30
3428,919,2,329,42,371,3387,2021-01-25 00:48:47
3429,401,2,429,55,484,3388,2021-01-24 14:35:28
3430,323,2,498,64,562,3389,2021-01-24 11:45:54
3431,512,1,229,29,258,3390,2021-01-24 22:54:44
3432,377,3,758,98,856,3391,2021-01-24 22:53:48
3433,847,2,698,90,788,3392,2021-01-24 07:08:30
3434,315,2,598,77,675,3393,2021-01-23 15:05:41
3435,162,2,498,64,562,3394,2021-01-24 05:14:48
3436,981,2,598,77,675,3395,2021-01-24 00:38:18
3437,233,3,747,97,844,3396,2021-01-23 19:55:33
3438,434,2,459,59,518,3397,2021-01-24 04:59:28
3439,668,2,398,51,449,3398,2021-01-24 02:15:12
3440,706,2,498,64,562,3399,2021-01-24 13:12:06
3441,921,3,747,97,844,3400,2021-01-24 11:29:06
3442,95,2,598,77,675,3401,2021-01-24 19:44:43
3443,191,3,697,90,787,3402,2021-01-24 04:39:11
3444,997,4,1246,161,1407,3403,2021-01-24 02:54:07
3445,310,2,329,42,371,3404,2021-01-24 10:19:39
3446,968,3,997,129,1126,3405,2021-01-25 17:30:52
3447,311,3,947,123,1070,3406,2021-01-25 03:27:55
3448,742,3,1197,155,1352,3407,2021-01-25 03:07:21
3449,313,3,747,97,844,3408,2021-01-25 07:54:14
3450,956,3,1127,146,1273,3409,2021-01-25 14:20:45
3451,807,3,478,62,540,3410,2021-01-25 12:31:24
3452,240,1,99,12,111,3411,2021-01-25 09:10:46
3453,470,3,997,129,1126,3412,2021-01-25 10:24:10
3454,209,3,1197,155,1352,3413,2021-01-25 21:07:52
3455,632,2,898,116,1014,3414,2021-01-25 23:27:42
3456,571,3,727,94,821,3415,2021-01-26 01:18:07
3457,67,3,1047,136,1183,3416,2021-01-25 09:23:48
3458,60,2,748,97,845,3417,2021-01-25 22:33:25
3459,354,3,1197,155,1352,3418,2021-01-25 13:02:51
3460,565,1,149,19,168,3419,2021-01-25 02:51:21
3461,471,2,798,103,901,3420,2021-01-24 17:31:30
3462,586,6,1544,200,1744,3421,2021-01-24 16:59:18
3463,61,3,797,103,900,3422,2021-01-24 17:23:27
3464,150,3,688,89,777,3423,2021-01-24 23:20:40
3465,70,2,698,90,788,3424,2021-01-24 19:58:10
3466,825,3,797,103,900,3425,2021-01-25 05:24:57
3467,742,2,598,77,675,3426,2021-01-25 00:53:26
3468,789,3,927,120,1047,3427,2021-01-24 21:57:34
3469,966,2,828,107,935,3428,2021-01-24 22:27:43
3470,675,3,758,98,856,3429,2021-01-25 02:25:23
3471,328,5,1745,226,1971,3430,2021-01-25 03:04:38
3472,38,5,1306,169,1475,3431,2021-01-24 16:06:58
3473,543,3,947,123,1070,3432,2021-01-24 13:53:31
3474,223,2,898,116,1014,3433,2021-01-25 00:30:46
3475,397,2,429,55,484,3434,2021-01-24 23:45:53
3476,917,3,897,116,1013,3435,2021-01-24 08:43:33
3477,712,3,1047,136,1183,3436,2021-01-23 16:30:11
3478,449,3,747,97,844,3437,2021-01-24 06:21:41
3479,465,3,1127,146,1273,3438,2021-01-24 03:04:19
3480,849,2,798,103,901,3439,2021-01-23 20:30:00
3481,975,2,1098,142,1240,3440,2021-01-24 05:20:36
3482,471,2,548,71,619,3441,2021-01-24 03:44:23
3483,596,3,808,105,913,3442,2021-01-24 15:38:28
3484,212,3,1247,162,1409,3443,2021-01-24 13:24:00
3485,677,3,688,89,777,3444,2021-01-24 21:02:38
3486,458,2,598,77,675,3445,2021-01-24 04:49:16
3487,533,3,888,115,1003,3446,2021-01-24 03:57:13
3488,77,2,498,64,562,3447,2021-01-24 11:50:08
3489,550,2,459,59,518,3448,2021-01-25 18:17:38
3490,423,2,459,59,518,3449,2021-01-25 05:47:21
3491,373,3,597,77,674,3450,2021-01-25 03:58:47
3492,170,3,1327,172,1499,3451,2021-01-25 08:40:42
3493,202,2,798,103,901,3452,2021-01-25 15:18:06
3494,831,3,478,62,540,3453,2021-01-25 13:42:41
3495,31,3,478,62,540,3454,2021-01-25 10:24:17
3496,349,1,599,77,676,3455,2021-01-25 12:32:17
3497,466,3,1127,146,1273,3456,2021-01-25 21:17:27
3498,714,3,1027,133,1160,3457,2021-01-26 01:28:53
3499,60,3,727,94,821,3458,2021-01-26 02:17:17
3500,589,5,926,120,1046,3459,2021-01-25 11:17:33
3501,883,3,697,90,787,3460,2021-01-26 01:11:55
3502,975,1,99,12,111,3461,2021-01-25 15:01:28
3503,840,6,1305,169,1474,3462,2021-01-25 05:07:34
3504,342,3,558,72,630,3463,2021-01-24 19:05:35
3505,443,1,149,19,168,3464,2021-01-24 18:07:34
3506,42,3,658,85,743,3465,2021-01-24 17:59:26
3507,656,2,898,116,1014,3466,2021-01-25 00:52:50
3508,107,6,1954,254,2208,3467,2021-01-24 21:18:20
3509,665,2,798,103,901,3468,2021-01-25 06:10:27
3510,451,3,808,105,913,3469,2021-01-25 01:42:41
3511,501,1,599,77,676,3470,2021-01-24 21:59:59
3512,654,3,1327,172,1499,3471,2021-01-25 00:43:57
3513,683,3,1327,172,1499,3472,2021-01-25 03:38:15
3514,165,2,448,58,506,3473,2021-01-25 04:11:28
3515,183,3,578,75,653,3474,2021-01-24 18:29:00
3516,243,3,1127,146,1273,3475,2021-01-24 15:19:29
3517,951,3,727,94,821,3476,2021-01-25 02:59:14
3518,942,3,888,115,1003,3477,2021-01-25 00:54:39
3519,616,4,1157,150,1307,3478,2021-01-24 09:45:30
3520,892,4,996,129,1125,3479,2021-01-23 18:26:56
3521,333,2,898,116,1014,3480,2021-01-24 07:03:02
3522,634,1,99,12,111,3481,2021-01-24 05:44:19
3523,136,3,997,129,1126,3482,2021-01-23 22:17:38
3524,399,3,558,72,630,3483,2021-01-24 07:13:48
3525,448,3,697,90,787,3484,2021-01-24 06:26:33
3526,688,3,897,116,1013,3485,2021-01-24 16:17:43
3527,372,3,1127,146,1273,3486,2021-01-24 15:44:40
3528,848,5,1445,187,1632,3487,2021-01-24 22:50:34
3529,175,2,329,42,371,3488,2021-01-24 07:18:15
3530,447,2,1098,142,1240,3489,2021-01-24 04:26:26
3531,169,3,608,79,687,3490,2021-01-24 11:54:49
3532,414,2,429,55,484,3491,2021-01-25 19:39:37
3533,451,3,1047,136,1183,3492,2021-01-25 08:25:47
3534,374,4,1596,207,1803,3493,2021-01-25 05:14:38
3535,32,5,1495,194,1689,3494,2021-01-25 09:30:43
3536,765,5,1186,154,1340,3495,2021-01-25 17:42:27
3537,230,2,429,55,484,3496,2021-01-25 14:06:52
3538,227,2,459,59,518,3497,2021-01-25 10:26:23
3539,787,3,608,79,687,3498,2021-01-25 14:19:49
3540,787,5,1995,259,2254,3499,2021-01-25 21:51:07
3541,988,3,897,116,1013,3500,2021-01-26 01:31:27
3542,997,2,329,42,371,3501,2021-01-26 03:54:10
3543,138,3,697,90,787,3502,2021-01-25 12:18:04
3544,633,2,598,77,675,3503,2021-01-26 01:57:45
3545,625,3,947,123,1070,3504,2021-01-25 17:18:51
3546,532,5,1495,194,1689,3505,2021-01-25 05:17:42
3547,63,3,997,129,1126,3506,2021-01-24 20:39:50
3548,764,3,647,84,731,3507,2021-01-24 18:31:43
3549,812,3,697,90,787,3508,2021-01-24 20:06:40
3550,284,3,827,107,934,3509,2021-01-25 01:45:09
3551,480,3,608,79,687,3510,2021-01-24 22:04:47
3552,638,3,608,79,687,3511,2021-01-25 08:13:55
3553,225,3,528,68,596,3512,2021-01-25 04:01:26
3554,634,2,659,85,744,3513,2021-01-25 00:06:46
3555,135,2,459,59,518,3514,2021-01-25 02:52:49
3556,703,3,478,62,540,3515,2021-01-25 04:55:34
3557,285,5,1426,185,1611,3516,2021-01-25 06:21:07
3558,45,3,897,116,1013,3517,2021-01-24 19:01:57
3559,564,2,498,64,562,3518,2021-01-24 17:30:44
3560,275,3,727,94,821,3519,2021-01-25 03:59:20
3561,126,1,599,77,676,3520,2021-01-25 00:55:41
3562,650,2,498,64,562,3521,2021-01-24 10:41:17
3563,515,2,598,77,675,3522,2021-01-23 20:27:04
3564,461,3,947,123,1070,3523,2021-01-24 07:58:15
3565,674,2,1098,142,1240,3524,2021-01-24 05:49:08
3566,602,3,428,55,483,3525,2021-01-23 23:49:17
3567,724,4,1226,159,1385,3526,2021-01-24 07:41:30
3568,487,3,758,98,856,3527,2021-01-24 08:30:17
3569,289,3,1197,155,1352,3528,2021-01-24 19:00:23
3570,953,3,1127,146,1273,3529,2021-01-24 17:37:02
3571,915,4,1226,159,1385,3530,2021-01-25 00:24:45
3572,84,3,1027,133,1160,3531,2021-01-24 08:44:12
3573,840,3,947,123,1070,3532,2021-01-24 07:12:24
3574,944,2,898,116,1014,3533,2021-01-24 14:04:37
3575,556,2,659,85,744,3534,2021-01-25 20:26:27
3576,823,1,599,77,676,3535,2021-01-25 11:09:56
3577,674,5,1325,172,1497,3536,2021-01-25 07:30:31
3578,770,6,1425,185,1610,3537,2021-01-25 09:59:45
3579,986,2,429,55,484,3538,2021-01-25 19:02:16
3580,171,2,659,85,744,3539,2021-01-25 15:49:22
3581,79,2,448,58,506,3540,2021-01-25 12:57:56
3582,609,4,1107,143,1250,3541,2021-01-25 14:42:40
3583,382,3,1247,162,1409,3542,2021-01-26 00:32:36
3584,554,4,1357,176,1533,3543,2021-01-26 03:05:12
3585,652,3,827,107,934,3544,2021-01-26 03:57:49
3586,701,3,827,107,934,3545,2021-01-25 13:51:37
3587,883,5,1376,178,1554,3546,2021-01-26 04:02:09
3588,971,3,997,129,1126,3547,2021-01-25 17:37:06
3589,218,5,1925,250,2175,3548,2021-01-25 06:01:42
3590,203,3,647,84,731,3549,2021-01-24 21:35:07
3591,478,3,1047,136,1183,3550,2021-01-24 20:54:42
3592,643,3,888,115,1003,3551,2021-01-24 21:58:08
3593,488,3,997,129,1126,3552,2021-01-25 01:45:26
3594,287,2,329,42,371,3553,2021-01-24 22:46:44
3595,972,1,399,51,450,3554,2021-01-25 08:21:00
3596,900,3,1047,136,1183,3555,2021-01-25 04:10:07
3597,807,3,947,123,1070,3556,2021-01-25 01:40:48
3598,978,3,947,123,1070,3557,2021-01-25 03:58:49
3599,453,3,947,123,1070,3558,2021-01-25 05:34:55
3600,811,6,1544,200,1744,3559,2021-01-25 07:56:58
3601,114,1,499,64,563,3560,2021-01-24 19:08:30
3602,70,3,847,110,957,3561,2021-01-24 19:06:38
3603,245,2,598,77,675,3562,2021-01-25 06:36:09
3604,602,3,758,98,856,3563,2021-01-25 02:27:08
3605,967,3,758,98,856,3564,2021-01-24 12:45:53
3606,17,3,797,103,900,3565,2021-01-23 22:33:01
3607,403,3,558,72,630,3566,2021-01-24 08:47:52
3608,547,1,229,29,258,3567,2021-01-24 07:03:58
3609,679,3,478,62,540,3568,2021-01-24 01:21:41
3610,655,3,1127,146,1273,3569,2021-01-24 10:12:34
3611,890,4,1696,220,1916,3570,2021-01-24 10:38:39
3612,558,2,1098,142,1240,3571,2021-01-24 21:17:27
3613,889,5,1076,139,1215,3572,2021-01-24 17:45:37
3614,357,3,1027,133,1160,3573,2021-01-25 01:46:25
3615,725,3,997,129,1126,3574,2021-01-24 09:47:34
3616,665,2,598,77,675,3575,2021-01-24 09:46:32
3617,729,3,608,79,687,3576,2021-01-24 16:48:10
3618,563,2,329,42,371,3577,2021-01-25 22:59:33
3619,780,5,1545,200,1745,3578,2021-01-25 12:13:55
3620,641,2,329,42,371,3579,2021-01-25 08:24:57
3621,502,2,598,77,675,3580,2021-01-25 10:36:38
3622,164,3,647,84,731,3581,2021-01-25 21:30:31
3623,270,3,1047,136,1183,3582,2021-01-25 18:13:20
3624,629,4,1196,155,1351,3583,2021-01-25 14:10:58
3625,183,2,1098,142,1240,3584,2021-01-25 16:55:37
3626,892,3,578,75,653,3585,2021-01-26 03:15:24
3627,453,2,598,77,675,3586,2021-01-26 04:42:16
3628,769,6,1544,200,1744,3587,2021-01-26 05:50:56
3629,592,3,558,72,630,3588,2021-01-25 16:00:11
3630,729,2,498,64,562,3589,2021-01-26 05:33:47
3631,1,4,1696,220,1916,3590,2021-01-25 19:55:22
3632,225,3,997,129,1126,3591,2021-01-25 07:46:34
3633,607,3,747,97,844,3592,2021-01-24 22:17:19
3634,367,3,1127,146,1273,3593,2021-01-24 23:21:40
3635,297,3,578,75,653,3594,2021-01-24 23:05:23
3636,220,4,1526,198,1724,3595,2021-01-25 02:31:50
3637,544,2,598,77,675,3596,2021-01-24 23:33:19
3638,681,3,1047,136,1183,3597,2021-01-25 08:23:11
3639,938,3,758,98,856,3598,2021-01-25 06:00:47
3640,91,2,548,71,619,3599,2021-01-25 03:45:48
3641,223,2,498,64,562,3600,2021-01-25 05:23:07
3642,595,5,1525,198,1723,3601,2021-01-25 06:57:58
3643,429,2,628,81,709,3602,2021-01-25 09:57:57
3644,433,5,1325,172,1497,3603,2021-01-24 19:51:58
3645,592,3,1127,146,1273,3604,2021-01-24 21:19:10
3646,340,3,697,90,787,3605,2021-01-25 08:15:00
3647,297,3,1047,136,1183,3606,2021-01-25 04:13:04
3648,305,3,478,62,540,3607,2021-01-24 13:21:37
3649,250,2,659,85,744,3608,2021-01-23 23:22:43
3650,372,2,798,103,901,3609,2021-01-24 08:56:26
3651,323,4,1246,161,1407,3610,2021-01-24 09:04:03
3652,539,3,1127,146,1273,3611,2021-01-24 03:21:18
3653,437,3,1027,133,1160,3612,2021-01-24 11:39:43
3654,119,1,99,12,111,3613,2021-01-24 13:02:40
3655,565,3,1047,136,1183,3614,2021-01-24 23:15:19
3656,384,2,659,85,744,3615,2021-01-24 17:53:08
3657,39,3,827,107,934,3616,2021-01-25 01:58:09
3658,648,3,1197,155,1352,3617,2021-01-24 11:14:01
3659,621,3,558,72,630,3618,2021-01-24 12:27:59
3660,790,1,399,51,450,3619,2021-01-24 19:13:10
3661,562,3,1127,146,1273,3620,2021-01-26 01:20:08
3662,462,2,329,42,371,3621,2021-01-25 12:52:47
3663,562,3,747,97,844,3622,2021-01-25 08:54:05
3664,554,3,1047,136,1183,3623,2021-01-25 11:00:46
3665,996,4,1996,259,2255,3624,2021-01-25 22:31:06
3666,724,3,478,62,540,3625,2021-01-25 20:54:37
3667,328,3,578,75,653,3626,2021-01-25 16:13:48
3668,181,3,997,129,1126,3627,2021-01-25 18:05:59
3669,615,3,747,97,844,3628,2021-01-26 05:01:01
3670,851,2,329,42,371,3629,2021-01-26 06:35:00
3671,681,3,697,90,787,3630,2021-01-26 07:23:22
3672,253,3,827,107,934,3631,2021-01-25 16:52:38
3673,227,3,658,85,743,3632,2021-01-26 08:14:53
3674,140,3,558,72,630,3633,2021-01-25 21:54:56
3675,958,3,888,115,1003,3634,2021-01-25 09:16:53
3676,835,3,697,90,787,3635,2021-01-25 00:58:48
3677,332,3,747,97,844,3636,2021-01-25 01:05:18
3678,651,3,608,79,687,3637,2021-01-25 01:19:46
3679,885,2,498,64,562,3638,2021-01-25 03:28:59
3680,431,2,598,77,675,3639,2021-01-25 01:00:21
3681,522,2,459,59,518,3640,2021-01-25 09:07:21
3682,407,3,808,105,913,3641,2021-01-25 07:04:13
3683,913,2,648,84,732,3642,2021-01-25 05:10:39
3684,438,5,1955,254,2209,3643,2021-01-25 06:53:37
3685,69,3,697,90,787,3644,2021-01-25 07:26:41
3686,901,3,827,107,934,3645,2021-01-25 11:10:30
3687,516,3,947,123,1070,3646,2021-01-24 20:23:12
3688,992,2,798,103,901,3647,2021-01-25 00:02:55
3689,33,2,1098,142,1240,3648,2021-01-25 10:53:05
3690,671,3,597,77,674,3649,2021-01-25 05:56:42
3691,671,3,597,77,674,3649,2021-01-25 05:56:42
3692,233,3,578,75,653,3650,2021-01-24 15:33:13
3693,465,3,647,84,731,3651,2021-01-24 01:33:38
3694,422,3,1247,162,1409,3652,2021-01-24 09:25:25
3695,680,2,598,77,675,3653,2021-01-24 11:18:24
3696,368,5,1575,204,1779,3654,2021-01-24 03:41:02
3697,692,3,558,72,630,3655,2021-01-24 13:09:27
3698,282,3,927,120,1047,3656,2021-01-24 13:42:46
3699,977,5,1475,191,1666,3657,2021-01-25 00:53:28
3700,412,3,1027,133,1160,3658,2021-01-24 20:17:17
3701,316,2,429,55,484,3659,2021-01-25 04:26:24
3702,269,3,827,107,934,3660,2021-01-24 11:16:10
3703,200,4,1346,174,1520,3661,2021-01-24 12:47:31
3704,332,2,498,64,562,3662,2021-01-24 19:46:10
3705,139,3,528,68,596,3663,2021-01-26 01:28:36
3706,204,2,329,42,371,3664,2021-01-25 15:09:46
3707,256,2,598,77,675,3665,2021-01-25 11:02:52
3708,776,1,299,38,337,3666,2021-01-25 12:10:54
3709,971,2,329,42,371,3667,2021-01-25 23:41:17
3710,603,3,558,72,630,3668,2021-01-25 21:03:01
3711,923,2,898,116,1014,3669,2021-01-25 16:32:05
3712,643,3,847,110,957,3670,2021-01-25 20:50:51
3713,504,3,558,72,630,3671,2021-01-26 07:02:36
3714,299,3,697,90,787,3672,2021-01-26 08:24:33
3715,498,3,1047,136,1183,3673,2021-01-26 10:08:43
3716,706,3,888,115,1003,3674,2021-01-25 19:11:00
3717,836,5,1276,165,1441,3675,2021-01-26 09:11:16
3718,505,3,897,116,1013,3676,2021-01-25 23:24:11
3719,952,3,727,94,821,3677,2021-01-25 11:39:47
3720,336,3,1327,172,1499,3678,2021-01-25 01:05:57
3721,188,2,898,116,1014,3679,2021-01-25 03:28:45
3722,511,5,1225,159,1384,3680,2021-01-25 02:15:20
3723,127,3,897,116,1013,3681,2021-01-25 04:33:41
3724,975,6,2024,263,2287,3682,2021-01-25 01:33:53
3725,426,6,1685,219,1904,3683,2021-01-25 10:13:56
3726,889,2,698,90,788,3684,2021-01-25 08:42:34
3727,244,3,747,97,844,3685,2021-01-25 06:36:02
3728,36,5,1326,172,1498,3686,2021-01-25 08:53:41
3729,148,2,429,55,484,3687,2021-01-25 08:35:18
3730,995,6,1954,254,2208,3688,2021-01-25 12:42:34
3731,881,2,898,116,1014,3689,2021-01-24 21:37:51
3732,818,3,1127,146,1273,3690,2021-01-25 01:18:21
3733,564,3,558,72,630,3691,2021-01-25 10:56:12
3734,260,2,598,77,675,3692,2021-01-25 06:40:16
3735,115,2,898,116,1014,3693,2021-01-25 06:41:51
3736,45,2,329,42,371,3694,2021-01-24 16:26:32
3737,506,2,898,116,1014,3695,2021-01-24 03:29:04
3738,743,2,329,42,371,3696,2021-01-24 11:12:05
3739,73,3,428,55,483,3697,2021-01-24 12:23:24
3740,651,3,1197,155,1352,3698,2021-01-24 06:25:03
3741,253,3,608,79,687,3699,2021-01-24 14:16:37
3742,140,3,827,107,934,3700,2021-01-24 15:24:47
3743,881,3,747,97,844,3701,2021-01-25 01:35:32
3744,40,3,827,107,934,3702,2021-01-24 22:04:38
3745,804,3,608,79,687,3703,2021-01-25 04:49:43
3746,102,5,1376,178,1554,3704,2021-01-24 13:35:19
3747,231,3,697,90,787,3705,2021-01-24 13:37:58
3748,742,3,688,89,777,3706,2021-01-24 22:15:00
3749,740,3,608,79,687,3707,2021-01-26 03:57:29
3750,453,3,797,103,900,3708,2021-01-25 17:40:14
3751,502,3,897,116,1013,3709,2021-01-25 12:11:45
3752,867,3,727,94,821,3710,2021-01-25 13:27:49
3753,473,1,699,90,789,3711,2021-01-26 01:22:15
3754,230,3,697,90,787,3712,2021-01-25 22:12:33
3755,907,3,997,129,1126,3713,2021-01-25 17:48:36
3756,771,3,808,105,913,3714,2021-01-25 23:29:15
3757,586,3,528,68,596,3715,2021-01-26 07:20:21
3758,178,2,429,55,484,3716,2021-01-26 08:27:01
3759,18,2,898,116,1014,3717,2021-01-26 10:13:03
3760,443,1,399,51,450,3718,2021-01-25 19:37:49
3761,504,3,947,123,1070,3719,2021-01-26 11:03:29
3762,379,2,898,116,1014,3720,2021-01-26 00:55:28
3763,734,2,329,42,371,3721,2021-01-25 12:22:25
3764,693,3,747,97,844,3722,2021-01-25 02:34:04
3765,882,2,848,110,958,3723,2021-01-25 04:05:06
3766,200,5,1356,176,1532,3724,2021-01-25 04:36:42
3767,247,4,1096,142,1238,3725,2021-01-25 04:38:06
3768,628,2,598,77,675,3726,2021-01-25 04:15:33
3769,253,6,1424,185,1609,3727,2021-01-25 12:05:10
3770,693,3,658,85,743,3728,2021-01-25 10:36:44
3771,756,3,927,120,1047,3729,2021-01-25 07:13:04
3772,702,2,698,90,788,3730,2021-01-25 11:38:43
3773,678,2,598,77,675,3731,2021-01-25 10:24:22
3774,709,3,1247,162,1409,3732,2021-01-25 13:00:42
3775,78,6,2324,302,2626,3733,2021-01-24 23:40:00
3776,186,3,578,75,653,3734,2021-01-25 02:29:26
3777,9,3,1127,146,1273,3735,2021-01-25 12:41:12
3778,78,3,1047,136,1183,3736,2021-01-25 09:18:07
3779,185,5,2175,282,2457,3737,2021-01-25 07:28:49
3780,81,3,697,90,787,3738,2021-01-24 18:11:56
3781,510,6,1575,204,1779,3739,2021-01-24 03:53:02
3782,42,4,1726,224,1950,3740,2021-01-24 11:44:08
3783,511,2,898,116,1014,3741,2021-01-24 12:54:01
3784,208,2,698,90,788,3742,2021-01-24 09:11:10
3785,352,3,658,85,743,3743,2021-01-24 14:27:09
3786,492,6,2154,280,2434,3744,2021-01-24 16:36:44
3787,95,2,598,77,675,3745,2021-01-25 02:40:44
3788,84,3,997,129,1126,3746,2021-01-24 22:32:35
3789,765,3,747,97,844,3747,2021-01-25 07:16:21
3790,56,3,428,55,483,3748,2021-01-24 15:59:45
3791,513,3,597,77,674,3749,2021-01-24 15:36:36
3792,455,2,429,55,484,3750,2021-01-25 00:12:38
3793,822,2,1098,142,1240,3751,2021-01-26 04:48:03
3794,765,3,997,129,1126,3752,2021-01-25 19:02:27
3795,799,3,947,123,1070,3753,2021-01-25 13:49:01
3796,899,6,1605,208,1813,3754,2021-01-25 15:57:14
3797,89,3,1247,162,1409,3755,2021-01-26 03:48:14
3798,129,3,888,115,1003,3756,2021-01-26 00:34:35
3799,475,2,798,103,901,3757,2021-01-25 18:17:40
3800,490,2,798,103,901,3758,2021-01-26 00:34:34
3801,299,2,898,116,1014,3759,2021-01-26 08:15:31
3802,832,3,1047,136,1183,3760,2021-01-26 09:49:42
3803,675,2,459,59,518,3761,2021-01-26 10:50:20
3804,425,3,658,85,743,3762,2021-01-25 21:58:01
3805,800,2,398,51,449,3763,2021-01-26 12:47:00
3806,497,3,528,68,596,3764,2021-01-26 01:49:53
3807,710,2,459,59,518,3765,2021-01-25 15:06:56
3808,500,3,558,72,630,3766,2021-01-25 02:41:48
3809,810,2,698,90,788,3767,2021-01-25 04:31:16
3810,304,3,927,120,1047,3768,2021-01-25 04:52:36
3811,197,2,659,85,744,3769,2021-01-25 06:55:17
3812,127,2,398,51,449,3770,2021-01-25 04:40:39
3813,139,5,1386,180,1566,3771,2021-01-25 13:33:17
3814,348,3,697,90,787,3772,2021-01-25 11:30:28
3815,428,3,597,77,674,3773,2021-01-25 09:45:51
3816,133,3,797,103,900,3774,2021-01-25 12:28:04
3817,950,3,428,55,483,3775,2021-01-25 11:19:25
3818,682,2,698,90,788,3776,2021-01-25 15:17:19
3819,66,3,1247,162,1409,3777,2021-01-25 00:54:45
3820,57,3,1047,136,1183,3778,2021-01-25 04:09:28
3821,938,3,947,123,1070,3779,2021-01-25 14:46:54
3822,538,3,1127,146,1273,3780,2021-01-25 11:37:11
3823,834,2,498,64,562,3781,2021-01-25 07:56:39
3824,558,3,997,129,1126,3782,2021-01-24 20:49:30
3825,821,3,647,84,731,3783,2021-01-24 05:09:26
3826,720,3,528,68,596,3784,2021-01-24 12:05:46
3827,828,3,888,115,1003,3785,2021-01-24 13:03:04
3828,973,4,1246,161,1407,3786,2021-01-24 09:47:14
3829,968,3,1127,146,1273,3787,2021-01-24 15:36:33
3830,25,3,688,89,777,3788,2021-01-24 17:39:44
3831,5,6,1424,185,1609,3789,2021-01-25 02:56:08
3832,78,2,548,71,619,3790,2021-01-25 00:19:16
3833,395,2,1098,142,1240,3791,2021-01-25 09:01:06
3834,544,3,747,97,844,3792,2021-01-24 18:17:51
3835,93,3,528,68,596,3793,2021-01-24 17:04:30
3836,468,3,747,97,844,3794,2021-01-25 02:28:25
3837,897,2,429,55,484,3795,2021-01-26 06:47:44
3838,280,3,747,97,844,3796,2021-01-25 20:06:33
3839,496,2,659,85,744,3797,2021-01-25 15:33:26
3840,536,3,797,103,900,3798,2021-01-25 16:44:49
3841,858,2,498,64,562,3799,2021-01-26 06:10:50
3842,682,1,149,19,168,3800,2021-01-26 00:35:56
3843,150,3,1327,172,1499,3801,2021-01-25 18:31:45
3844,962,3,1127,146,1273,3802,2021-01-26 01:06:51
3845,335,2,848,110,958,3803,2021-01-26 08:28:36
3846,62,3,1197,155,1352,3804,2021-01-26 10:56:26
3847,326,5,1445,187,1632,3805,2021-01-26 13:34:35
3848,366,2,898,116,1014,3806,2021-01-25 23:30:42
3849,814,3,927,120,1047,3807,2021-01-26 13:59:30
3850,445,3,558,72,630,3808,2021-01-26 02:37:46
3851,573,2,928,120,1048,3809,2021-01-25 15:35:38
3852,846,3,927,120,1047,3810,2021-01-25 03:08:39
3853,889,3,758,98,856,3811,2021-01-25 06:28:26
3854,111,2,798,103,901,3812,2021-01-25 07:00:58
3855,862,2,459,59,518,3813,2021-01-25 07:56:03
3856,817,3,758,98,856,3814,2021-01-25 06:29:42
3857,44,3,808,105,913,3815,2021-01-25 15:09:33
3858,800,3,1127,146,1273,3816,2021-01-25 12:07:39
3859,348,3,847,110,957,3817,2021-01-25 11:30:54
3860,38,2,429,55,484,3818,2021-01-25 12:48:12
3861,912,1,499,64,563,3819,2021-01-25 12:06:22
3862,15,3,847,110,957,3820,2021-01-25 18:02:36
3863,868,3,1047,136,1183,3821,2021-01-25 02:39:23
3864,868,3,1047,136,1183,3821,2021-01-25 02:39:23
3865,100,1,229,29,258,3822,2021-01-25 04:37:53
3866,195,3,1127,146,1273,3823,2021-01-25 14:57:37
3867,319,3,827,107,934,3824,2021-01-25 12:16:11
3868,841,3,997,129,1126,3825,2021-01-25 09:07:39
3869,292,3,428,55,483,3826,2021-01-24 22:25:22
3870,855,2,848,110,958,3827,2021-01-24 06:49:32
3871,866,2,598,77,675,3828,2021-01-24 13:29:28
3872,717,3,727,94,821,3829,2021-01-24 13:46:01
3873,688,5,1576,204,1780,3830,2021-01-24 11:47:30
3874,678,3,597,77,674,3831,2021-01-24 15:40:33
3875,320,5,1906,247,2153,3832,2021-01-24 17:39:51
3876,312,3,827,107,934,3833,2021-01-25 03:47:26
3877,523,3,1247,162,1409,3834,2021-01-25 02:53:37
3878,134,1,599,77,676,3835,2021-01-25 10:12:52
3879,590,3,597,77,674,3836,2021-01-24 18:55:19
3880,191,3,827,107,934,3837,2021-01-24 18:25:52
3881,450,3,1247,162,1409,3838,2021-01-25 04:59:40
3882,680,5,1545,200,1745,3839,2021-01-26 09:00:28
3883,98,2,329,42,371,3840,2021-01-25 22:30:55
3884,607,3,997,129,1126,3841,2021-01-25 17:01:38
3885,222,3,1247,162,1409,3842,2021-01-25 17:26:55
3886,57,2,898,116,1014,3843,2021-01-26 06:57:30
3887,90,2,828,107,935,3844,2021-01-26 02:25:08
3888,797,3,747,97,844,3845,2021-01-25 19:36:14
3889,723,3,647,84,731,3846,2021-01-26 01:36:31
3890,673,3,827,107,934,3847,2021-01-26 08:39:07
3891,340,3,827,107,934,3848,2021-01-26 12:40:20
3892,809,2,659,85,744,3849,2021-01-26 15:31:28
3893,141,2,498,64,562,3850,2021-01-26 00:17:34
3894,426,3,478,62,540,3851,2021-01-26 15:00:53
3895,206,5,1745,226,1971,3852,2021-01-26 04:40:19
3896,855,2,659,85,744,3853,2021-01-25 18:10:38
3897,658,3,647,84,731,3854,2021-01-25 05:12:19
3898,250,2,698,90,788,3855,2021-01-25 06:52:50
3899,927,5,1656,215,1871,3856,2021-01-25 08:06:33
3900,710,3,947,123,1070,3857,2021-01-25 08:40:37
3901,747,2,898,116,1014,3858,2021-01-25 07:28:34
3902,456,3,1127,146,1273,3859,2021-01-25 16:43:47
3903,991,2,498,64,562,3860,2021-01-25 13:15:43
3904,532,5,1225,159,1384,3861,2021-01-25 13:02:51
3905,713,1,699,90,789,3862,2021-01-25 15:04:51
3906,381,3,688,89,777,3863,2021-01-25 12:32:13
3907,397,2,659,85,744,3864,2021-01-25 20:38:33
3908,603,3,1127,146,1273,3865,2021-01-25 04:54:29
3909,34,2,648,84,732,3866,2021-01-25 02:59:23
3910,458,6,1155,150,1305,3867,2021-01-25 05:20:46
3911,310,3,727,94,821,3868,2021-01-25 16:29:37
3912,483,4,1546,200,1746,3869,2021-01-25 12:56:19
3913,213,2,698,90,788,3870,2021-01-25 11:32:09
3914,826,1,499,64,563,3871,2021-01-24 23:11:49
3915,94,3,997,129,1126,3872,2021-01-24 09:04:52
3916,199,5,1645,213,1858,3873,2021-01-24 14:41:05
3917,834,2,598,77,675,3874,2021-01-24 14:50:35
3918,807,3,727,94,821,3875,2021-01-24 14:17:06
3919,922,3,697,90,787,3876,2021-01-24 18:06:28
3920,35,2,698,90,788,3877,2021-01-24 19:46:01
3921,741,2,459,59,518,3878,2021-01-25 06:12:29
3922,27,2,698,90,788,3879,2021-01-25 04:08:05
3923,346,3,597,77,674,3880,2021-01-25 11:59:08
3924,561,3,847,110,957,3881,2021-01-24 19:12:04
3925,467,2,1098,142,1240,3882,2021-01-24 20:20:46
3926,134,5,1306,169,1475,3883,2021-01-25 05:26:01
3927,462,5,1695,220,1915,3884,2021-01-26 11:41:38
3928,215,5,1217,158,1375,3885,2021-01-26 00:48:40
3929,103,3,997,129,1126,3886,2021-01-25 17:08:37
3930,899,2,698,90,788,3887,2021-01-25 18:47:49
3931,500,3,727,94,821,3888,2021-01-26 08:25:09
3932,942,5,1195,155,1350,3889,2021-01-26 03:54:14
3933,851,3,428,55,483,3890,2021-01-25 20:44:48
3934,614,3,697,90,787,3891,2021-01-26 03:42:05
3935,748,1,599,77,676,3892,2021-01-26 10:52:25
3936,898,3,647,84,731,3893,2021-01-26 15:05:10
3937,640,3,847,110,957,3894,2021-01-26 15:45:53
3938,256,5,1356,176,1532,3895,2021-01-26 00:50:14
3939,671,2,598,77,675,3896,2021-01-26 16:35:09
3940,754,3,697,90,787,3897,2021-01-26 06:14:00
3941,256,6,1644,213,1857,3898,2021-01-25 19:00:37
3942,191,3,1127,146,1273,3899,2021-01-25 06:01:46
3943,866,2,598,77,675,3900,2021-01-25 07:21:41
3944,41,3,847,110,957,3901,2021-01-25 08:34:15
3945,895,5,1495,194,1689,3902,2021-01-25 10:54:46
3946,93,2,698,90,788,3903,2021-01-25 09:58:12
3947,569,3,1247,162,1409,3904,2021-01-25 17:56:58
3948,206,1,229,29,258,3905,2021-01-25 15:59:42
3949,150,3,1027,133,1160,3906,2021-01-25 14:04:05
3950,639,2,598,77,675,3907,2021-01-25 16:09:01
3951,952,3,1047,136,1183,3908,2021-01-25 15:11:35
3952,957,2,429,55,484,3909,2021-01-25 22:14:28
3953,649,3,808,105,913,3910,2021-01-25 05:58:52
3954,143,2,329,42,371,3911,2021-01-25 03:13:15
3955,244,4,1396,181,1577,3912,2021-01-25 05:59:25
3956,101,2,598,77,675,3913,2021-01-25 19:14:52
3957,68,3,1327,172,1499,3914,2021-01-25 14:50:30
3958,464,3,888,115,1003,3915,2021-01-25 14:12:34
3959,188,3,888,115,1003,3916,2021-01-24 23:35:06
3960,201,3,1327,172,1499,3917,2021-01-24 10:01:43
3961,578,3,597,77,674,3918,2021-01-24 17:01:28
3962,721,5,1476,191,1667,3919,2021-01-24 16:38:42
3963,407,3,558,72,630,3920,2021-01-24 15:56:51
3964,866,3,747,97,844,3921,2021-01-24 19:51:45
3965,316,5,1486,193,1679,3922,2021-01-24 19:47:01
3966,141,3,597,77,674,3923,2021-01-25 06:20:17
3967,790,5,1376,178,1554,3924,2021-01-25 06:26:23
3968,33,1,399,51,450,3925,2021-01-25 12:06:32
3969,598,3,1127,146,1273,3926,2021-01-24 19:17:26
3970,706,2,898,116,1014,3927,2021-01-24 20:30:51
3971,973,3,558,72,630,3928,2021-01-25 07:47:46
3972,711,1,499,64,563,3929,2021-01-26 14:21:00
3973,816,2,459,59,518,3930,2021-01-26 02:24:58
3974,757,3,428,55,483,3931,2021-01-25 18:15:59
3975,184,2,329,42,371,3932,2021-01-25 20:33:00
3976,510,3,747,97,844,3933,2021-01-26 10:16:20
3977,592,3,1127,146,1273,3934,2021-01-26 04:34:43
3978,613,2,898,116,1014,3935,2021-01-25 22:41:42
3979,769,3,597,77,674,3936,2021-01-26 05:07:32
3980,694,3,797,103,900,3937,2021-01-26 11:43:06
3981,625,2,898,116,1014,3938,2021-01-26 15:14:08
3982,447,3,1247,162,1409,3939,2021-01-26 16:34:21
3983,223,3,1197,155,1352,3940,2021-01-26 01:38:14
3984,443,5,1226,159,1385,3941,2021-01-26 17:28:53
3985,910,3,697,90,787,3942,2021-01-26 07:39:13
3986,476,2,498,64,562,3943,2021-01-25 20:50:43
3987,29,5,1456,189,1645,3944,2021-01-25 07:47:28
3988,219,2,429,55,484,3945,2021-01-25 08:35:34
3989,108,5,2425,315,2740,3946,2021-01-25 10:50:36
3990,647,2,598,77,675,3947,2021-01-25 11:09:44
3991,860,3,528,68,596,3948,2021-01-25 10:09:13
3992,550,2,659,85,744,3949,2021-01-25 18:21:40
3993,588,2,598,77,675,3950,2021-01-25 17:31:25
3994,478,3,1247,162,1409,3951,2021-01-25 16:49:49
3995,932,2,548,71,619,3952,2021-01-25 18:23:12
3996,521,3,1327,172,1499,3953,2021-01-25 16:43:56
3997,194,3,758,98,856,3954,2021-01-25 23:00:03
3998,840,3,747,97,844,3955,2021-01-25 08:27:36
3999,855,3,727,94,821,3956,2021-01-25 04:51:34
4000,56,3,428,55,483,3957,2021-01-25 07:23:04
4001,900,3,727,94,821,3958,2021-01-25 19:23:29
4002,10,3,608,79,687,3959,2021-01-25 15:07:06
4003,502,2,898,116,1014,3960,2021-01-25 16:01:09
4004,705,3,597,77,674,3961,2021-01-25 00:03:39
4005,859,3,647,84,731,3962,2021-01-24 11:51:07
4006,115,2,329,42,371,3963,2021-01-24 18:10:09
4007,127,2,698,90,788,3964,2021-01-24 18:35:42
4008,238,3,1197,155,1352,3965,2021-01-24 18:26:56
4009,967,3,1327,172,1499,3966,2021-01-24 21:57:48
4010,992,2,598,77,675,3967,2021-01-24 22:28:09
4011,824,2,698,90,788,3968,2021-01-25 07:54:56
4012,372,3,827,107,934,3969,2021-01-25 06:56:16
4013,610,3,578,75,653,3970,2021-01-25 13:32:42
4014,182,2,329,42,371,3971,2021-01-24 20:10:09
4015,743,3,647,84,731,3972,2021-01-24 22:25:18
4016,175,3,947,123,1070,3973,2021-01-25 07:59:04
4017,816,1,149,19,168,3974,2021-01-26 14:39:09
4018,876,4,1446,187,1633,3975,2021-01-26 03:57:34
4019,7,2,598,77,675,3976,2021-01-25 18:18:25
4020,256,5,1295,168,1463,3977,2021-01-25 21:41:42
4021,1000,3,697,90,787,3978,2021-01-26 11:25:59
4022,595,2,598,77,675,3979,2021-01-26 07:02:21
4023,537,2,329,42,371,3980,2021-01-25 23:41:13
4024,135,2,459,59,518,3981,2021-01-26 05:44:03
4025,410,3,688,89,777,3982,2021-01-26 12:09:04
4026,223,2,659,85,744,3983,2021-01-26 16:52:58
4027,983,2,329,42,371,3984,2021-01-26 16:52:16
4028,716,2,798,103,901,3985,2021-01-26 02:19:34
4029,917,3,1197,155,1352,3986,2021-01-26 18:01:35
4030,570,3,1047,136,1183,3987,2021-01-26 08:51:34
4031,176,3,597,77,674,3988,2021-01-25 22:23:44
4032,422,2,429,55,484,3989,2021-01-25 09:33:53
4033,255,3,558,72,630,3990,2021-01-25 10:30:17
4034,992,3,997,129,1126,3991,2021-01-25 11:59:30
4035,440,3,558,72,630,3992,2021-01-25 13:10:35
4036,570,2,598,77,675,3993,2021-01-25 12:16:56
4037,834,2,798,103,901,3994,2021-01-25 19:06:08
4038,433,3,997,129,1126,3995,2021-01-25 20:14:59
4039,557,2,1098,142,1240,3996,2021-01-25 17:01:31
4040,982,3,758,98,856,3997,2021-01-25 20:42:24
4041,349,5,1525,198,1723,3998,2021-01-25 19:00:35
4042,860,3,597,77,674,3999,2021-01-26 01:46:28
4043,748,5,1395,181,1576,4000,2021-01-25 10:02:54
4044,289,3,428,55,483,4001,2021-01-25 05:05:19
4045,219,2,898,116,1014,4002,2021-01-25 09:44:56
4046,998,4,877,114,991,4003,2021-01-25 21:21:50
4047,251,5,1376,178,1554,4004,2021-01-25 16:17:22
4048,305,3,1247,162,1409,4005,2021-01-25 16:30:54
4049,937,3,478,62,540,4006,2021-01-25 01:18:14
4050,466,4,1356,176,1532,4007,2021-01-24 13:15:53
4051,119,6,2044,265,2309,4008,2021-01-24 20:14:26
4052,65,3,1247,162,1409,4009,2021-01-24 21:21:11
4053,355,2,628,81,709,4010,2021-01-24 19:01:11
4054,368,3,997,129,1126,4011,2021-01-25 00:06:56
4055,407,2,659,85,744,4012,2021-01-24 23:10:56
4056,212,2,498,64,562,4013,2021-01-25 09:39:34
4057,815,2,698,90,788,4014,2021-01-25 08:26:41
4058,989,3,688,89,777,4015,2021-01-25 13:58:11
4059,337,2,598,77,675,4016,2021-01-24 21:15:40
4060,471,3,1327,172,1499,4017,2021-01-25 00:43:17
4061,194,5,1525,198,1723,4018,2021-01-25 08:48:49
4062,402,3,827,107,934,4019,2021-01-26 16:00:33
4063,712,6,1325,172,1497,4020,2021-01-26 05:55:54
4064,14,3,697,90,787,4021,2021-01-25 20:05:05
4065,708,2,498,64,562,4022,2021-01-25 21:54:17
4066,520,1,99,12,111,4023,2021-01-26 11:53:34
4067,123,1,599,77,676,4024,2021-01-26 08:44:26
4068,614,1,99,12,111,4025,2021-01-26 00:04:43
4069,534,2,459,59,518,4026,2021-01-26 06:53:34
4070,445,1,599,77,676,4027,2021-01-26 12:13:26
4071,178,3,578,75,653,4028,2021-01-26 17:24:40
4072,418,2,448,58,506,4029,2021-01-26 18:24:05
4073,17,5,1406,182,1588,4030,2021-01-26 04:54:43
4074,83,3,1247,162,1409,4031,2021-01-26 19:48:54
4075,299,2,598,77,675,4032,2021-01-26 09:26:24
4076,414,3,947,123,1070,4033,2021-01-25 23:08:48
4077,675,3,847,110,957,4034,2021-01-25 11:07:57
4078,675,3,847,110,957,4034,2021-01-25 11:07:57
4079,727,3,947,123,1070,4035,2021-01-25 10:33:08
4080,916,3,927,120,1047,4036,2021-01-25 14:40:14
4081,501,3,608,79,687,4037,2021-01-25 15:15:12
4082,934,3,558,72,630,4038,2021-01-25 13:59:20
4083,340,5,1295,168,1463,4039,2021-01-25 19:19:29
4084,81,3,927,120,1047,4040,2021-01-25 22:19:59
4085,657,3,1247,162,1409,4041,2021-01-25 18:18:18
4086,679,3,558,72,630,4042,2021-01-25 23:21:05
4087,188,4,1826,237,2063,4043,2021-01-25 20:12:33
4088,688,2,329,42,371,4044,2021-01-26 01:56:10
4089,506,3,558,72,630,4045,2021-01-25 10:37:10
4090,588,3,758,98,856,4046,2021-01-25 05:50:30
4091,769,5,1156,150,1306,4047,2021-01-25 11:28:49
4092,603,3,608,79,687,4048,2021-01-25 23:47:47
4093,45,2,798,103,901,4049,2021-01-25 17:25:56
4094,67,3,528,68,596,4050,2021-01-25 17:59:35
4095,375,3,597,77,674,4051,2021-01-25 03:00:23
4096,319,3,528,68,596,4052,2021-01-24 14:25:39
4097,735,5,1625,211,1836,4053,2021-01-24 22:23:52
4098,736,2,329,42,371,4054,2021-01-24 22:46:00
4099,441,2,698,90,788,4055,2021-01-24 21:24:25
4100,22,3,947,123,1070,4056,2021-01-25 00:10:30
4101,178,5,1586,206,1792,4057,2021-01-25 01:11:09
4102,257,3,558,72,630,4058,2021-01-25 09:57:02
4103,963,1,699,90,789,4059,2021-01-25 09:09:29
4104,125,3,827,107,934,4060,2021-01-25 14:24:21
4105,131,3,797,103,900,4061,2021-01-24 23:29:30
4106,603,2,459,59,518,4062,2021-01-25 02:38:49
4107,81,3,1047,136,1183,4063,2021-01-25 11:03:17
4108,596,3,578,75,653,4064,2021-01-26 17:22:21
4109,590,3,578,75,653,4065,2021-01-26 08:16:07
4110,279,3,558,72,630,4066,2021-01-25 20:05:43
4111,359,2,598,77,675,4067,2021-01-25 23:55:06
4112,597,2,429,55,484,4068,2021-01-26 12:28:38
4113,496,3,997,129,1126,4069,2021-01-26 10:31:32
4114,299,3,608,79,687,4070,2021-01-26 00:31:35
4115,901,2,1098,142,1240,4071,2021-01-26 07:30:22
4116,287,3,747,97,844,4072,2021-01-26 12:22:27
4117,724,3,1047,136,1183,4073,2021-01-26 18:13:39
4118,468,3,697,90,787,4074,2021-01-26 19:43:24
4119,609,2,598,77,675,4075,2021-01-26 06:59:21
4120,101,3,827,107,934,4076,2021-01-26 20:56:07
4121,554,6,1524,198,1722,4077,2021-01-26 09:40:35
4122,98,3,997,129,1126,4078,2021-01-26 00:38:15
4123,175,3,1197,155,1352,4079,2021-01-25 11:16:13
4124,652,3,428,55,483,4080,2021-01-25 13:32:49
4125,482,2,659,85,744,4081,2021-01-25 11:41:13
4126,650,3,947,123,1070,4082,2021-01-25 16:41:09
4127,404,3,888,115,1003,4083,2021-01-25 17:07:18
4128,230,3,478,62,540,4084,2021-01-25 14:41:44
4129,641,3,758,98,856,4085,2021-01-25 20:08:37
4130,544,2,598,77,675,4086,2021-01-26 00:21:50
4131,744,3,1197,155,1352,4087,2021-01-25 19:50:24
4132,766,3,1127,146,1273,4088,2021-01-26 00:16:45
4133,404,3,947,123,1070,4089,2021-01-25 20:15:31
4134,270,3,727,94,821,4090,2021-01-26 02:19:26
4135,449,3,1197,155,1352,4091,2021-01-25 11:17:43
4136,586,3,647,84,731,4092,2021-01-25 07:55:10
4137,548,3,888,115,1003,4093,2021-01-25 12:17:29
4138,292,3,797,103,900,4094,2021-01-26 00:54:27
4139,471,5,2075,269,2344,4095,2021-01-25 19:07:03
4140,289,2,459,59,518,4096,2021-01-25 18:12:54
4141,637,3,428,55,483,4097,2021-01-25 04:32:08
4142,187,3,1197,155,1352,4098,2021-01-24 15:49:45
4143,214,2,598,77,675,4099,2021-01-24 22:48:30
4144,95,5,1845,239,2084,4100,2021-01-25 00:17:30
4145,298,2,648,84,732,4101,2021-01-24 21:53:11
4146,989,3,688,89,777,4102,2021-01-25 02:03:30
4147,523,3,1327,172,1499,4103,2021-01-25 03:16:51
4148,111,3,997,129,1126,4104,2021-01-25 11:44:55
4149,435,3,697,90,787,4105,2021-01-25 10:25:10
4150,518,2,1098,142,1240,4106,2021-01-25 16:32:56
4151,499,2,698,90,788,4107,2021-01-25 01:25:20
4152,901,2,898,116,1014,4108,2021-01-25 04:32:04
4153,164,3,1047,136,1183,4109,2021-01-25 13:31:30
4154,113,2,898,116,1014,4110,2021-01-26 18:15:48
4155,677,3,1127,146,1273,4111,2021-01-26 09:42:21
4156,237,3,578,75,653,4112,2021-01-25 21:28:22
4157,287,3,608,79,687,4113,2021-01-26 01:09:47
4158,987,2,659,85,744,4114,2021-01-26 13:34:03
4159,307,2,898,116,1014,4115,2021-01-26 12:56:21
4160,942,6,1725,224,1949,4116,2021-01-26 00:47:37
4161,111,3,827,107,934,4117,2021-01-26 09:08:03
4162,119,3,797,103,900,4118,2021-01-26 14:18:57
4163,930,2,698,90,788,4119,2021-01-26 20:43:41
4164,214,2,698,90,788,4120,2021-01-26 20:42:49
4165,773,5,1286,167,1453,4121,2021-01-26 07:45:07
4166,119,2,498,64,562,4122,2021-01-26 22:23:06
4167,972,2,429,55,484,4123,2021-01-26 11:00:30
4168,227,3,927,120,1047,4124,2021-01-26 03:08:30
4169,232,1,229,29,258,4125,2021-01-25 12:26:40
4170,708,3,578,75,653,4126,2021-01-25 14:09:37
4171,266,6,1505,195,1700,4127,2021-01-25 11:41:43
4172,438,3,927,120,1047,4128,2021-01-25 17:47:16
4173,472,3,947,123,1070,4129,2021-01-25 18:26:02
4174,510,2,329,42,371,4130,2021-01-25 16:04:41
4175,563,3,1047,136,1183,4131,2021-01-25 21:04:54
4176,591,3,658,85,743,4132,2021-01-26 01:28:35
4177,829,3,697,90,787,4133,2021-01-25 21:25:44
4178,645,3,1247,162,1409,4134,2021-01-26 01:45:33
4179,645,3,1247,162,1409,4134,2021-01-26 01:45:33
4180,878,3,888,115,1003,4135,2021-01-25 20:42:10
4181,265,3,1327,172,1499,4136,2021-01-26 03:22:29
4182,92,5,1295,168,1463,4137,2021-01-25 12:30:55
4183,273,3,1327,172,1499,4138,2021-01-25 09:51:12
4184,689,3,747,97,844,4139,2021-01-25 14:51:18
4185,639,3,428,55,483,4140,2021-01-26 01:43:26
4186,229,3,428,55,483,4141,2021-01-25 20:30:26
4187,535,3,747,97,844,4142,2021-01-25 18:55:14
4188,742,3,478,62,540,4143,2021-01-25 04:49:57
4189,621,2,598,77,675,4144,2021-01-24 18:20:20
4190,653,2,698,90,788,4145,2021-01-24 23:31:39
4191,716,3,827,107,934,4146,2021-01-25 00:46:06
4192,756,3,647,84,731,4147,2021-01-24 21:54:43
4193,484,3,847,110,957,4148,2021-01-25 03:23:04
4194,320,2,448,58,506,4149,2021-01-25 04:52:33
4195,703,2,398,51,449,4150,2021-01-25 14:12:02
4196,9,3,688,89,777,4151,2021-01-25 12:56:02
4197,539,3,597,77,674,4152,2021-01-25 19:11:49
4198,810,5,1545,200,1745,4153,2021-01-25 03:12:52
4199,398,3,697,90,787,4154,2021-01-25 06:31:46
4200,109,5,1556,202,1758,4155,2021-01-25 14:57:38
4201,994,3,1247,162,1409,4156,2021-01-26 18:29:24
4202,293,3,1247,162,1409,4157,2021-01-26 11:15:01
4203,742,2,598,77,675,4158,2021-01-25 21:37:23
4204,554,3,1027,133,1160,4159,2021-01-26 02:37:57
4205,626,3,758,98,856,4160,2021-01-26 16:04:50
4206,417,3,597,77,674,4161,2021-01-26 15:09:24
4207,632,3,1127,146,1273,4162,2021-01-26 01:34:47
4208,236,5,1506,195,1701,4163,2021-01-26 10:09:32
4209,504,5,1625,211,1836,4164,2021-01-26 16:51:10
4210,568,4,1326,172,1498,4165,2021-01-26 21:57:32
4211,353,3,647,84,731,4166,2021-01-26 22:07:46
4212,758,2,448,58,506,4167,2021-01-26 09:59:48
4213,625,3,697,90,787,4168,2021-01-26 23:40:37
4214,323,3,1197,155,1352,4169,2021-01-26 12:36:15
4215,71,3,1327,172,1499,4170,2021-01-26 04:30:30
4216,358,3,997,129,1126,4171,2021-01-25 14:54:32
4217,534,2,928,120,1048,4172,2021-01-25 14:36:06
4218,198,3,897,116,1013,4173,2021-01-25 14:09:21
4219,577,5,1545,200,1745,4174,2021-01-25 18:48:53
4220,862,3,827,107,934,4175,2021-01-25 20:43:21
4221,616,3,1127,146,1273,4176,2021-01-25 17:51:51
4222,214,2,898,116,1014,4177,2021-01-25 23:46:16
4223,972,1,149,19,168,4178,2021-01-26 02:04:05
4224,862,3,1047,136,1183,4179,2021-01-25 23:58:13
4225,124,3,528,68,596,4180,2021-01-26 02:31:47
4226,294,3,847,110,957,4181,2021-01-26 03:47:17
4227,981,5,1345,174,1519,4182,2021-01-25 22:56:14
4228,904,2,628,81,709,4183,2021-01-26 05:01:04
4229,178,3,1127,146,1273,4184,2021-01-25 12:44:03
4230,483,3,1127,146,1273,4185,2021-01-25 12:13:22
4231,948,3,558,72,630,4186,2021-01-25 15:47:49
4232,36,2,659,85,744,4187,2021-01-26 02:17:48
4233,520,3,558,72,630,4188,2021-01-25 22:40:51
4234,519,3,827,107,934,4189,2021-01-25 19:42:47
4235,740,2,598,77,675,4190,2021-01-25 05:02:04
4236,626,2,498,64,562,4191,2021-01-24 19:45:52
4237,24,3,758,98,856,4192,2021-01-25 00:35:35
4238,102,2,1098,142,1240,4193,2021-01-25 03:09:20
4239,466,3,827,107,934,4194,2021-01-25 00:31:17
4240,517,6,1485,193,1678,4195,2021-01-25 06:06:01
4241,517,6,1485,193,1678,4195,2021-01-25 06:06:01
4242,154,1,229,29,258,4196,2021-01-25 06:08:56
4243,409,1,499,64,563,4197,2021-01-25 14:48:13
4244,375,3,597,77,674,4198,2021-01-25 15:16:06
4245,6,3,428,55,483,4199,2021-01-25 20:02:54
4246,401,1,149,19,168,4200,2021-01-25 04:48:12
4247,977,3,1247,162,1409,4201,2021-01-25 06:43:45
4248,661,1,599,77,676,4202,2021-01-25 16:28:25
4249,179,3,1127,146,1273,4203,2021-01-26 18:54:38
4250,840,3,888,115,1003,4204,2021-01-26 13:39:00
4251,829,3,827,107,934,4205,2021-01-25 22:01:16
4252,674,2,898,116,1014,4206,2021-01-26 03:24:44
4253,710,3,597,77,674,4207,2021-01-26 17:02:28
4254,602,3,1127,146,1273,4208,2021-01-26 17:47:36
4255,741,3,558,72,630,4209,2021-01-26 03:40:43
4256,414,5,926,120,1046,4210,2021-01-26 11:22:03
4257,571,2,798,103,901,4211,2021-01-26 17:42:55
4258,261,2,598,77,675,4212,2021-01-26 22:59:05
4259,286,2,798,103,901,4213,2021-01-26 23:31:26
4260,996,2,548,71,619,4214,2021-01-26 11:23:12
4261,601,2,828,107,935,4215,2021-01-27 02:03:37
4262,552,3,1197,155,1352,4216,2021-01-26 14:51:15
4263,84,3,528,68,596,4217,2021-01-26 06:35:18
4264,295,2,659,85,744,4218,2021-01-25 15:17:19
4265,19,3,608,79,687,4219,2021-01-25 15:18:30
4266,649,3,727,94,821,4220,2021-01-25 14:33:58
4267,791,2,898,116,1014,4221,2021-01-25 19:52:15
4268,604,1,99,12,111,4222,2021-01-25 20:59:40
4269,462,2,1098,142,1240,4223,2021-01-25 18:30:40
4270,975,5,1716,223,1939,4224,2021-01-26 00:47:07
4271,72,2,329,42,371,4225,2021-01-26 02:35:54
4272,439,3,1027,133,1160,4226,2021-01-26 00:49:35
4273,781,3,1047,136,1183,4227,2021-01-26 02:55:39
4274,576,2,329,42,371,4228,2021-01-26 04:46:01
4275,440,2,329,42,371,4229,2021-01-25 23:27:23
4276,501,2,898,116,1014,4230,2021-01-26 05:47:37
4277,623,3,428,55,483,4231,2021-01-25 15:03:40
4278,945,4,1546,200,1746,4232,2021-01-25 13:05:46
4279,594,3,847,110,957,4233,2021-01-25 17:41:35
4280,453,3,1247,162,1409,4234,2021-01-26 02:56:38
4281,436,4,1157,150,1307,4235,2021-01-25 23:31:36
4282,145,3,578,75,653,4236,2021-01-25 20:11:10
4283,415,5,1795,233,2028,4237,2021-01-25 05:20:01
4284,129,3,747,97,844,4238,2021-01-24 22:29:49
4285,386,3,428,55,483,4239,2021-01-25 00:44:19
4286,505,1,149,19,168,4240,2021-01-25 05:22:10
4287,169,4,1307,169,1476,4241,2021-01-25 01:05:11
4288,224,2,898,116,1014,4242,2021-01-25 08:48:24
4289,680,6,1525,198,1723,4243,2021-01-25 06:47:45
4290,773,3,1127,146,1273,4244,2021-01-25 06:22:05
4291,292,3,688,89,777,4245,2021-01-25 17:15:36
4292,259,3,1127,146,1273,4246,2021-01-25 15:18:03
4293,525,3,1047,136,1183,4247,2021-01-25 20:41:33
4294,442,2,429,55,484,4248,2021-01-25 05:29:41
4295,265,3,808,105,913,4249,2021-01-25 08:54:58
4296,424,2,798,103,901,4250,2021-01-25 17:41:57
4297,973,3,597,77,674,4251,2021-01-26 21:34:37
4298,284,3,1027,133,1160,4252,2021-01-26 14:49:57
4299,455,3,827,107,934,4253,2021-01-26 00:11:27
4300,730,3,428,55,483,4254,2021-01-26 03:45:21
4301,805,4,707,91,798,4255,2021-01-26 18:44:14
4302,357,2,429,55,484,4256,2021-01-26 18:26:46
4303,247,3,947,123,1070,4257,2021-01-26 04:06:15
4304,596,2,329,42,371,4258,2021-01-26 13:40:49
4305,327,5,887,115,1002,4259,2021-01-26 18:53:49
4306,409,3,558,72,630,4260,2021-01-27 00:33:21
4307,59,2,498,64,562,4261,2021-01-27 02:11:38
4308,59,2,498,64,562,4261,2021-01-27 02:11:38
4309,312,3,688,89,777,4262,2021-01-26 12:24:38
4310,953,2,429,55,484,4263,2021-01-27 03:57:52
4311,229,2,598,77,675,4264,2021-01-26 17:33:04
4312,362,5,1475,191,1666,4265,2021-01-26 09:17:27
4313,976,1,699,90,789,4266,2021-01-25 17:21:30
4314,766,2,898,116,1014,4267,2021-01-25 17:17:32
4315,255,3,688,89,777,4268,2021-01-25 15:56:43
4316,737,3,727,94,821,4269,2021-01-25 19:58:33
4317,794,2,498,64,562,4270,2021-01-25 22:00:11
4318,869,2,598,77,675,4271,2021-01-25 19:49:30
4319,265,3,1047,136,1183,4272,2021-01-26 01:41:44
4320,853,6,1494,194,1688,4273,2021-01-26 04:18:21
4321,465,3,927,120,1047,4274,2021-01-26 03:24:06
4322,812,2,898,116,1014,4275,2021-01-26 04:15:47
4323,364,2,329,42,371,4276,2021-01-26 07:09:34
4324,563,2,698,90,788,4277,2021-01-26 01:18:34
4325,852,3,747,97,844,4278,2021-01-26 06:37:25
4326,626,3,997,129,1126,4279,2021-01-25 16:45:31
4327,191,3,747,97,844,4280,2021-01-25 13:09:11
4328,657,1,699,90,789,4281,2021-01-25 20:13:41
4329,27,3,1127,146,1273,4282,2021-01-26 04:18:36
4330,837,5,1425,185,1610,4283,2021-01-26 01:08:08
4331,837,3,727,94,821,4284,2021-01-25 21:39:03
4332,510,3,647,84,731,4285,2021-01-25 05:53:29
4333,969,2,898,116,1014,4286,2021-01-24 23:19:50
4334,530,2,548,71,619,4287,2021-01-25 02:44:38
4335,355,3,997,129,1126,4288,2021-01-25 07:40:41
4336,181,3,558,72,630,4289,2021-01-25 02:04:02
4337,869,2,598,77,675,4290,2021-01-25 11:29:40
4338,649,3,478,62,540,4291,2021-01-25 08:46:04
4339,466,3,827,107,934,4292,2021-01-25 07:35:07
4340,841,1,399,51,450,4293,2021-01-25 18:20:26
4341,835,2,498,64,562,4294,2021-01-25 16:23:35
4342,963,3,478,62,540,4295,2021-01-25 21:40:36
4343,573,3,528,68,596,4296,2021-01-25 07:10:48
4344,448,3,897,116,1013,4297,2021-01-25 11:09:31
4345,307,3,927,120,1047,4298,2021-01-25 19:43:14
4346,434,2,898,116,1014,4299,2021-01-26 22:10:51
4347,557,3,578,75,653,4300,2021-01-26 16:48:50
4348,996,3,747,97,844,4301,2021-01-26 00:40:48
4349,102,3,747,97,844,4302,2021-01-26 06:18:01
4350,967,5,1725,224,1949,4303,2021-01-26 20:03:51
4351,286,3,997,129,1126,4304,2021-01-26 19:11:01
4352,802,4,996,129,1125,4305,2021-01-26 06:06:21
4353,860,3,608,79,687,4306,2021-01-26 14:59:28
4354,512,2,698,90,788,4307,2021-01-26 19:40:11
4355,2,4,1557,202,1759,4308,2021-01-27 01:38:30
4356,414,3,1027,133,1160,4309,2021-01-27 02:45:25
4357,97,2,698,90,788,4310,2021-01-27 02:21:00
4358,915,3,597,77,674,4311,2021-01-26 14:15:26
4359,249,2,598,77,675,4312,2021-01-27 05:33:26
4360,269,2,659,85,744,4313,2021-01-26 18:29:55
4361,345,3,697,90,787,4314,2021-01-26 09:35:44
4362,158,1,399,51,450,4315,2021-01-25 17:32:11
4363,527,3,888,115,1003,4316,2021-01-25 19:00:12
4364,19,5,2095,272,2367,4317,2021-01-25 17:25:51
4365,9,3,1327,172,1499,4318,2021-01-25 20:22:52
4366,767,3,797,103,900,4319,2021-01-25 22:47:17
4367,462,3,897,116,1013,4320,2021-01-25 22:05:32
4368,68,2,898,116,1014,4321,2021-01-26 03:01:42
4369,250,3,1027,133,1160,4322,2021-01-26 04:38:47
4370,475,5,2175,282,2457,4323,2021-01-26 04:40:46
4371,373,3,697,90,787,4324,2021-01-26 05:05:54
4372,331,1,299,38,337,4325,2021-01-26 09:28:22
4373,98,5,1656,215,1871,4326,2021-01-26 03:22:51
4374,763,3,947,123,1070,4327,2021-01-26 08:19:52
4375,302,2,498,64,562,4328,2021-01-25 17:24:22
4376,496,3,747,97,844,4329,2021-01-25 14:13:25
4377,333,2,459,59,518,4330,2021-01-25 22:31:14
4378,852,3,528,68,596,4331,2021-01-26 05:53:29
4379,105,2,329,42,371,4332,2021-01-26 02:26:05
4380,990,2,498,64,562,4333,2021-01-25 23:38:31
4381,448,2,798,103,901,4334,2021-01-25 07:30:05
4382,338,2,548,71,619,4335,2021-01-25 02:02:00
4383,769,3,897,116,1013,4336,2021-01-25 04:27:26
4384,97,3,608,79,687,4337,2021-01-25 09:26:53
4385,884,3,1047,136,1183,4338,2021-01-25 04:01:47
4386,123,3,658,85,743,4339,2021-01-25 12:31:15
4387,774,3,847,110,957,4340,2021-01-25 11:28:56
4388,978,3,927,120,1047,4341,2021-01-25 08:49:35
4389,961,2,659,85,744,4342,2021-01-25 19:41:25
4390,829,5,1056,137,1193,4343,2021-01-25 17:40:59
4391,372,5,1495,194,1689,4344,2021-01-25 21:58:51
4392,803,3,747,97,844,4345,2021-01-25 09:10:12
4393,665,5,1676,217,1893,4346,2021-01-25 13:32:24
4394,229,2,498,64,562,4347,2021-01-25 22:01:57
4395,23,3,1047,136,1183,4348,2021-01-26 22:48:39
4396,697,3,1047,136,1183,4349,2021-01-26 18:38:08
4397,964,2,848,110,958,4350,2021-01-26 01:57:33
4398,949,3,647,84,731,4351,2021-01-26 08:12:22
4399,899,5,1156,150,1306,4352,2021-01-26 20:16:36
4400,617,2,648,84,732,4353,2021-01-26 21:17:36
4401,790,2,429,55,484,4354,2021-01-26 08:11:54
4402,430,5,1625,211,1836,4355,2021-01-26 16:59:09
4403,933,2,598,77,675,4356,2021-01-26 21:33:22
4404,83,2,459,59,518,4357,2021-01-27 03:12:28
4405,372,3,888,115,1003,4358,2021-01-27 02:49:53
4406,922,2,798,103,901,4359,2021-01-27 04:26:12
4407,520,2,498,64,562,4360,2021-01-26 14:47:47
4408,212,5,1226,159,1385,4361,2021-01-27 05:59:32
4409,571,2,598,77,675,4362,2021-01-26 18:40:17
4410,759,2,598,77,675,4363,2021-01-26 12:00:30
4411,779,3,1127,146,1273,4364,2021-01-25 17:53:49
4412,563,3,578,75,653,4365,2021-01-25 19:25:57
4413,492,4,1357,176,1533,4366,2021-01-25 17:34:01
4414,561,3,528,68,596,4367,2021-01-25 20:54:04
4415,934,2,798,103,901,4368,2021-01-25 23:44:03
4416,13,6,2124,276,2400,4369,2021-01-25 23:00:57
4417,932,2,448,58,506,4370,2021-01-26 03:54:28
4418,465,3,997,129,1126,4371,2021-01-26 04:53:25
4419,838,3,947,123,1070,4372,2021-01-26 05:17:01
4420,320,3,997,129,1126,4373,2021-01-26 07:37:51
4421,102,2,698,90,788,4374,2021-01-26 11:52:31
4422,480,2,498,64,562,4375,2021-01-26 04:59:21
4423,444,5,1475,191,1666,4376,2021-01-26 09:06:34
4424,631,3,827,107,934,4377,2021-01-25 19:47:16
4425,751,3,528,68,596,4378,2021-01-25 16:31:45
4426,238,5,1406,182,1588,4379,2021-01-26 00:10:34
4427,955,3,1327,172,1499,4380,2021-01-26 07:25:51
4428,714,2,828,107,935,4381,2021-01-26 03:03:54
4429,102,6,1574,204,1778,4382,2021-01-26 01:47:11
4430,30,2,598,77,675,4383,2021-01-25 10:11:28
4431,294,3,608,79,687,4384,2021-01-25 03:19:44
4432,422,5,1795,233,2028,4385,2021-01-25 06:51:36
4433,325,3,997,129,1126,4386,2021-01-25 11:31:57
4434,429,3,747,97,844,4387,2021-01-25 04:05:08
4435,938,3,797,103,900,4388,2021-01-25 13:01:15
4436,18,2,1098,142,1240,4389,2021-01-25 14:05:32
4437,908,3,1127,146,1273,4390,2021-01-25 11:19:34
4438,547,3,558,72,630,4391,2021-01-25 20:51:39
4439,237,5,2095,272,2367,4392,2021-01-25 20:01:33
4440,837,3,927,120,1047,4393,2021-01-25 22:38:57
4441,52,2,498,64,562,4394,2021-01-25 10:46:57
4442,277,3,697,90,787,4395,2021-01-25 14:15:22
4443,71,2,498,64,562,4396,2021-01-25 23:59:33
4444,908,3,927,120,1047,4397,2021-01-27 00:05:06
4445,217,3,428,55,483,4398,2021-01-26 18:51:20
4446,210,3,688,89,777,4399,2021-01-26 03:04:26
4447,682,2,498,64,562,4400,2021-01-26 08:33:32
4448,663,2,1098,142,1240,4401,2021-01-26 21:25:48
4449,295,3,1047,136,1183,4402,2021-01-26 22:57:48
4450,759,2,928,120,1048,4403,2021-01-26 09:14:41
4451,959,3,597,77,674,4404,2021-01-26 18:32:20
4452,690,6,1435,186,1621,4405,2021-01-27 00:16:31
4453,785,5,1376,178,1554,4406,2021-01-27 03:32:13
4454,33,1,99,12,111,4407,2021-01-27 04:02:26
4455,605,3,1197,155,1352,4408,2021-01-27 04:52:50
4456,159,3,827,107,934,4409,2021-01-26 14:52:48
4457,250,2,698,90,788,4410,2021-01-27 08:12:04
4458,100,3,1327,172,1499,4411,2021-01-26 20:05:16
4459,209,2,898,116,1014,4412,2021-01-26 12:09:52
4460,972,6,1305,169,1474,4413,2021-01-25 17:57:53
4461,746,3,1197,155,1352,4414,2021-01-25 21:48:38
4462,260,3,647,84,731,4415,2021-01-25 18:16:47
4463,692,1,399,51,450,4416,2021-01-25 21:13:25
4464,578,2,498,64,562,4417,2021-01-25 23:47:10
4465,454,1,399,51,450,4418,2021-01-26 00:26:24
4466,52,5,1206,156,1362,4419,2021-01-26 05:01:05
4467,916,3,727,94,821,4420,2021-01-26 07:08:45
4468,460,6,1774,230,2004,4421,2021-01-26 07:38:54
4469,891,2,429,55,484,4422,2021-01-26 08:20:26
4470,891,2,429,55,484,4422,2021-01-26 08:20:26
4471,166,1,229,29,258,4423,2021-01-26 12:22:12
4472,70,1,699,90,789,4424,2021-01-26 07:15:33
4473,913,3,697,90,787,4425,2021-01-26 10:57:58
4474,741,3,697,90,787,4426,2021-01-25 22:19:15
4475,847,2,659,85,744,4427,2021-01-25 16:41:21
4476,547,2,648,84,732,4428,2021-01-26 02:07:56
4477,748,3,727,94,821,4429,2021-01-26 09:25:26
4478,380,3,578,75,653,4430,2021-01-26 03:30:37
4479,640,2,628,81,709,4431,2021-01-26 02:25:41
4480,27,6,1475,191,1666,4432,2021-01-25 11:57:15
4481,905,3,727,94,821,4433,2021-01-25 05:11:23
4482,401,3,558,72,630,4434,2021-01-25 08:53:20
4483,254,3,528,68,596,4435,2021-01-25 13:19:32
4484,96,3,1247,162,1409,4436,2021-01-25 05:52:58
4485,908,3,1247,162,1409,4437,2021-01-25 14:50:00
4486,526,2,698,90,788,4438,2021-01-25 15:48:05
4487,320,3,1027,133,1160,4439,2021-01-25 12:27:06
4488,919,2,498,64,562,4440,2021-01-25 22:48:29
4489,832,3,888,115,1003,4441,2021-01-25 22:19:36
4490,794,3,808,105,913,4442,2021-01-26 00:17:03
4491,186,2,898,116,1014,4443,2021-01-25 13:12:59
4492,132,3,688,89,777,4444,2021-01-25 16:33:39
4493,173,4,1096,142,1238,4445,2021-01-26 00:26:07
4494,724,3,827,107,934,4446,2021-01-27 02:24:05
4495,394,3,608,79,687,4447,2021-01-26 19:02:46
4496,30,2,898,116,1014,4448,2021-01-26 04:28:53
4497,260,3,747,97,844,4449,2021-01-26 11:09:20
4498,438,3,797,103,900,4450,2021-01-26 21:48:18
4499,781,3,608,79,687,4451,2021-01-27 00:24:43
4500,435,3,558,72,630,4452,2021-01-26 10:36:24
4501,16,3,808,105,913,4453,2021-01-26 18:32:53
4502,809,2,698,90,788,4454,2021-01-27 02:02:22
4503,427,3,658,85,743,4455,2021-01-27 03:43:14
4504,776,2,498,64,562,4456,2021-01-27 05:54:02
4505,298,3,697,90,787,4457,2021-01-27 05:39:53
4506,787,3,947,123,1070,4458,2021-01-26 15:34:22
4507,291,4,1496,194,1690,4459,2021-01-27 10:55:08
4508,126,3,747,97,844,4460,2021-01-26 20:24:56
4509,668,4,1057,137,1194,4461,2021-01-26 14:36:18
4510,214,2,1098,142,1240,4462,2021-01-25 20:18:32
4511,458,2,698,90,788,4463,2021-01-25 22:31:34
4512,292,3,847,110,957,4464,2021-01-25 19:35:06
4513,728,5,1376,178,1554,4465,2021-01-25 23:06:22
4514,762,2,798,103,901,4466,2021-01-26 02:06:24
4515,112,2,598,77,675,4467,2021-01-26 01:02:14
4516,742,3,1127,146,1273,4468,2021-01-26 07:20:17
4517,359,3,1047,136,1183,4469,2021-01-26 09:09:18
4518,464,3,1127,146,1273,4470,2021-01-26 08:55:06
4519,97,3,697,90,787,4471,2021-01-26 10:46:05
4520,383,3,1197,155,1352,4472,2021-01-26 10:15:20
4521,570,2,429,55,484,4473,2021-01-26 13:53:03
4522,85,2,598,77,675,4474,2021-01-26 08:51:33
4523,552,3,897,116,1013,4475,2021-01-26 11:10:22
4524,32,3,747,97,844,4476,2021-01-25 22:59:25
4525,605,3,1047,136,1183,4477,2021-01-25 17:59:28
4526,825,3,528,68,596,4478,2021-01-26 02:42:05
4527,391,3,578,75,653,4479,2021-01-26 12:11:28
4528,834,2,798,103,901,4480,2021-01-26 05:17:59
4529,748,3,1247,162,1409,4481,2021-01-26 04:28:30
4530,331,3,727,94,821,4482,2021-01-25 14:07:35
4531,978,3,927,120,1047,4483,2021-01-25 07:02:41
4532,779,2,429,55,484,4484,2021-01-25 10:08:58
4533,966,3,1197,155,1352,4485,2021-01-25 13:32:57
4534,746,3,747,97,844,4486,2021-01-25 06:10:55
4535,676,2,628,81,709,4487,2021-01-25 16:01:51
4536,207,3,528,68,596,4488,2021-01-25 17:38:07
4537,525,3,797,103,900,4489,2021-01-25 13:39:34
4538,140,5,1645,213,1858,4490,2021-01-25 23:22:56
4539,870,2,928,120,1048,4491,2021-01-26 00:35:54
4540,778,3,747,97,844,4492,2021-01-26 00:34:29
4541,420,3,528,68,596,4493,2021-01-25 14:22:19
4542,83,2,429,55,484,4494,2021-01-25 18:45:31
4543,937,2,429,55,484,4495,2021-01-26 00:37:02
4544,60,2,329,42,371,4496,2021-01-27 04:25:05
4545,891,3,1197,155,1352,4497,2021-01-26 21:36:22
4546,827,2,598,77,675,4498,2021-01-26 05:22:20
4547,495,5,1325,172,1497,4499,2021-01-26 12:35:11
4548,49,1,399,51,450,4500,2021-01-27 00:32:46
4549,670,2,329,42,371,4501,2021-01-27 02:47:33
4550,334,3,997,129,1126,4502,2021-01-26 11:55:15
4551,187,2,448,58,506,4503,2021-01-26 20:47:54
4552,105,4,1356,176,1532,4504,2021-01-27 03:24:40
4553,211,2,329,42,371,4505,2021-01-27 04:41:33
4554,318,3,608,79,687,4506,2021-01-27 07:32:52
4555,132,1,229,29,258,4507,2021-01-27 05:52:38
4556,452,3,1327,172,1499,4508,2021-01-26 17:45:04
4557,614,3,997,129,1126,4509,2021-01-27 12:31:01
4558,476,2,459,59,518,4510,2021-01-26 21:35:26
4559,193,6,2024,263,2287,4511,2021-01-26 17:18:54
4560,777,2,598,77,675,4512,2021-01-25 21:40:21
4561,674,1,99,12,111,4513,2021-01-26 00:03:11
4562,556,3,647,84,731,4514,2021-01-25 20:57:30
4563,519,4,1276,165,1441,4515,2021-01-26 00:08:55
4564,323,3,997,129,1126,4516,2021-01-26 02:34:24
4565,269,3,747,97,844,4517,2021-01-26 01:13:22
4566,687,3,1127,146,1273,4518,2021-01-26 08:11:44
4567,21,2,598,77,675,4519,2021-01-26 11:17:39
4568,516,3,1327,172,1499,4520,2021-01-26 09:06:10
4569,790,6,1615,209,1824,4521,2021-01-26 13:29:18
4570,798,2,698,90,788,4522,2021-01-26 12:54:20
4571,435,3,697,90,787,4523,2021-01-26 14:04:11
4572,463,3,1047,136,1183,4524,2021-01-26 10:03:28
4573,657,3,528,68,596,4525,2021-01-26 11:26:45
4574,313,3,478,62,540,4526,2021-01-26 01:29:57
4575,557,3,688,89,777,4527,2021-01-25 20:19:50
4576,689,2,628,81,709,4528,2021-01-26 04:59:55
4577,779,2,498,64,562,4529,2021-01-26 13:44:12
4578,386,3,758,98,856,4530,2021-01-26 06:51:36
4579,117,2,898,116,1014,4531,2021-01-26 06:58:50
4580,582,3,558,72,630,4532,2021-01-25 15:12:29
4581,72,2,659,85,744,4533,2021-01-25 09:37:48
4582,632,3,1327,172,1499,4534,2021-01-25 12:32:00
4583,441,4,976,126,1102,4535,2021-01-25 13:38:25
4584,483,3,658,85,743,4536,2021-01-25 06:35:24
4585,583,2,928,120,1048,4537,2021-01-25 16:48:12
4586,392,2,598,77,675,4538,2021-01-25 18:08:44
4587,218,2,898,116,1014,4539,2021-01-25 14:41:18
4588,430,1,229,29,258,4540,2021-01-25 23:28:01
4589,693,2,459,59,518,4541,2021-01-26 02:54:45
4590,522,3,997,129,1126,4542,2021-01-26 01:08:02
4591,428,1,99,12,111,4543,2021-01-25 16:31:40
4592,131,3,428,55,483,4544,2021-01-25 20:18:36
4593,951,2,598,77,675,4545,2021-01-26 02:27:20
4594,345,3,428,55,483,4546,2021-01-27 04:35:11
4595,509,3,578,75,653,4547,2021-01-26 23:42:24
4596,457,3,608,79,687,4548,2021-01-26 06:11:43
4597,303,3,1197,155,1352,4549,2021-01-26 13:35:34
4598,458,2,898,116,1014,4550,2021-01-27 00:58:30
4599,380,3,688,89,777,4551,2021-01-27 05:24:21
4600,899,5,1106,143,1249,4552,2021-01-26 12:44:14
4601,769,4,1146,148,1294,4553,2021-01-26 21:00:25
4602,642,2,459,59,518,4554,2021-01-27 05:13:56
4603,58,3,1247,162,1409,4555,2021-01-27 07:24:54
4604,577,3,1047,136,1183,4556,2021-01-27 10:09:58
4605,320,2,598,77,675,4557,2021-01-27 08:28:34
4606,658,3,947,123,1070,4558,2021-01-26 20:15:14
4607,261,3,1247,162,1409,4559,2021-01-27 13:18:56
4608,767,3,697,90,787,4560,2021-01-26 23:09:24
4609,456,3,997,129,1126,4561,2021-01-26 17:56:13
4610,922,5,1225,159,1384,4562,2021-01-25 22:14:35
4611,163,3,927,120,1047,4563,2021-01-26 00:33:39
4612,33,3,1047,136,1183,4564,2021-01-25 23:07:23
4613,444,1,229,29,258,4565,2021-01-26 00:42:49
4614,158,2,648,84,732,4566,2021-01-26 02:42:30
4615,524,2,659,85,744,4567,2021-01-26 03:39:20
4616,428,3,897,116,1013,4568,2021-01-26 09:44:37
4617,29,2,498,64,562,4569,2021-01-26 13:50:34
4618,319,3,1047,136,1183,4570,2021-01-26 11:18:43
4619,792,3,758,98,856,4571,2021-01-26 15:15:52
4620,154,5,1245,161,1406,4572,2021-01-26 15:36:58
4621,527,3,478,62,540,4573,2021-01-26 16:14:52
4622,275,3,747,97,844,4574,2021-01-26 12:38:23
4623,616,2,798,103,901,4575,2021-01-26 13:10:40
4624,921,3,597,77,674,4576,2021-01-26 03:40:21
4625,907,1,229,29,258,4577,2021-01-25 22:33:50
4626,816,3,658,85,743,4578,2021-01-26 05:45:27
4627,77,3,797,103,900,4579,2021-01-26 14:20:40
4628,717,4,1457,189,1646,4580,2021-01-26 09:24:57
4629,523,3,597,77,674,4581,2021-01-26 07:03:11
4630,928,3,897,116,1013,4582,2021-01-25 16:01:20
4631,259,3,747,97,844,4583,2021-01-25 11:33:02
4632,328,3,888,115,1003,4584,2021-01-25 13:53:37
4633,998,3,797,103,900,4585,2021-01-25 16:17:20
4634,98,2,648,84,732,4586,2021-01-25 09:20:34
4635,963,2,598,77,675,4587,2021-01-25 16:55:43
4636,903,2,498,64,562,4588,2021-01-25 19:40:13
4637,10,4,1626,211,1837,4589,2021-01-25 15:51:36
4638,584,2,798,103,901,4590,2021-01-26 01:46:16
4639,439,2,429,55,484,4591,2021-01-26 05:23:03
4640,142,2,459,59,518,4592,2021-01-26 03:00:42
4641,856,2,898,116,1014,4593,2021-01-25 18:00:05
4642,684,2,598,77,675,4594,2021-01-25 22:44:46
4643,661,3,808,105,913,4595,2021-01-26 02:40:31
4644,152,2,898,116,1014,4596,2021-01-27 06:42:37
4645,567,2,459,59,518,4597,2021-01-27 01:08:52
4646,952,4,1176,152,1328,4598,2021-01-26 08:37:42
4647,121,1,699,90,789,4599,2021-01-26 15:58:46
4648,319,3,1027,133,1160,4600,2021-01-27 02:16:52
4649,844,2,1098,142,1240,4601,2021-01-27 08:10:44
4650,573,3,658,85,743,4602,2021-01-26 12:51:48
4651,484,3,1297,168,1465,4603,2021-01-26 21:08:24
4652,442,3,578,75,653,4604,2021-01-27 05:54:43
4653,216,2,628,81,709,4605,2021-01-27 07:45:29
4654,165,3,697,90,787,4606,2021-01-27 10:37:24
4655,236,3,1027,133,1160,4607,2021-01-27 10:42:27
4656,309,2,498,64,562,4608,2021-01-26 22:52:10
4657,319,2,659,85,744,4609,2021-01-27 14:32:02
4658,163,1,99,12,111,4610,2021-01-27 00:32:35
4659,356,3,997,129,1126,4611,2021-01-26 18:20:48
4660,100,2,329,42,371,4612,2021-01-26 00:47:53
4661,249,2,1098,142,1240,4613,2021-01-26 01:38:08
4662,115,2,459,59,518,4614,2021-01-26 01:20:09
4663,181,2,798,103,901,4615,2021-01-26 03:25:45
4664,679,2,798,103,901,4616,2021-01-26 03:16:44
4665,430,4,1326,172,1498,4617,2021-01-26 06:15:18
4666,309,3,597,77,674,4618,2021-01-26 10:13:39
4667,593,2,459,59,518,4619,2021-01-26 14:50:43
4668,729,3,697,90,787,4620,2021-01-26 12:28:43
4669,676,3,1247,162,1409,4621,2021-01-26 15:49:03
4670,82,2,698,90,788,4622,2021-01-26 16:26:22
4671,249,3,797,103,900,4623,2021-01-26 18:46:00
4672,995,3,747,97,844,4624,2021-01-26 14:53:52
4673,760,3,997,129,1126,4625,2021-01-26 14:59:45
4674,28,2,898,116,1014,4626,2021-01-26 05:51:09
4675,660,1,149,19,168,4627,2021-01-26 00:17:34
4676,57,5,1645,213,1858,4628,2021-01-26 07:21:47
4677,820,3,1127,146,1273,4629,2021-01-26 14:56:03
4678,459,3,808,105,913,4630,2021-01-26 12:06:49
4679,319,3,1127,146,1273,4631,2021-01-26 08:57:17
4680,401,2,459,59,518,4632,2021-01-25 16:52:53
4681,172,2,598,77,675,4633,2021-01-25 13:54:01
4682,612,3,1027,133,1160,4634,2021-01-25 14:30:54
4683,782,1,699,90,789,4635,2021-01-25 16:38:38
4684,320,6,1374,178,1552,4636,2021-01-25 09:22:20
4685,804,4,1487,193,1680,4637,2021-01-25 18:30:22
4686,26,2,659,85,744,4638,2021-01-25 22:20:48
4687,309,2,459,59,518,4639,2021-01-25 17:01:27
4688,706,2,498,64,562,4640,2021-01-26 04:04:00
4689,134,3,797,103,900,4641,2021-01-26 06:41:32
4690,335,3,558,72,630,4642,2021-01-26 03:19:51
4691,374,2,429,55,484,4643,2021-01-25 18:35:51
4692,58,3,997,129,1126,4644,2021-01-25 22:51:40
4693,336,2,598,77,675,4645,2021-01-26 03:07:04
4694,279,3,827,107,934,4646,2021-01-27 07:51:03
4695,592,3,1247,162,1409,4647,2021-01-27 03:21:13
4696,47,2,898,116,1014,4648,2021-01-26 11:01:47
4697,612,3,808,105,913,4649,2021-01-26 16:32:51
4698,941,3,997,129,1126,4650,2021-01-27 04:05:23
4699,62,2,659,85,744,4651,2021-01-27 09:16:28
4700,663,3,658,85,743,4652,2021-01-26 15:19:11
4701,748,3,1027,133,1160,4653,2021-01-26 21:10:19
4702,524,3,888,115,1003,4654,2021-01-27 06:52:53
4703,494,3,528,68,596,4655,2021-01-27 09:00:31
4704,279,3,697,90,787,4656,2021-01-27 11:06:25
4705,57,3,827,107,934,4657,2021-01-27 12:56:15
4706,450,3,608,79,687,4658,2021-01-26 23:23:54
4707,79,2,628,81,709,4659,2021-01-27 14:54:58
4708,79,2,628,81,709,4659,2021-01-27 14:54:58
4709,694,2,598,77,675,4660,2021-01-27 01:40:55
4710,606,2,598,77,675,4661,2021-01-26 20:25:35
4711,779,3,528,68,596,4662,2021-01-26 01:53:44
4712,602,3,747,97,844,4663,2021-01-26 03:36:05
4713,707,3,428,55,483,4664,2021-01-26 01:28:01
4714,542,2,798,103,901,4665,2021-01-26 05:13:03
4715,903,4,1826,237,2063,4666,2021-01-26 05:48:01
4716,840,3,927,120,1047,4667,2021-01-26 08:15:49
4717,192,1,149,19,168,4668,2021-01-26 12:15:40
4718,991,3,997,129,1126,4669,2021-01-26 15:51:39
4719,51,3,1047,136,1183,4670,2021-01-26 13:09:32
4720,969,3,797,103,900,4671,2021-01-26 17:44:32
4721,928,3,997,129,1126,4672,2021-01-26 19:10:42
4722,898,2,1098,142,1240,4673,2021-01-26 19:22:26
4723,655,4,1596,207,1803,4674,2021-01-26 15:26:40
4724,516,3,1197,155,1352,4675,2021-01-26 17:07:41
4725,662,3,758,98,856,4676,2021-01-26 06:02:27
4726,77,3,697,90,787,4677,2021-01-26 00:27:02
4727,290,2,798,103,901,4678,2021-01-26 09:19:47
4728,883,2,429,55,484,4679,2021-01-26 16:48:58
4729,775,4,1596,207,1803,4680,2021-01-26 13:34:00
4730,455,3,578,75,653,4681,2021-01-26 09:07:38
4731,437,2,1098,142,1240,4682,2021-01-25 18:44:46
4732,833,3,997,129,1126,4683,2021-01-25 15:54:45
4733,388,3,428,55,483,4684,2021-01-25 16:16:39
4734,304,1,399,51,450,4685,2021-01-25 18:46:10
4735,102,3,747,97,844,4686,2021-01-25 10:13:48
4736,892,3,658,85,743,4687,2021-01-25 20:29:46
4737,524,3,747,97,844,4688,2021-01-25 22:34:08
4738,150,2,548,71,619,4689,2021-01-25 19:13:06
4739,669,2,798,103,901,4690,2021-01-26 05:04:35
4740,550,3,827,107,934,4691,2021-01-26 08:14:03
4741,621,3,997,129,1126,4692,2021-01-26 05:17:44
4742,828,6,1505,195,1700,4693,2021-01-25 19:06:42
4743,789,2,1098,142,1240,4694,2021-01-25 23:53:04
4744,237,3,558,72,630,4695,2021-01-26 04:59:02
4745,144,3,827,107,934,4696,2021-01-27 09:24:20
4746,986,3,1027,133,1160,4697,2021-01-27 05:30:32
4747,449,2,898,116,1014,4698,2021-01-26 13:17:48
4748,440,3,747,97,844,4699,2021-01-26 16:53:05
4749,627,3,1247,162,1409,4700,2021-01-27 05:31:31
4750,816,3,808,105,913,4701,2021-01-27 09:40:06
4751,695,3,428,55,483,4702,2021-01-26 15:49:46
4752,4,2,898,116,1014,4703,2021-01-26 22:47:44
4753,16,3,1127,146,1273,4704,2021-01-27 08:59:58
4754,687,6,1525,198,1723,4705,2021-01-27 09:34:02
4755,386,3,647,84,731,4706,2021-01-27 13:11:23
4756,504,2,798,103,901,4707,2021-01-27 12:56:42
4757,633,3,947,123,1070,4708,2021-01-27 01:19:07
4758,776,3,1127,146,1273,4709,2021-01-27 17:36:44
4759,936,4,876,113,989,4710,2021-01-27 16:48:29
4760,809,3,897,116,1013,4711,2021-01-27 02:12:49
4761,498,3,1027,133,1160,4712,2021-01-26 22:13:30
4762,129,3,528,68,596,4713,2021-01-26 02:29:01
4763,378,3,1327,172,1499,4714,2021-01-26 05:46:35
4764,452,3,997,129,1126,4715,2021-01-26 04:12:29
4765,985,1,229,29,258,4716,2021-01-26 05:50:00
4766,802,3,927,120,1047,4717,2021-01-26 07:51:08
4767,942,6,2024,263,2287,4718,2021-01-26 09:06:26
4768,460,3,597,77,674,4719,2021-01-26 12:56:24
4769,815,2,498,64,562,4720,2021-01-26 17:42:36
4770,136,3,1127,146,1273,4721,2021-01-26 13:21:49
4771,669,2,1098,142,1240,4722,2021-01-26 17:53:26
4772,19,4,1207,156,1363,4723,2021-01-26 19:29:20
4773,588,3,847,110,957,4724,2021-01-26 19:39:53
4774,458,2,528,68,596,4725,2021-01-26 16:28:29
4775,262,3,997,129,1126,4726,2021-01-26 19:09:34
4776,708,3,597,77,674,4727,2021-01-26 06:07:35
4777,428,3,428,55,483,4728,2021-01-26 02:10:29
4778,103,1,699,90,789,4729,2021-01-26 09:34:00
4779,670,3,478,62,540,4730,2021-01-26 18:09:52
4780,837,3,428,55,483,4731,2021-01-26 16:09:49
4781,448,4,1346,174,1520,4732,2021-01-26 09:49:05
4782,197,5,1486,193,1679,4733,2021-01-25 21:19:23
4783,798,3,808,105,913,4734,2021-01-25 16:17:13
4784,554,5,1975,256,2231,4735,2021-01-25 18:24:39
4785,69,3,1327,172,1499,4736,2021-01-25 21:12:05
4786,348,3,578,75,653,4737,2021-01-25 10:16:02
4787,587,6,1505,195,1700,4738,2021-01-25 20:42:38
4788,910,3,1047,136,1183,4739,2021-01-25 23:39:27
4789,356,2,329,42,371,4740,2021-01-25 21:19:35
4790,993,2,628,81,709,4741,2021-01-26 05:09:55
4791,673,3,1047,136,1183,4742,2021-01-26 09:56:43
4792,655,3,897,116,1013,4743,2021-01-26 07:05:17
4793,179,3,647,84,731,4744,2021-01-25 19:55:45
4794,295,3,747,97,844,4745,2021-01-26 00:20:13
4795,906,2,798,103,901,4746,2021-01-26 06:22:43
4796,498,2,498,64,562,4747,2021-01-27 11:00:01
4797,747,3,927,120,1047,4748,2021-01-27 06:02:48
4798,285,3,1027,133,1160,4749,2021-01-26 14:27:27
4799,67,3,658,85,743,4750,2021-01-26 19:17:18
4800,487,3,478,62,540,4751,2021-01-27 05:36:51
4801,785,3,558,72,630,4752,2021-01-27 09:57:18
4802,485,2,898,116,1014,4753,2021-01-26 18:35:53
4803,788,2,798,103,901,4754,2021-01-26 22:59:43
4804,204,3,847,110,957,4755,2021-01-27 10:36:40
4805,615,3,1047,136,1183,4756,2021-01-27 11:43:21
4806,279,2,548,71,619,4757,2021-01-27 14:52:17
4807,743,3,947,123,1070,4758,2021-01-27 14:51:30
4808,11,3,647,84,731,4759,2021-01-27 01:25:00
4809,717,3,808,105,913,4760,2021-01-27 17:58:01
4810,805,2,429,55,484,4761,2021-01-27 18:57:56
4811,841,1,599,77,676,4762,2021-01-27 02:40:33
4812,984,3,578,75,653,4763,2021-01-27 00:00:28
4813,900,3,688,89,777,4764,2021-01-26 04:58:24
4814,315,2,898,116,1014,4765,2021-01-26 07:25:18
4815,717,2,898,116,1014,4766,2021-01-26 06:49:00
4816,820,4,1117,145,1262,4767,2021-01-26 08:19:08
4817,240,2,828,107,935,4768,2021-01-26 08:29:18
4818,195,2,598,77,675,4769,2021-01-26 10:41:45
4819,398,3,558,72,630,4770,2021-01-26 15:05:46
4820,662,3,1197,155,1352,4771,2021-01-26 19:05:12
4821,670,3,528,68,596,4772,2021-01-26 14:10:16
4822,427,3,827,107,934,4773,2021-01-26 20:12:41
4823,995,3,658,85,743,4774,2021-01-26 19:47:28
4824,131,3,688,89,777,4775,2021-01-26 19:44:20
4825,969,5,1925,250,2175,4776,2021-01-26 18:28:39
4826,141,3,997,129,1126,4777,2021-01-26 20:25:16
4827,877,2,329,42,371,4778,2021-01-26 06:33:16
4828,182,2,698,90,788,4779,2021-01-26 02:18:00
4829,796,5,1556,202,1758,4780,2021-01-26 10:49:17
4830,966,4,1357,176,1533,4781,2021-01-26 18:45:44
4831,349,3,1247,162,1409,4782,2021-01-26 17:47:47
4832,595,3,428,55,483,4783,2021-01-26 11:04:29
4833,697,3,697,90,787,4784,2021-01-25 21:57:53
4834,433,3,428,55,483,4785,2021-01-25 16:37:31
4835,770,3,1047,136,1183,4786,2021-01-25 19:55:35
4836,144,3,888,115,1003,4787,2021-01-25 23:23:28
4837,960,2,498,64,562,4788,2021-01-25 11:00:00
4838,371,2,598,77,675,4789,2021-01-25 23:20:06
4839,826,3,827,107,934,4790,2021-01-26 02:18:01
4840,494,3,827,107,934,4791,2021-01-25 23:58:39
4841,482,3,1047,136,1183,4792,2021-01-26 06:40:27
4842,831,3,697,90,787,4793,2021-01-26 10:51:11
4843,553,2,928,120,1048,4794,2021-01-26 09:06:17
4844,520,3,897,116,1013,4795,2021-01-25 22:10:40
4845,520,3,897,116,1013,4795,2021-01-25 22:10:40
4846,896,3,697,90,787,4796,2021-01-26 02:11:56
4847,220,2,1098,142,1240,4797,2021-01-26 06:29:50
4848,446,3,997,129,1126,4798,2021-01-27 12:55:38
4849,769,3,888,115,1003,4799,2021-01-27 07:51:28
4850,315,2,598,77,675,4800,2021-01-26 16:08:13
4851,455,3,1027,133,1160,4801,2021-01-26 21:27:03
4852,30,2,848,110,958,4802,2021-01-27 07:12:28
4853,862,2,398,51,449,4803,2021-01-27 12:25:36
4854,599,2,459,59,518,4804,2021-01-26 20:10:46
4855,480,3,1127,146,1273,4805,2021-01-27 01:16:15
4856,425,5,976,126,1102,4806,2021-01-27 12:28:36
4857,203,5,1195,155,1350,4807,2021-01-27 12:34:47
4858,221,3,997,129,1126,4808,2021-01-27 14:59:42
4859,672,3,847,110,957,4809,2021-01-27 16:50:31
4860,686,3,697,90,787,4810,2021-01-27 02:56:24
4861,439,3,697,90,787,4811,2021-01-27 18:58:07
4862,261,3,1027,133,1160,4812,2021-01-27 21:09:23
4863,469,3,808,105,913,4813,2021-01-27 03:36:44
4864,704,2,798,103,901,4814,2021-01-27 00:45:37
4865,23,3,947,123,1070,4815,2021-01-26 07:08:42
4866,164,3,1127,146,1273,4816,2021-01-26 08:44:19
4867,913,3,997,129,1126,4817,2021-01-26 09:32:30
4868,869,3,927,120,1047,4818,2021-01-26 09:40:48
4869,360,2,659,85,744,4819,2021-01-26 08:56:33
4870,916,2,459,59,518,4820,2021-01-26 12:12:48
4871,966,3,1027,133,1160,4821,2021-01-26 17:37:45
4872,646,2,548,71,619,4822,2021-01-26 20:59:07
4873,525,3,478,62,540,4823,2021-01-26 14:53:41
4874,555,2,398,51,449,4824,2021-01-26 22:51:34
4875,694,2,698,90,788,4825,2021-01-26 21:35:16
4876,971,2,1098,142,1240,4826,2021-01-26 20:00:11
4877,625,3,1127,146,1273,4827,2021-01-26 20:41:40
4878,126,3,697,90,787,4828,2021-01-26 21:34:26
4879,652,3,478,62,540,4829,2021-01-26 08:31:29
4880,132,6,1615,209,1824,4830,2021-01-26 03:04:20
4881,621,5,1256,163,1419,4831,2021-01-26 13:33:47
4882,468,3,558,72,630,4832,2021-01-26 20:04:13
4883,896,2,659,85,744,4833,2021-01-26 18:15:02
4884,9,3,997,129,1126,4834,2021-01-26 11:57:48
4885,489,3,528,68,596,4835,2021-01-26 00:43:51
4886,144,3,1197,155,1352,4836,2021-01-25 18:55:42
4887,214,6,2074,269,2343,4837,2021-01-25 20:24:31
4888,978,2,659,85,744,4838,2021-01-25 23:56:08
4889,943,3,997,129,1126,4839,2021-01-25 12:50:45
4890,600,3,1127,146,1273,4840,2021-01-26 00:32:36
4891,250,3,428,55,483,4841,2021-01-26 04:16:53
4892,568,2,498,64,562,4842,2021-01-26 02:20:25
4893,299,2,698,90,788,4843,2021-01-26 07:25:25
4894,447,5,1295,168,1463,4844,2021-01-26 12:15:00
4895,479,3,647,84,731,4845,2021-01-26 10:09:52
4896,647,3,947,123,1070,4846,2021-01-25 23:52:48
4897,346,3,1047,136,1183,4847,2021-01-25 23:08:45
4898,346,3,1047,136,1183,4847,2021-01-25 23:08:45
4899,618,2,329,42,371,4848,2021-01-26 04:04:15
4900,256,2,429,55,484,4849,2021-01-26 08:01:33
4901,581,3,827,107,934,4850,2021-01-27 13:56:10
4902,198,1,299,38,337,4851,2021-01-27 09:10:26
4903,234,1,149,19,168,4852,2021-01-26 17:39:21
4904,234,1,149,19,168,4852,2021-01-26 17:39:21
4905,868,3,478,62,540,4853,2021-01-26 23:27:11
4906,381,3,1197,155,1352,4854,2021-01-27 09:43:10
4907,76,3,578,75,653,4855,2021-01-27 14:43:58
4908,984,2,598,77,675,4856,2021-01-26 21:08:41
4909,706,2,398,51,449,4857,2021-01-27 01:32:52
4910,50,3,827,107,934,4858,2021-01-27 14:00:02
4911,239,3,997,129,1126,4859,2021-01-27 13:19:08
4912,569,5,2145,278,2423,4860,2021-01-27 16:12:14
4913,583,6,1546,200,1746,4861,2021-01-27 17:54:01
4914,201,2,698,90,788,4862,2021-01-27 03:42:18
4915,405,2,898,116,1014,4863,2021-01-27 20:14:19
4916,184,5,1845,239,2084,4864,2021-01-27 21:19:36
4917,556,2,659,85,744,4865,2021-01-27 05:38:23
4918,14,2,459,59,518,4866,2021-01-27 02:25:16
4919,319,3,927,120,1047,4867,2021-01-26 08:12:11
4920,180,3,758,98,856,4868,2021-01-26 10:27:48
4921,285,3,1027,133,1160,4869,2021-01-26 10:30:34
4922,662,1,99,12,111,4870,2021-01-26 11:01:34
4923,120,3,1127,146,1273,4871,2021-01-26 11:31:10
4924,504,2,928,120,1048,4872,2021-01-26 13:56:51
4925,58,3,997,129,1126,4873,2021-01-26 17:45:21
4926,994,3,758,98,856,4874,2021-01-26 23:25:19
4927,238,2,798,103,901,4875,2021-01-26 15:13:26
4928,895,3,528,68,596,4876,2021-01-26 23:25:07
4929,454,3,608,79,687,4877,2021-01-26 22:21:07
4930,493,2,598,77,675,4878,2021-01-26 22:33:39
4931,837,3,478,62,540,4879,2021-01-26 22:38:40
4932,367,3,697,90,787,4880,2021-01-26 21:44:06
4933,183,3,1047,136,1183,4881,2021-01-26 08:55:06
4934,296,2,598,77,675,4882,2021-01-26 05:26:22
4935,253,2,848,110,958,4883,2021-01-26 14:32:14
4936,583,3,758,98,856,4884,2021-01-26 22:04:31
4937,664,3,688,89,777,4885,2021-01-26 20:56:26
4938,579,2,1098,142,1240,4886,2021-01-26 13:51:07
4939,640,3,558,72,630,4887,2021-01-26 03:26:59
4940,311,2,329,42,371,4888,2021-01-25 19:01:28
4941,235,3,658,85,743,4889,2021-01-25 21:11:02
4942,728,3,997,129,1126,4890,2021-01-26 00:40:48
4943,283,2,598,77,675,4891,2021-01-25 12:59:57
4944,27,3,1027,133,1160,4892,2021-01-26 03:07:31
4945,855,3,688,89,777,4893,2021-01-26 06:12:08
4946,751,2,628,81,709,4894,2021-01-26 02:36:42
4947,983,2,429,55,484,4895,2021-01-26 08:47:52
4948,665,2,698,90,788,4896,2021-01-26 13:15:01
4949,264,3,997,129,1126,4897,2021-01-26 12:28:24
4950,689,3,697,90,787,4898,2021-01-26 02:32:21
4951,804,3,847,110,957,4899,2021-01-26 00:16:56
4952,439,1,299,38,337,4900,2021-01-26 00:37:46
4953,500,3,528,68,596,4901,2021-01-26 05:53:44
4954,278,3,647,84,731,4902,2021-01-26 08:12:10
4955,995,1,699,90,789,4903,2021-01-27 16:02:47
4956,694,3,647,84,731,4904,2021-01-27 10:16:19
4957,1,3,697,90,787,4905,2021-01-26 18:08:10
4958,378,4,1526,198,1724,4906,2021-01-26 18:00:39
4959,726,3,888,115,1003,4907,2021-01-27 00:30:49
4960,770,3,608,79,687,4908,2021-01-27 12:11:33
4961,544,2,459,59,518,4909,2021-01-27 17:15:54
4962,745,2,598,77,675,4910,2021-01-26 22:08:00
4963,445,3,478,62,540,4911,2021-01-27 03:58:35
4964,220,3,997,129,1126,4912,2021-01-27 16:18:40
4965,678,2,659,85,744,4913,2021-01-27 15:48:02
4966,680,2,398,51,449,4914,2021-01-27 17:58:39
4967,521,5,1676,217,1893,4915,2021-01-27 18:18:27
4968,618,3,1127,146,1273,4916,2021-01-27 03:51:20
4969,894,3,727,94,821,4917,2021-01-27 22:51:58
4970,228,4,1307,169,1476,4918,2021-01-27 23:10:55
4971,753,3,478,62,540,4919,2021-01-27 06:48:19
4972,215,1,229,29,258,4920,2021-01-27 03:41:42
4973,304,3,747,97,844,4921,2021-01-26 08:48:03
4974,304,3,747,97,844,4921,2021-01-26 08:48:03
4975,494,3,1327,172,1499,4922,2021-01-26 12:29:15
4976,296,3,888,115,1003,4923,2021-01-26 12:31:02
4977,714,3,827,107,934,4924,2021-01-26 13:17:40
4978,15,2,459,59,518,4925,2021-01-26 13:34:04
4979,824,6,1385,180,1565,4926,2021-01-26 14:16:54
4980,555,3,1047,136,1183,4927,2021-01-26 18:51:26
4981,604,2,459,59,518,4928,2021-01-27 00:58:12
4982,586,4,1596,207,1803,4929,2021-01-26 15:26:55
4983,659,3,1047,136,1183,4930,2021-01-27 00:10:33
4984,106,3,997,129,1126,4931,2021-01-26 23:10:07
4985,363,6,1544,200,1744,4932,2021-01-27 00:41:56
4986,429,3,1047,136,1183,4933,2021-01-26 23:02:27
4987,280,4,1696,220,1916,4934,2021-01-26 23:51:47
4988,280,4,1696,220,1916,4934,2021-01-26 23:51:47
4989,148,3,658,85,743,4935,2021-01-26 11:33:43
4990,921,2,459,59,518,4936,2021-01-26 06:20:01
4991,624,1,399,51,450,4937,2021-01-26 17:16:57
4992,101,4,1546,200,1746,4938,2021-01-27 00:35:57
4993,292,3,697,90,787,4939,2021-01-26 21:40:29
4994,589,3,1197,155,1352,4940,2021-01-26 15:54:01
4995,847,5,1545,200,1745,4941,2021-01-26 03:49:06
4996,274,3,1027,133,1160,4942,2021-01-25 21:14:58
4997,578,3,1247,162,1409,4943,2021-01-25 23:08:54
4998,450,3,608,79,687,4944,2021-01-26 00:53:27
4999,191,4,1426,185,1611,4945,2021-01-25 15:22:18
5000,820,3,927,120,1047,4946,2021-01-26 03:11:51
5001,730,5,1275,165,1440,4947,2021-01-26 06:54:30
5002,603,2,798,103,901,4948,2021-01-26 05:20:04
5003,774,2,848,110,958,4949,2021-01-26 10:42:45
5004,305,2,798,103,901,4950,2021-01-26 15:50:52
5005,916,3,697,90,787,4951,2021-01-26 13:49:40
5006,494,3,697,90,787,4952,2021-01-26 04:06:32
5007,17,5,1326,172,1498,4953,2021-01-26 01:32:14
5008,681,2,928,120,1048,4954,2021-01-26 02:10:51
5009,252,5,1456,189,1645,4955,2021-01-26 06:34:48
5010,118,3,1247,162,1409,4956,2021-01-26 10:34:18
5011,940,2,798,103,901,4957,2021-01-27 16:36:37
5012,699,2,698,90,788,4958,2021-01-27 10:39:50
5013,23,3,558,72,630,4959,2021-01-26 18:52:37
5014,254,2,598,77,675,4960,2021-01-26 19:26:05
5015,982,5,1356,176,1532,4961,2021-01-27 01:36:56
5016,602,5,1595,207,1802,4962,2021-01-27 14:52:17
5017,377,3,808,105,913,4963,2021-01-27 18:43:24
5018,552,2,698,90,788,4964,2021-01-26 23:42:06
5019,998,3,478,62,540,4965,2021-01-27 06:00:54
5020,15,4,1296,168,1464,4966,2021-01-27 19:04:06
5021,785,3,428,55,483,4967,2021-01-27 18:12:12
5022,798,6,1905,247,2152,4968,2021-01-27 20:12:27
5023,270,2,598,77,675,4969,2021-01-27 19:18:22
5024,114,2,828,107,935,4970,2021-01-27 05:59:00
5025,595,2,898,116,1014,4971,2021-01-28 00:51:04
5026,789,3,658,85,743,4972,2021-01-28 00:09:25
5027,581,3,688,89,777,4973,2021-01-27 09:00:52
5028,770,4,577,75,652,4974,2021-01-27 04:46:54
5029,51,3,658,85,743,4975,2021-01-26 11:00:19
5030,657,3,808,105,913,4976,2021-01-26 10:32:22
5031,270,5,1206,156,1362,4977,2021-01-26 14:12:43
5032,840,6,1644,213,1857,4978,2021-01-26 15:07:48
5033,44,2,598,77,675,4979,2021-01-26 14:11:50
5034,454,3,997,129,1126,4980,2021-01-26 15:48:40
5035,515,2,698,90,788,4981,2021-01-26 15:05:49
5036,783,2,329,42,371,4982,2021-01-26 19:34:10
5037,428,3,478,62,540,4983,2021-01-27 03:03:22
5038,173,3,1027,133,1160,4984,2021-01-26 17:28:35
5039,941,3,1327,172,1499,4985,2021-01-27 00:45:44
5040,893,6,1166,151,1317,4986,2021-01-27 00:12:18
5041,747,3,688,89,777,4987,2021-01-27 03:01:55
5042,199,3,747,97,844,4988,2021-01-26 23:40:08
5043,388,3,558,72,630,4989,2021-01-27 01:33:53
5044,266,3,478,62,540,4990,2021-01-26 23:56:58
5045,960,3,1247,162,1409,4991,2021-01-26 13:48:06
5046,967,3,947,123,1070,4992,2021-01-26 08:00:38
5047,947,3,927,120,1047,4993,2021-01-26 19:26:14
5048,413,3,558,72,630,4994,2021-01-27 02:11:23
5049,187,3,428,55,483,4995,2021-01-26 22:55:52
5050,961,3,647,84,731,4996,2021-01-26 17:56:27
5051,780,3,1047,136,1183,4997,2021-01-26 05:04:51
5052,14,2,698,90,788,4998,2021-01-25 23:29:48
5053,842,3,1127,146,1273,4999,2021-01-26 00:36:43
5054,465,2,528,68,596,5000,2021-01-26 03:19:21
5055,588,2,329,42,371,5001,2021-01-25 16:54:47
5056,864,4,1346,174,1520,5002,2021-01-26 03:47:47
5057,99,2,728,94,822,5003,2021-01-26 07:54:47
5058,721,3,1047,136,1183,5004,2021-01-26 07:06:11
5059,195,3,847,110,957,5005,2021-01-26 12:32:30
5060,19,3,1047,136,1183,5006,2021-01-26 16:28:20
5061,166,3,697,90,787,5007,2021-01-26 15:47:56
5062,474,5,1345,174,1519,5008,2021-01-26 04:59:25
5063,613,3,558,72,630,5009,2021-01-26 01:37:54
5064,948,6,1944,252,2196,5010,2021-01-26 04:40:01
5065,266,3,597,77,674,5011,2021-01-26 08:27:24
5066,225,3,1047,136,1183,5012,2021-01-26 11:41:58
5067,369,5,1545,200,1745,5013,2021-01-27 19:20:43
5068,450,2,848,110,958,5014,2021-01-27 13:10:28
5069,780,2,798,103,901,5015,2021-01-26 20:49:27
5070,276,3,647,84,731,5016,2021-01-26 21:29:13
5071,47,2,828,107,935,5017,2021-01-27 02:56:57
5072,461,2,329,42,371,5018,2021-01-27 15:21:31
5073,416,3,1197,155,1352,5019,2021-01-27 18:53:18
5074,790,5,1445,187,1632,5020,2021-01-27 01:59:41
5075,432,2,659,85,744,5021,2021-01-27 07:12:41
5076,522,3,1047,136,1183,5022,2021-01-27 20:03:58
5077,345,4,1257,163,1420,5023,2021-01-27 20:56:25
5078,139,2,798,103,901,5024,2021-01-27 22:50:46
5079,822,3,847,110,957,5025,2021-01-27 20:14:18
5080,191,3,1247,162,1409,5026,2021-01-27 06:56:22
5081,706,5,1276,165,1441,5027,2021-01-28 00:53:04
5082,94,3,1197,155,1352,5028,2021-01-28 01:12:05
5083,589,3,688,89,777,5029,2021-01-27 11:43:23
5084,206,2,659,85,744,5030,2021-01-27 06:21:41
5085,467,3,688,89,777,5031,2021-01-26 12:05:16
5086,83,4,1596,207,1803,5032,2021-01-26 13:04:42
5087,177,2,548,71,619,5033,2021-01-26 16:09:32
5088,62,3,847,110,957,5034,2021-01-26 16:34:27
5089,396,3,1127,146,1273,5035,2021-01-26 14:57:41
5090,308,5,1076,139,1215,5036,2021-01-26 18:19:01
5091,586,3,608,79,687,5037,2021-01-26 16:48:37
5092,496,3,697,90,787,5038,2021-01-26 20:47:13
5093,371,3,797,103,900,5039,2021-01-27 04:23:37
5094,194,2,698,90,788,5040,2021-01-26 17:52:43
5095,926,3,947,123,1070,5041,2021-01-27 03:00:51
5096,289,5,1067,138,1205,5042,2021-01-27 02:47:10
5097,253,3,597,77,674,5043,2021-01-27 04:58:16
5098,584,3,1127,146,1273,5044,2021-01-27 00:07:42
5099,957,4,1027,133,1160,5045,2021-01-27 02:23:13
5100,35,4,1057,137,1194,5046,2021-01-27 02:29:17
5101,478,3,797,103,900,5047,2021-01-26 15:10:13
5102,747,3,647,84,731,5048,2021-01-26 10:45:15
5103,779,3,797,103,900,5049,2021-01-26 21:57:11
5104,367,2,1098,142,1240,5050,2021-01-27 03:24:36
5105,616,2,898,116,1014,5051,2021-01-27 00:37:53
5106,311,2,698,90,788,5052,2021-01-26 18:50:39
5107,508,3,1027,133,1160,5053,2021-01-26 07:31:08
5108,358,3,1047,136,1183,5054,2021-01-26 00:07:51
5109,951,3,578,75,653,5055,2021-01-26 02:31:12
5110,316,2,498,64,562,5056,2021-01-26 03:39:19
5111,282,5,1545,200,1745,5057,2021-01-25 18:38:05
5112,524,3,1127,146,1273,5058,2021-01-26 04:18:38
5113,253,2,448,58,506,5059,2021-01-26 08:03:44
5114,409,2,329,42,371,5060,2021-01-26 07:57:31
5115,647,2,659,85,744,5061,2021-01-26 14:50:50
5116,64,3,697,90,787,5062,2021-01-26 17:42:41
5117,383,3,797,103,900,5063,2021-01-26 18:30:56
5118,50,3,1127,146,1273,5064,2021-01-26 07:31:01
5119,324,2,698,90,788,5065,2021-01-26 03:23:53
5120,579,3,597,77,674,5066,2021-01-26 06:53:22
5121,942,3,428,55,483,5067,2021-01-26 10:59:20
5122,926,5,1345,174,1519,5068,2021-01-26 13:41:26
5123,944,3,558,72,630,5069,2021-01-27 20:35:44
5124,675,2,429,55,484,5070,2021-01-27 13:30:43
5125,950,3,747,97,844,5071,2021-01-26 23:13:25
5126,984,2,329,42,371,5072,2021-01-26 21:51:33
5127,750,2,329,42,371,5073,2021-01-27 04:47:49
5128,856,3,808,105,913,5074,2021-01-27 18:06:06
5129,941,3,827,107,934,5075,2021-01-27 19:17:23
5130,381,2,798,103,901,5076,2021-01-27 03:09:25
5131,788,2,628,81,709,5077,2021-01-27 08:31:06
5132,71,3,827,107,934,5078,2021-01-27 20:49:15
5133,538,2,498,64,562,5079,2021-01-27 23:25:23
5134,434,4,1426,185,1611,5080,2021-01-27 23:41:36
5135,948,3,1047,136,1183,5081,2021-01-27 20:26:08
5136,894,3,658,85,743,5082,2021-01-27 08:29:47
5137,890,6,1544,200,1744,5083,2021-01-28 03:16:07
5138,733,2,659,85,744,5084,2021-01-28 02:00:33
5139,408,2,798,103,901,5085,2021-01-27 12:53:32
5140,839,2,898,116,1014,5086,2021-01-27 08:10:20
5141,601,2,1098,142,1240,5087,2021-01-26 12:52:53
5142,425,3,827,107,934,5088,2021-01-26 15:41:59
5143,803,3,1027,133,1160,5089,2021-01-26 18:26:33
5144,51,3,797,103,900,5090,2021-01-26 17:31:07
5145,398,5,2025,263,2288,5091,2021-01-26 15:20:21
5146,541,3,1047,136,1183,5092,2021-01-26 18:24:20
5147,374,2,498,64,562,5093,2021-01-26 19:19:23
5148,894,5,1795,233,2028,5094,2021-01-26 20:58:38
5149,368,4,1037,134,1171,5095,2021-01-27 05:25:27
5150,636,3,697,90,787,5096,2021-01-26 20:23:23
5151,799,2,798,103,901,5097,2021-01-27 04:01:05
5152,807,3,888,115,1003,5098,2021-01-27 02:51:19
5153,19,2,798,103,901,5099,2021-01-27 07:19:28
5154,135,2,748,97,845,5100,2021-01-27 02:37:20
5155,476,2,659,85,744,5101,2021-01-27 04:02:17
5156,981,3,747,97,844,5102,2021-01-27 05:00:03
5157,357,3,1047,136,1183,5103,2021-01-26 15:11:07
5158,65,3,478,62,540,5104,2021-01-26 13:31:36
5159,849,2,498,64,562,5105,2021-01-26 22:20:52
5160,241,1,99,12,111,5106,2021-01-27 03:57:49
5161,810,3,1127,146,1273,5107,2021-01-27 02:14:52
5162,379,3,888,115,1003,5108,2021-01-26 19:22:35
5163,197,4,1126,146,1272,5109,2021-01-26 07:49:31
5164,894,3,1047,136,1183,5110,2021-01-26 00:56:06
5165,814,3,1247,162,1409,5111,2021-01-26 03:33:25
5166,303,2,429,55,484,5112,2021-01-26 06:20:35
5167,569,3,808,105,913,5113,2021-01-25 19:47:17
5168,978,3,478,62,540,5114,2021-01-26 04:44:10
5169,49,3,1327,172,1499,5115,2021-01-26 10:06:41
5170,397,3,597,77,674,5116,2021-01-26 09:58:29
5171,808,2,528,68,596,5117,2021-01-26 16:08:12
5172,148,6,1416,184,1600,5118,2021-01-26 18:06:32
5173,345,2,329,42,371,5119,2021-01-26 19:18:09
5174,565,4,1226,159,1385,5120,2021-01-26 07:42:15
5175,536,3,688,89,777,5121,2021-01-26 05:04:42
5176,833,5,1855,241,2096,5122,2021-01-26 08:29:44
5177,193,5,1795,233,2028,5123,2021-01-26 12:27:03
5178,473,2,429,55,484,5124,2021-01-26 16:27:13
5179,124,2,459,59,518,5125,2021-01-27 21:18:13
5180,124,2,459,59,518,5125,2021-01-27 21:18:13
5181,85,3,688,89,777,5126,2021-01-27 15:26:38
5182,517,2,459,59,518,5127,2021-01-26 23:37:54
5183,517,2,459,59,518,5127,2021-01-26 23:37:54
5184,860,2,898,116,1014,5128,2021-01-26 22:19:22
5185,646,3,597,77,674,5129,2021-01-27 06:03:57
5186,467,3,1127,146,1273,5130,2021-01-27 18:33:31
5187,396,3,647,84,731,5131,2021-01-27 20:34:54
5188,331,2,659,85,744,5132,2021-01-27 04:53:34
5189,884,3,658,85,743,5133,2021-01-27 08:54:29
5190,66,2,898,116,1014,5134,2021-01-27 23:23:46
5191,182,2,429,55,484,5135,2021-01-28 01:33:23
5192,71,3,747,97,844,5136,2021-01-28 01:37:07
5193,323,3,597,77,674,5137,2021-01-27 22:47:30
5194,781,5,1076,139,1215,5138,2021-01-27 11:01:19
5195,561,2,329,42,371,5139,2021-01-28 05:33:42
5196,489,3,478,62,540,5140,2021-01-28 03:12:23
5197,296,5,1745,226,1971,5141,2021-01-27 13:47:48
5198,329,2,459,59,518,5142,2021-01-27 10:37:32
5199,233,3,888,115,1003,5143,2021-01-26 13:11:58
5200,51,2,498,64,562,5144,2021-01-26 17:34:17
5201,532,3,658,85,743,5145,2021-01-26 20:41:01
5202,232,2,429,55,484,5146,2021-01-26 19:47:02
5203,107,3,1127,146,1273,5147,2021-01-26 15:22:09
5204,793,2,898,116,1014,5148,2021-01-26 19:11:58
5205,645,6,2074,269,2343,5149,2021-01-26 19:59:43
5206,701,2,528,68,596,5150,2021-01-26 23:28:34
5207,880,2,628,81,709,5151,2021-01-27 05:37:57
5208,23,2,698,90,788,5152,2021-01-26 21:16:04
5209,135,3,747,97,844,5153,2021-01-27 05:56:29
5210,799,3,797,103,900,5154,2021-01-27 04:07:52
5211,368,4,1396,181,1577,5155,2021-01-27 09:49:34
5212,735,4,1057,137,1194,5156,2021-01-27 03:00:03
5213,153,3,528,68,596,5157,2021-01-27 05:56:29
5214,458,2,498,64,562,5158,2021-01-27 05:06:01
5215,799,3,578,75,653,5159,2021-01-26 16:30:27
5216,476,2,898,116,1014,5160,2021-01-26 15:15:18
5217,513,3,697,90,787,5161,2021-01-26 23:10:56
5218,173,2,429,55,484,5162,2021-01-27 05:33:54
5219,150,5,1595,207,1802,5163,2021-01-27 04:38:48
5220,806,1,399,51,450,5164,2021-01-26 20:15:44
5221,768,3,558,72,630,5165,2021-01-26 09:36:58
5222,833,3,827,107,934,5166,2021-01-26 01:16:05
5223,736,3,797,103,900,5167,2021-01-26 04:04:15
5224,466,3,1047,136,1183,5168,2021-01-26 07:32:16
5225,358,3,658,85,743,5169,2021-01-25 22:10:54
5226,197,3,897,116,1013,5170,2021-01-26 06:05:10
5227,219,3,1197,155,1352,5171,2021-01-26 10:57:32
5228,509,3,1127,146,1273,5172,2021-01-26 12:23:43
5229,276,3,658,85,743,5173,2021-01-26 16:39:30
5230,268,3,747,97,844,5174,2021-01-26 19:13:22
5231,470,6,1855,241,2096,5175,2021-01-26 21:56:50
5232,741,4,1246,161,1407,5176,2021-01-26 09:33:24
5233,745,3,727,94,821,5177,2021-01-26 05:54:43
5234,704,1,149,19,168,5178,2021-01-26 09:20:01
5235,919,3,428,55,483,5179,2021-01-26 15:10:10
5236,324,3,1047,136,1183,5180,2021-01-26 18:42:17
5237,785,3,927,120,1047,5181,2021-01-27 22:21:32
5238,726,3,1027,133,1160,5182,2021-01-27 23:50:47
5239,802,3,1327,172,1499,5183,2021-01-27 16:20:11
5240,300,6,1835,238,2073,5184,2021-01-27 00:06:58
5241,43,3,747,97,844,5185,2021-01-27 00:46:42
5242,802,5,1606,208,1814,5186,2021-01-27 00:03:54
5243,357,5,1326,172,1498,5187,2021-01-27 06:23:54
5244,137,3,688,89,777,5188,2021-01-27 18:35:29
5245,206,3,808,105,913,5189,2021-01-27 20:45:17
5246,361,3,1047,136,1183,5190,2021-01-27 07:34:54
5247,125,1,499,64,563,5191,2021-01-27 09:21:37
5248,655,3,597,77,674,5192,2021-01-28 00:00:34
5249,116,3,997,129,1126,5193,2021-01-28 03:22:21
5250,915,3,647,84,731,5194,2021-01-28 03:33:37
5251,601,3,888,115,1003,5195,2021-01-28 01:11:54
5252,753,3,1247,162,1409,5196,2021-01-27 13:00:36
5253,624,3,608,79,687,5197,2021-01-28 05:34:41
5254,695,3,528,68,596,5198,2021-01-28 04:09:36
5255,881,1,499,64,563,5199,2021-01-27 15:50:27
5256,849,3,847,110,957,5200,2021-01-27 13:20:08
5257,863,3,947,123,1070,5201,2021-01-26 14:34:05
5258,907,3,1127,146,1273,5202,2021-01-26 19:39:39
5259,147,2,528,68,596,5203,2021-01-26 22:10:24
5260,236,1,149,19,168,5204,2021-01-26 20:46:25
5261,57,3,1197,155,1352,5205,2021-01-26 17:23:38
5262,6,1,99,12,111,5206,2021-01-26 20:12:24
5263,33,1,699,90,789,5207,2021-01-26 20:36:47
5264,467,3,1047,136,1183,5208,2021-01-27 00:09:43
5265,736,3,947,123,1070,5209,2021-01-27 07:00:52
5266,812,3,597,77,674,5210,2021-01-26 22:02:01
5267,154,3,808,105,913,5211,2021-01-27 08:23:45
5268,147,3,558,72,630,5212,2021-01-27 05:30:49
5269,861,2,598,77,675,5213,2021-01-27 10:12:26
5270,631,1,399,51,450,5214,2021-01-27 03:47:36
5271,278,6,1505,195,1700,5215,2021-01-27 07:46:35
5272,4,3,647,84,731,5216,2021-01-27 07:49:15
5273,667,2,698,90,788,5217,2021-01-26 18:55:08
5274,416,3,797,103,900,5218,2021-01-26 15:48:51
5275,842,3,1027,133,1160,5219,2021-01-27 01:14:16
5276,872,1,299,38,337,5220,2021-01-27 08:08:48
5277,582,3,528,68,596,5221,2021-01-27 07:13:23
5278,721,3,1197,155,1352,5222,2021-01-26 20:47:56
5279,441,3,1197,155,1352,5223,2021-01-26 11:22:10
5280,581,2,429,55,484,5224,2021-01-26 03:05:26
5281,493,3,697,90,787,5225,2021-01-26 04:14:03
5282,895,3,747,97,844,5226,2021-01-26 08:46:24
5283,323,3,888,115,1003,5227,2021-01-25 22:58:07
5284,632,3,558,72,630,5228,2021-01-26 07:34:01
5285,669,3,947,123,1070,5229,2021-01-26 12:40:38
5286,36,3,647,84,731,5230,2021-01-26 12:35:26
5287,691,2,659,85,744,5231,2021-01-26 18:20:08
5288,573,4,927,120,1047,5232,2021-01-26 20:39:20
5289,573,4,927,120,1047,5232,2021-01-26 20:39:20
5290,888,3,828,107,935,5233,2021-01-26 23:42:48
5291,934,3,897,116,1013,5234,2021-01-26 09:38:39
5292,453,4,627,81,708,5235,2021-01-26 06:28:29
5293,724,2,898,116,1014,5236,2021-01-26 09:32:22
5294,991,6,1255,163,1418,5237,2021-01-26 16:10:38
5295,871,3,808,105,913,5238,2021-01-26 20:53:32
5296,440,3,1327,172,1499,5239,2021-01-27 23:18:15
5297,580,3,528,68,596,5240,2021-01-28 00:13:44
5298,324,3,1197,155,1352,5241,2021-01-27 16:21:28
5299,463,3,727,94,821,5242,2021-01-27 02:48:48
5300,337,3,1327,172,1499,5243,2021-01-27 01:09:19
5301,714,6,1244,161,1405,5244,2021-01-27 01:55:59
5302,845,3,697,90,787,5245,2021-01-27 06:56:34
5303,880,3,827,107,934,5246,2021-01-27 19:44:31
5304,79,3,528,68,596,5247,2021-01-27 21:49:39
5305,522,2,329,42,371,5248,2021-01-27 08:06:45
5306,50,3,797,103,900,5249,2021-01-27 09:49:48
5307,1,3,1327,172,1499,5250,2021-01-28 00:07:16
5308,320,3,797,103,900,5251,2021-01-28 04:19:05
5309,540,3,888,115,1003,5252,2021-01-28 05:42:29
5310,588,3,1047,136,1183,5253,2021-01-28 03:33:04
5311,955,4,1296,168,1464,5254,2021-01-27 14:14:00
5312,289,3,597,77,674,5255,2021-01-28 07:40:30
5313,328,3,1327,172,1499,5256,2021-01-28 04:22:15
5314,816,4,1187,154,1341,5257,2021-01-27 18:12:09
5315,527,3,1027,133,1160,5258,2021-01-27 14:21:27
5316,449,3,1047,136,1183,5259,2021-01-26 17:07:29
5317,112,3,747,97,844,5260,2021-01-26 21:04:41
5318,123,3,597,77,674,5261,2021-01-26 23:11:40
5319,620,3,897,116,1013,5262,2021-01-26 21:04:16
5320,832,3,727,94,821,5263,2021-01-26 18:57:38
5321,327,3,997,129,1126,5264,2021-01-26 21:42:07
5322,802,2,928,120,1048,5265,2021-01-26 23:07:32
5323,897,3,827,107,934,5266,2021-01-27 01:22:29
5324,581,3,1047,136,1183,5267,2021-01-27 07:38:36
5325,874,3,528,68,596,5268,2021-01-26 23:56:06
5326,140,3,1197,155,1352,5269,2021-01-27 10:00:18
5327,961,3,897,116,1013,5270,2021-01-27 07:02:30
5328,249,3,428,55,483,5271,2021-01-27 10:33:49
5329,106,3,947,123,1070,5272,2021-01-27 06:17:04
5330,121,4,846,109,955,5273,2021-01-27 07:58:38
5331,426,3,1327,172,1499,5274,2021-01-27 08:46:41
5332,49,3,558,72,630,5275,2021-01-26 20:06:02
5333,84,3,997,129,1126,5276,2021-01-26 17:28:01
5334,677,3,758,98,856,5277,2021-01-27 02:38:48
5335,672,3,688,89,777,5278,2021-01-27 10:04:22
5336,26,1,299,38,337,5279,2021-01-27 08:02:25
5337,110,3,888,115,1003,5280,2021-01-26 21:18:57
5338,70,2,698,90,788,5281,2021-01-26 12:25:15
5339,548,3,758,98,856,5282,2021-01-26 05:42:23
5340,316,1,229,29,258,5283,2021-01-26 06:55:03
5341,780,6,1574,204,1778,5284,2021-01-26 10:37:10
5342,460,3,428,55,483,5285,2021-01-25 23:48:31
5343,515,1,149,19,168,5286,2021-01-26 09:01:50
5344,11,2,898,116,1014,5287,2021-01-26 14:14:34
5345,234,2,498,64,562,5288,2021-01-26 15:21:47
5346,298,3,658,85,743,5289,2021-01-26 18:43:59
5347,680,3,1047,136,1183,5290,2021-01-26 21:41:57
5348,135,1,699,90,789,5291,2021-01-26 21:43:24
5349,336,3,827,107,934,5292,2021-01-27 01:20:22
5350,976,3,758,98,856,5293,2021-01-26 10:05:02
5351,688,3,797,103,900,5294,2021-01-26 06:35:24
5352,110,3,1197,155,1352,5295,2021-01-26 11:11:48
5353,907,5,1686,219,1905,5296,2021-01-26 18:28:14
5354,704,2,598,77,675,5297,2021-01-26 22:02:06
5355,811,2,598,77,675,5298,2021-01-28 01:08:58
5356,631,3,997,129,1126,5299,2021-01-28 01:42:03
5357,358,2,598,77,675,5300,2021-01-27 16:38:07
5358,253,3,1047,136,1183,5301,2021-01-27 03:51:10
5359,397,3,1127,146,1273,5302,2021-01-27 01:24:30
5360,196,2,498,64,562,5303,2021-01-27 01:57:09
5361,108,3,478,62,540,5304,2021-01-27 07:18:00
5362,434,2,898,116,1014,5305,2021-01-27 21:47:21
5363,663,2,498,64,562,5306,2021-01-27 22:50:06
5364,144,3,578,75,653,5307,2021-01-27 08:29:21
5365,782,2,659,85,744,5308,2021-01-27 10:21:11
5366,975,5,1245,161,1406,5309,2021-01-28 01:15:28
5367,910,3,558,72,630,5310,2021-01-28 04:27:00
5368,318,3,927,120,1047,5311,2021-01-28 06:59:08
5369,136,3,697,90,787,5312,2021-01-28 06:01:23
5370,862,3,428,55,483,5313,2021-01-27 14:57:22
5371,646,3,428,55,483,5314,2021-01-28 10:01:18
5372,579,3,1127,146,1273,5315,2021-01-28 06:06:04
5373,455,3,528,68,596,5316,2021-01-27 19:13:44
5374,708,3,1127,146,1273,5317,2021-01-27 14:44:04
5375,855,3,1327,172,1499,5318,2021-01-26 17:24:37
5376,157,3,558,72,630,5319,2021-01-26 23:47:01
5377,693,3,697,90,787,5320,2021-01-26 23:25:52
5378,655,2,398,51,449,5321,2021-01-26 23:00:15
5379,672,3,747,97,844,5322,2021-01-26 21:43:02
5380,744,3,597,77,674,5323,2021-01-26 23:19:54
5381,494,2,798,103,901,5324,2021-01-26 23:18:43
5382,601,2,898,116,1014,5325,2021-01-27 04:03:23
5383,172,2,459,59,518,5326,2021-01-27 09:13:48
5384,265,3,808,105,913,5327,2021-01-27 02:40:16
5385,351,4,1396,181,1577,5328,2021-01-27 11:31:00
5386,688,3,997,129,1126,5329,2021-01-27 09:38:42
5387,904,2,429,55,484,5330,2021-01-27 13:07:49
5388,63,5,1656,215,1871,5331,2021-01-27 07:22:17
5389,633,2,548,71,619,5332,2021-01-27 09:02:10
5390,993,3,927,120,1047,5333,2021-01-27 10:26:02
5391,675,3,608,79,687,5334,2021-01-26 21:41:46
5392,381,3,997,129,1126,5335,2021-01-26 18:57:52
5393,762,3,528,68,596,5336,2021-01-27 03:51:02
5394,440,2,659,85,744,5337,2021-01-27 11:49:08
5395,198,3,478,62,540,5338,2021-01-27 10:12:37
5396,672,2,598,77,675,5339,2021-01-26 23:58:41
5397,672,6,1735,225,1960,5340,2021-01-26 13:13:00
5398,751,2,898,116,1014,5341,2021-01-26 05:48:31
5399,76,3,697,90,787,5342,2021-01-26 09:31:27
5400,472,3,747,97,844,5343,2021-01-26 12:56:52
5401,417,3,997,129,1126,5344,2021-01-26 01:43:31
5402,288,5,1406,182,1588,5345,2021-01-26 09:09:47
5403,973,2,898,116,1014,5346,2021-01-26 15:16:54
5404,660,1,99,12,111,5347,2021-01-26 16:54:33
5405,129,2,459,59,518,5348,2021-01-26 19:45:39
5406,20,5,937,121,1058,5349,2021-01-27 00:25:34
5407,645,2,898,116,1014,5350,2021-01-26 22:01:07
5408,491,3,528,68,596,5351,2021-01-27 04:06:57
5409,879,3,1247,162,1409,5352,2021-01-26 11:21:35
5410,151,2,898,116,1014,5353,2021-01-26 08:21:17
5411,144,3,558,72,630,5354,2021-01-26 11:55:01
5412,260,2,659,85,744,5355,2021-01-26 21:06:38
5413,753,3,1127,146,1273,5356,2021-01-26 22:02:10
5414,745,3,827,107,934,5357,2021-01-28 01:54:15
5415,967,5,1206,156,1362,5358,2021-01-28 03:00:04
5416,762,1,699,90,789,5359,2021-01-27 19:22:38
5417,52,1,299,38,337,5360,2021-01-27 05:29:31
5418,362,3,827,107,934,5361,2021-01-27 02:22:39
5419,731,2,528,68,596,5362,2021-01-27 04:24:55
5420,731,2,528,68,596,5362,2021-01-27 04:24:55
5421,993,2,528,68,596,5363,2021-01-27 08:09:51
5422,993,2,528,68,596,5363,2021-01-27 08:09:51
5423,859,3,1327,172,1499,5364,2021-01-27 22:56:02
5424,622,2,628,81,709,5365,2021-01-28 01:22:58
5425,198,2,498,64,562,5366,2021-01-27 08:29:36
5426,134,2,459,59,518,5367,2021-01-27 12:40:37
5427,281,3,758,98,856,5368,2021-01-28 03:49:19
5428,551,3,947,123,1070,5369,2021-01-28 04:47:12
5429,984,3,528,68,596,5370,2021-01-28 08:32:18
5430,812,2,798,103,901,5371,2021-01-28 06:40:21
5431,745,3,558,72,630,5372,2021-01-27 15:24:08
5432,852,1,399,51,450,5373,2021-01-28 12:34:05
5433,803,4,976,126,1102,5374,2021-01-28 07:29:25
5434,692,2,329,42,371,5375,2021-01-27 21:56:20
5435,687,3,1327,172,1499,5376,2021-01-27 17:14:05
5436,573,3,897,116,1013,5377,2021-01-26 17:40:10
5437,118,3,1147,149,1296,5378,2021-01-27 02:16:40
5438,622,3,847,110,957,5379,2021-01-27 02:01:09
5439,887,3,1027,133,1160,5380,2021-01-26 23:34:00
5440,98,5,1375,178,1553,5381,2021-01-26 22:56:15
5441,281,3,597,77,674,5382,2021-01-27 01:24:49
5442,569,1,149,19,168,5383,2021-01-27 01:56:15
5443,55,6,1605,208,1813,5384,2021-01-27 04:27:12
5444,165,5,1706,221,1927,5385,2021-01-27 11:10:53
5445,146,3,528,68,596,5386,2021-01-27 05:23:13
5446,803,4,1207,156,1363,5387,2021-01-27 12:28:52
5447,877,2,598,77,675,5388,2021-01-27 11:37:19
5448,686,2,698,90,788,5389,2021-01-27 13:27:29
5449,702,2,898,116,1014,5390,2021-01-27 07:53:19
5450,818,2,898,116,1014,5391,2021-01-27 09:51:14
5451,896,3,808,105,913,5392,2021-01-27 11:22:35
5452,272,2,498,64,562,5393,2021-01-26 23:00:13
5453,767,3,747,97,844,5394,2021-01-26 21:34:49
5454,767,3,747,97,844,5394,2021-01-26 21:34:49
5455,924,3,558,72,630,5395,2021-01-27 05:20:03
5456,799,2,659,85,744,5396,2021-01-27 12:10:45
5457,506,5,1076,139,1215,5397,2021-01-27 12:30:50
5458,500,3,747,97,844,5398,2021-01-27 00:12:22
5459,283,3,1047,136,1183,5399,2021-01-26 15:10:27
5460,288,3,697,90,787,5400,2021-01-26 06:15:03
5461,589,2,898,116,1014,5401,2021-01-26 10:57:46
5462,565,5,1245,161,1406,5402,2021-01-26 13:58:54
5463,824,3,597,77,674,5403,2021-01-26 04:09:26
5464,368,2,598,77,675,5404,2021-01-26 10:49:23
5465,794,1,99,12,111,5405,2021-01-26 17:56:59
5466,891,2,1098,142,1240,5406,2021-01-26 19:28:22
5467,73,2,898,116,1014,5407,2021-01-26 20:34:03
5468,899,3,578,75,653,5408,2021-01-27 02:34:55
5469,609,3,1047,136,1183,5409,2021-01-26 23:32:14
5470,270,5,1406,182,1588,5410,2021-01-27 06:44:45
5471,671,1,599,77,676,5411,2021-01-26 13:46:03
5472,385,3,1247,162,1409,5412,2021-01-26 10:54:57
5473,374,3,1197,155,1352,5413,2021-01-26 14:18:32
5474,169,3,428,55,483,5414,2021-01-26 21:20:43
5475,740,3,947,123,1070,5415,2021-01-26 23:25:37
5476,562,2,459,59,518,5416,2021-01-28 02:38:58
5477,322,3,927,120,1047,5417,2021-01-28 03:54:58
5478,559,6,1705,221,1926,5418,2021-01-27 20:06:39
5479,996,2,329,42,371,5419,2021-01-27 07:57:14
5480,802,3,827,107,934,5420,2021-01-27 03:47:52
5481,257,3,688,89,777,5421,2021-01-27 05:22:43
5482,267,3,747,97,844,5422,2021-01-27 06:15:13
5483,93,2,628,81,709,5423,2021-01-27 09:55:35
5484,935,3,1047,136,1183,5424,2021-01-27 09:35:28
5485,915,3,797,103,900,5425,2021-01-27 23:21:02
5486,387,3,608,79,687,5426,2021-01-28 01:29:14
5487,676,3,688,89,777,5427,2021-01-27 10:53:15
5488,39,3,947,123,1070,5428,2021-01-27 14:43:03
5489,471,3,827,107,934,5429,2021-01-28 05:28:12
5490,796,6,1805,234,2039,5430,2021-01-28 05:57:31
5491,841,2,828,107,935,5431,2021-01-28 08:43:14
5492,521,2,698,90,788,5432,2021-01-28 07:09:19
5493,618,2,329,42,371,5433,2021-01-27 17:12:21
5494,656,2,898,116,1014,5434,2021-01-28 13:53:53
5495,173,4,1726,224,1950,5435,2021-01-28 10:02:17
5496,952,4,887,115,1002,5436,2021-01-27 23:28:21
5497,114,2,429,55,484,5437,2021-01-27 17:51:24
5498,543,3,1127,146,1273,5438,2021-01-26 19:06:31
5499,526,3,897,116,1013,5439,2021-01-27 04:47:21
5500,892,3,608,79,687,5440,2021-01-27 02:32:57
5501,288,6,1125,146,1271,5441,2021-01-27 01:26:35
5502,852,3,758,98,856,5442,2021-01-26 23:33:42
5503,657,2,429,55,484,5443,2021-01-27 04:05:59
5504,109,3,688,89,777,5444,2021-01-27 03:28:17
5505,124,2,659,85,744,5445,2021-01-27 06:55:15
5506,5,3,697,90,787,5446,2021-01-27 13:19:17
5507,937,2,648,84,732,5447,2021-01-27 07:03:09
5508,288,6,1724,224,1948,5448,2021-01-27 13:53:37
5509,285,3,997,129,1126,5449,2021-01-27 12:55:56
5510,4,2,898,116,1014,5450,2021-01-27 14:16:27
5511,384,2,659,85,744,5451,2021-01-27 08:18:23
5512,284,2,329,42,371,5452,2021-01-27 11:33:37
5513,819,4,1296,168,1464,5453,2021-01-27 11:28:26
5514,98,6,1644,213,1857,5454,2021-01-27 00:46:22
5515,100,3,727,94,821,5455,2021-01-26 22:45:05
5516,600,2,429,55,484,5456,2021-01-26 22:19:52
5517,311,2,598,77,675,5457,2021-01-27 07:44:52
5518,155,3,688,89,777,5458,2021-01-27 14:16:11
5519,483,2,598,77,675,5459,2021-01-27 13:47:19
5520,670,3,1127,146,1273,5460,2021-01-27 02:30:04
5521,887,2,329,42,371,5461,2021-01-26 16:25:07
5522,420,3,528,68,596,5462,2021-01-26 06:41:32
5523,559,3,997,129,1126,5463,2021-01-26 12:46:15
5524,969,3,797,103,900,5464,2021-01-26 16:26:08
5525,547,5,1845,239,2084,5465,2021-01-26 05:23:03
5526,725,2,598,77,675,5466,2021-01-26 11:23:50
5527,520,2,798,103,901,5467,2021-01-26 19:07:05
5528,604,3,597,77,674,5468,2021-01-26 20:34:12
5529,662,3,1027,133,1160,5469,2021-01-26 22:29:12
5530,654,2,548,71,619,5470,2021-01-27 03:22:17
5531,508,3,578,75,653,5471,2021-01-27 01:50:26
5532,916,2,628,81,709,5472,2021-01-27 07:54:48
5533,463,2,659,85,744,5473,2021-01-26 15:45:23
5534,179,2,628,81,709,5474,2021-01-26 11:22:28
5535,375,6,1305,169,1474,5475,2021-01-26 16:46:18
5536,229,2,698,90,788,5476,2021-01-26 22:44:57
5537,106,3,688,89,777,5477,2021-01-26 23:29:55
5538,590,3,478,62,540,5478,2021-01-28 02:57:24
5539,56,3,478,62,540,5479,2021-01-28 04:02:11
5540,66,2,329,42,371,5480,2021-01-27 21:12:53
5541,688,2,429,55,484,5481,2021-01-27 10:04:28
5542,870,2,498,64,562,5482,2021-01-27 06:01:49
5543,87,3,747,97,844,5483,2021-01-27 05:45:19
5544,536,3,1027,133,1160,5484,2021-01-27 08:12:02
5545,19,6,1855,241,2096,5485,2021-01-27 11:17:09
5546,374,5,1156,150,1306,5486,2021-01-27 11:53:02
5547,561,2,598,77,675,5487,2021-01-27 23:32:02
5548,234,2,548,71,619,5488,2021-01-28 02:49:13
5549,255,3,857,111,968,5489,2021-01-27 11:17:28
5550,590,3,1327,172,1499,5490,2021-01-27 17:07:01
5551,576,4,1246,161,1407,5491,2021-01-28 05:50:52
5552,15,2,828,107,935,5492,2021-01-28 08:05:34
5553,403,3,758,98,856,5493,2021-01-28 10:10:13
5554,417,3,997,129,1126,5494,2021-01-28 07:58:34
5555,208,3,888,115,1003,5495,2021-01-27 18:23:04
5556,949,3,997,129,1126,5496,2021-01-28 15:06:19
5557,232,3,747,97,844,5497,2021-01-28 12:41:02
5558,642,2,898,116,1014,5498,2021-01-28 00:54:57
5559,921,3,1127,146,1273,5499,2021-01-27 20:22:51
5560,408,1,229,29,258,5500,2021-01-26 19:52:56
5561,736,2,329,42,371,5501,2021-01-27 06:29:22
5562,966,2,459,59,518,5502,2021-01-27 03:22:38
5563,53,5,1695,220,1915,5503,2021-01-27 03:45:30
5564,710,3,1127,146,1273,5504,2021-01-27 02:03:36
5565,243,2,798,103,901,5505,2021-01-27 06:49:54
5566,713,3,647,84,731,5506,2021-01-27 03:51:31
5567,842,3,1127,146,1273,5507,2021-01-27 07:19:55
5568,475,1,229,29,258,5508,2021-01-27 15:27:50
5569,134,3,758,98,856,5509,2021-01-27 07:35:41
5570,232,3,827,107,934,5510,2021-01-27 14:07:09
5571,892,3,1047,136,1183,5511,2021-01-27 13:40:40
5572,458,2,329,42,371,5512,2021-01-27 16:18:02
5573,705,3,897,116,1013,5513,2021-01-27 08:25:31
5574,941,2,598,77,675,5514,2021-01-27 12:02:29
5575,167,3,1327,172,1499,5515,2021-01-27 13:28:52
5576,196,5,1325,172,1497,5516,2021-01-27 01:20:42
5577,16,2,659,85,744,5517,2021-01-26 23:21:15
5578,420,2,498,64,562,5518,2021-01-26 22:43:35
5579,217,2,598,77,675,5519,2021-01-27 09:42:05
5580,805,3,1127,146,1273,5520,2021-01-27 15:30:55
5581,652,2,398,51,449,5521,2021-01-27 13:59:26
5582,361,3,947,123,1070,5522,2021-01-27 04:23:20
5583,462,2,928,120,1048,5523,2021-01-26 16:48:16
5584,639,2,698,90,788,5524,2021-01-26 08:55:36
5585,789,3,558,72,630,5525,2021-01-26 13:11:30
5586,777,3,927,120,1047,5526,2021-01-26 16:51:16
5587,935,3,658,85,743,5527,2021-01-26 06:10:10
5588,235,3,608,79,687,5528,2021-01-26 12:29:42
5589,542,3,847,110,957,5529,2021-01-26 20:56:20
5590,71,3,1047,136,1183,5530,2021-01-26 20:47:57
5591,818,3,1127,146,1273,5531,2021-01-26 22:36:21
5592,571,3,608,79,687,5532,2021-01-27 03:22:28
5593,957,3,758,98,856,5533,2021-01-27 02:10:00
5594,330,5,1845,239,2084,5534,2021-01-27 08:22:34
5595,234,2,1098,142,1240,5535,2021-01-26 18:11:50
5596,38,4,1246,161,1407,5536,2021-01-26 11:58:14
5597,956,2,498,64,562,5537,2021-01-26 17:47:02
5598,100,3,997,129,1126,5538,2021-01-27 00:43:13
5599,71,3,1047,136,1183,5539,2021-01-27 00:10:33
5600,809,6,1654,215,1869,5540,2021-01-28 05:22:55
5601,809,6,1654,215,1869,5540,2021-01-28 05:22:55
5602,555,2,498,64,562,5541,2021-01-28 04:47:21
5603,15,6,2374,308,2682,5542,2021-01-27 21:49:53
5604,40,3,797,103,900,5543,2021-01-27 12:11:18
5605,999,2,598,77,675,5544,2021-01-27 07:21:05
5606,937,3,847,110,957,5545,2021-01-27 06:46:08
5607,99,3,947,123,1070,5546,2021-01-27 10:56:14
5608,157,1,399,51,450,5547,2021-01-27 12:26:26
5609,380,3,697,90,787,5548,2021-01-27 14:24:06
5610,780,3,1047,136,1183,5549,2021-01-28 00:07:50
5611,787,3,727,94,821,5550,2021-01-28 05:30:26
5612,797,2,528,68,596,5551,2021-01-27 11:31:44
5613,660,2,698,90,788,5552,2021-01-27 19:18:55
5614,230,2,798,103,901,5553,2021-01-28 08:17:04
5615,230,2,798,103,901,5553,2021-01-28 08:17:04
5616,756,2,698,90,788,5554,2021-01-28 08:29:34
5617,565,3,597,77,674,5555,2021-01-28 12:20:40
5618,856,3,727,94,821,5556,2021-01-28 08:41:03
5619,849,2,429,55,484,5557,2021-01-27 20:55:21
5620,707,2,898,116,1014,5558,2021-01-28 16:02:39
5621,368,3,647,84,731,5559,2021-01-28 12:41:49
5622,225,5,1586,206,1792,5560,2021-01-28 01:38:05
5623,743,2,659,85,744,5561,2021-01-27 20:52:40
5624,337,2,329,42,371,5562,2021-01-26 20:34:58
5625,999,3,727,94,821,5563,2021-01-27 06:31:48
5626,438,3,747,97,844,5564,2021-01-27 04:53:56
5627,187,3,1047,136,1183,5565,2021-01-27 06:15:45
5628,699,3,947,123,1070,5566,2021-01-27 03:03:25
5629,780,3,647,84,731,5567,2021-01-27 09:25:03
5630,862,2,798,103,901,5568,2021-01-27 06:08:30
5631,640,3,1247,162,1409,5569,2021-01-27 08:25:24
5632,853,3,727,94,821,5570,2021-01-27 15:40:07
5633,197,3,578,75,653,5571,2021-01-27 09:22:19
5634,442,2,898,116,1014,5572,2021-01-27 14:10:39
5635,700,2,459,59,518,5573,2021-01-27 13:51:59
5636,700,2,459,59,518,5573,2021-01-27 13:51:59
5637,635,3,697,90,787,5574,2021-01-27 17:37:13
5638,635,3,697,90,787,5574,2021-01-27 17:37:13
5639,223,5,2025,263,2288,5575,2021-01-27 10:12:17
5640,678,2,548,71,619,5576,2021-01-27 14:09:14
5641,392,2,459,59,518,5577,2021-01-27 15:47:35
5642,730,2,728,94,822,5578,2021-01-27 03:12:34
5643,128,3,997,129,1126,5579,2021-01-27 01:53:59
5644,162,3,1127,146,1273,5580,2021-01-26 22:58:44
5645,38,3,997,129,1126,5581,2021-01-27 11:44:28
5646,527,2,698,90,788,5582,2021-01-27 17:02:42
5647,777,2,898,116,1014,5583,2021-01-27 14:22:01
5648,507,3,827,107,934,5584,2021-01-27 07:02:09
5649,181,2,598,77,675,5585,2021-01-26 18:12:52
5650,37,3,827,107,934,5586,2021-01-26 10:21:45
5651,20,6,1166,151,1317,5587,2021-01-26 14:27:20
5652,198,1,299,38,337,5588,2021-01-26 17:27:18
5653,994,5,2095,272,2367,5589,2021-01-26 08:24:29
5654,496,3,578,75,653,5590,2021-01-26 12:54:39
5655,583,3,578,75,653,5591,2021-01-26 22:24:29
5656,650,2,459,59,518,5592,2021-01-26 20:52:24
5657,916,2,1098,142,1240,5593,2021-01-27 01:05:01
5658,769,2,498,64,562,5594,2021-01-27 06:03:30
5659,112,3,997,129,1126,5595,2021-01-27 03:24:52
5660,493,3,658,85,743,5596,2021-01-27 08:56:29
5661,685,2,429,55,484,5597,2021-01-26 19:14:43
5662,445,2,498,64,562,5598,2021-01-26 14:39:53
5663,427,2,598,77,675,5599,2021-01-26 19:40:05
5664,455,5,1376,178,1554,5600,2021-01-27 03:15:48
5665,487,3,608,79,687,5601,2021-01-27 00:14:34
5666,186,5,1217,158,1375,5602,2021-01-28 07:10:54
5667,846,3,827,107,934,5603,2021-01-28 06:24:52
5668,307,3,927,120,1047,5604,2021-01-28 05:03:49
5669,264,3,558,72,630,5605,2021-01-27 23:51:45
5670,852,3,1247,162,1409,5606,2021-01-27 13:14:01
5671,525,2,648,84,732,5607,2021-01-27 09:14:39
5672,440,2,848,110,958,5608,2021-01-27 07:12:12
5673,933,2,498,64,562,5609,2021-01-27 13:30:14
5674,451,3,428,55,483,5610,2021-01-27 13:17:24
5675,795,2,459,59,518,5611,2021-01-27 15:03:48
5676,659,3,558,72,630,5612,2021-01-28 00:43:55
5677,227,2,798,103,901,5613,2021-01-28 06:45:59
5678,168,3,727,94,821,5614,2021-01-27 13:25:45
5679,93,2,329,42,371,5615,2021-01-27 19:59:02
5680,793,2,429,55,484,5616,2021-01-28 10:55:32
5681,954,3,558,72,630,5617,2021-01-28 08:42:44
5682,697,3,578,75,653,5618,2021-01-28 10:08:21
5683,701,3,1127,146,1273,5619,2021-01-28 13:02:47
5684,620,5,1336,173,1509,5620,2021-01-28 11:11:19
5685,248,3,647,84,731,5621,2021-01-27 22:41:53
5686,635,6,1835,238,2073,5622,2021-01-28 18:06:27
5687,160,4,1596,207,1803,5623,2021-01-28 15:03:16
5688,495,1,99,12,111,5624,2021-01-28 02:00:05
5689,989,3,947,123,1070,5625,2021-01-27 21:01:41
5690,936,3,528,68,596,5626,2021-01-26 20:45:55
5691,630,3,888,115,1003,5627,2021-01-27 08:00:33
5692,583,2,598,77,675,5628,2021-01-27 05:54:38
5693,598,5,1925,250,2175,5629,2021-01-27 06:25:02
5694,229,3,727,94,821,5630,2021-01-27 04:44:53
5695,134,3,997,129,1126,5631,2021-01-27 10:00:23
5696,536,5,1725,224,1949,5632,2021-01-27 08:41:30
5697,209,2,429,55,484,5633,2021-01-27 10:21:19
5698,635,3,927,120,1047,5634,2021-01-27 15:45:30
5699,392,3,688,89,777,5635,2021-01-27 09:35:35
5700,563,3,697,90,787,5636,2021-01-27 15:54:42
5701,477,3,1127,146,1273,5637,2021-01-27 14:41:05
5702,786,2,659,85,744,5638,2021-01-27 14:08:23
5703,702,2,898,116,1014,5639,2021-01-27 18:44:59
5704,232,3,647,84,731,5640,2021-01-27 20:09:05
5705,482,1,99,12,111,5641,2021-01-27 11:41:37
5706,748,2,728,94,822,5642,2021-01-27 16:38:14
5707,822,3,1327,172,1499,5643,2021-01-27 15:59:36
5708,798,3,697,90,787,5644,2021-01-27 04:58:15
5709,342,3,1027,133,1160,5645,2021-01-27 03:00:17
5710,207,3,608,79,687,5646,2021-01-27 01:18:57
5711,671,3,558,72,630,5647,2021-01-27 14:29:06
5712,918,3,1027,133,1160,5648,2021-01-27 18:45:13
5713,711,3,558,72,630,5649,2021-01-27 16:00:42
5714,676,3,827,107,934,5650,2021-01-27 08:19:37
5715,949,2,598,77,675,5651,2021-01-26 20:47:40
5716,746,3,888,115,1003,5652,2021-01-26 12:21:24
5717,48,2,798,103,901,5653,2021-01-26 15:08:50
5718,478,3,558,72,630,5654,2021-01-26 17:38:29
5719,692,3,947,123,1070,5655,2021-01-26 09:13:02
5720,138,4,1257,163,1420,5656,2021-01-26 13:35:27
5721,193,5,1145,148,1293,5657,2021-01-26 22:40:16
5722,364,3,1327,172,1499,5658,2021-01-26 21:14:33
5723,108,2,798,103,901,5659,2021-01-27 02:53:29
5724,276,3,578,75,653,5660,2021-01-27 07:55:54
5725,376,5,1356,176,1532,5661,2021-01-27 05:48:26
5726,603,2,698,90,788,5662,2021-01-27 10:01:05
5727,494,2,898,116,1014,5663,2021-01-26 21:22:38
5728,459,3,927,120,1047,5664,2021-01-26 17:16:49
5729,761,5,1156,150,1306,5665,2021-01-26 21:19:12
5730,626,3,927,120,1047,5666,2021-01-27 04:59:20
5731,76,2,498,64,562,5667,2021-01-27 01:15:36
5732,165,2,598,77,675,5668,2021-01-28 07:39:32
5733,730,3,1127,146,1273,5669,2021-01-28 06:58:31
5734,990,6,1574,204,1778,5670,2021-01-28 07:10:16
5735,924,5,1795,233,2028,5671,2021-01-28 01:31:36
5736,466,3,808,105,913,5672,2021-01-27 15:52:29
5737,251,3,428,55,483,5673,2021-01-27 09:56:00
5738,524,3,747,97,844,5674,2021-01-27 09:35:07
5739,279,1,299,38,337,5675,2021-01-27 13:35:20
5740,998,1,99,12,111,5676,2021-01-27 13:28:59
5741,240,2,928,120,1048,5677,2021-01-27 15:18:30
5742,896,3,747,97,844,5678,2021-01-28 02:10:19
5743,17,2,898,116,1014,5679,2021-01-28 06:49:18
5744,841,2,459,59,518,5680,2021-01-27 14:13:23
5745,74,1,99,12,111,5681,2021-01-27 21:12:45
5746,57,4,1087,141,1228,5682,2021-01-28 13:06:45
5747,575,3,647,84,731,5683,2021-01-28 09:12:01
5748,175,3,658,85,743,5684,2021-01-28 12:23:14
5749,704,3,1047,136,1183,5685,2021-01-28 13:43:18
5750,757,3,658,85,743,5686,2021-01-28 12:57:50
5751,388,5,887,115,1002,5687,2021-01-28 00:23:26
5752,574,3,897,116,1013,5688,2021-01-28 19:50:46
5753,628,3,927,120,1047,5689,2021-01-28 15:09:34
5754,572,3,558,72,630,5690,2021-01-28 03:27:53
5755,707,1,229,29,258,5691,2021-01-27 22:23:16
5756,983,2,748,97,845,5692,2021-01-26 23:06:06
5757,84,2,398,51,449,5693,2021-01-27 09:20:53
5758,452,3,1247,162,1409,5694,2021-01-27 07:16:33
5759,521,2,648,84,732,5695,2021-01-27 09:07:20
5760,608,2,898,116,1014,5696,2021-01-27 04:50:24
5761,712,4,1096,142,1238,5697,2021-01-27 10:55:52
5762,800,2,498,64,562,5698,2021-01-27 11:03:36
5763,960,3,997,129,1126,5699,2021-01-27 13:00:26
5764,582,2,848,110,958,5700,2021-01-27 18:04:49
5765,269,2,648,84,732,5701,2021-01-27 11:42:48
5766,820,3,658,85,743,5702,2021-01-27 17:02:31
5767,626,3,827,107,934,5703,2021-01-27 15:05:45
5768,221,2,898,116,1014,5704,2021-01-27 14:20:49
5769,746,3,958,124,1082,5705,2021-01-27 19:42:48
5770,406,3,947,123,1070,5706,2021-01-27 20:40:25
5771,663,3,1127,146,1273,5707,2021-01-27 12:19:32
5772,175,3,697,90,787,5708,2021-01-27 19:21:38
5773,926,2,429,55,484,5709,2021-01-27 17:08:18
5774,355,3,688,89,777,5710,2021-01-27 06:21:15
5775,987,4,1207,156,1363,5711,2021-01-27 03:48:03
5776,496,3,927,120,1047,5712,2021-01-27 01:19:59
5777,368,3,997,129,1126,5713,2021-01-27 14:50:19
5778,875,2,329,42,371,5714,2021-01-27 20:42:50
5779,767,2,598,77,675,5715,2021-01-27 16:49:46
5780,182,1,229,29,258,5716,2021-01-27 09:13:54
5781,643,2,528,68,596,5717,2021-01-26 22:28:24
5782,330,3,647,84,731,5718,2021-01-26 13:03:04
5783,914,3,947,123,1070,5719,2021-01-26 17:49:41
5784,43,3,1047,136,1183,5720,2021-01-26 18:58:30
5785,787,3,1127,146,1273,5721,2021-01-26 11:43:19
5786,696,3,688,89,777,5722,2021-01-26 15:36:14
5787,747,2,798,103,901,5723,2021-01-26 23:52:33
5788,531,4,1526,198,1724,5724,2021-01-26 22:07:42
5789,660,1,399,51,450,5725,2021-01-27 04:06:28
5790,522,3,1027,133,1160,5726,2021-01-27 09:14:37
5791,764,3,1127,146,1273,5727,2021-01-27 06:21:44
5792,901,3,1127,146,1273,5728,2021-01-27 10:32:54
5793,322,3,1197,155,1352,5729,2021-01-26 22:57:37
5794,136,3,597,77,674,5730,2021-01-26 18:58:05
5795,918,3,597,77,674,5731,2021-01-26 21:53:15
5796,345,3,697,90,787,5732,2021-01-27 05:46:08
5797,82,3,597,77,674,5733,2021-01-27 02:07:31
5798,629,3,558,72,630,5734,2021-01-28 08:34:12
5799,51,3,888,115,1003,5735,2021-01-28 07:53:20
5800,115,2,898,116,1014,5736,2021-01-28 09:10:37
5801,122,1,399,51,450,5737,2021-01-28 02:10:08
5802,777,3,797,103,900,5738,2021-01-27 17:46:33
5803,805,3,827,107,934,5739,2021-01-27 11:26:28
5804,789,3,1327,172,1499,5740,2021-01-27 09:35:27
5805,991,3,997,129,1126,5741,2021-01-27 14:15:26
5806,221,3,808,105,913,5742,2021-01-27 15:53:10
5807,994,5,1755,228,1983,5743,2021-01-27 16:24:36
5808,611,3,897,116,1013,5744,2021-01-28 02:37:23
5809,236,3,558,72,630,5745,2021-01-28 08:01:04
5810,54,2,598,77,675,5746,2021-01-27 16:53:21
5811,866,5,1686,219,1905,5747,2021-01-27 23:24:15
5812,86,5,1117,145,1262,5748,2021-01-28 15:39:44
5813,116,2,659,85,744,5749,2021-01-28 09:39:28
5814,380,4,1826,237,2063,5750,2021-01-28 13:40:17
5815,554,3,697,90,787,5751,2021-01-28 13:43:54
5816,836,2,528,68,596,5752,2021-01-28 13:03:36
5817,422,4,1496,194,1690,5753,2021-01-28 02:56:41
5818,848,5,1376,178,1554,5754,2021-01-28 19:54:08
5819,186,3,528,68,596,5755,2021-01-28 16:31:06
5820,402,3,797,103,900,5756,2021-01-28 05:27:14
5821,912,3,647,84,731,5757,2021-01-28 00:29:30
5822,557,3,558,72,630,5758,2021-01-26 23:33:43
5823,648,2,898,116,1014,5759,2021-01-27 10:25:03
5824,507,3,1197,155,1352,5760,2021-01-27 07:55:36
5825,868,2,498,64,562,5761,2021-01-27 10:09:19
5826,131,2,398,51,449,5762,2021-01-27 06:47:04
5827,656,3,747,97,844,5763,2021-01-27 11:01:30
5828,859,3,827,107,934,5764,2021-01-27 12:44:01
5829,838,2,698,90,788,5765,2021-01-27 14:05:22
5830,940,3,697,90,787,5766,2021-01-27 18:11:40
5831,97,3,428,55,483,5767,2021-01-27 13:38:49
5832,676,3,478,62,540,5768,2021-01-27 19:44:47
5833,350,2,598,77,675,5769,2021-01-27 15:55:43
5834,175,3,1127,146,1273,5770,2021-01-27 15:02:10
5835,427,3,558,72,630,5771,2021-01-27 22:12:34
5836,631,3,808,105,913,5772,2021-01-27 21:36:35
5837,719,2,598,77,675,5773,2021-01-27 14:47:56
5838,436,5,1476,191,1667,5774,2021-01-27 20:41:39
5839,222,3,1027,133,1160,5775,2021-01-27 19:26:01
5840,296,3,897,116,1013,5776,2021-01-27 07:28:51
5841,944,2,698,90,788,5777,2021-01-27 04:32:54
5842,5,1,149,19,168,5778,2021-01-27 02:28:51
5843,805,2,598,77,675,5779,2021-01-27 16:58:48
5844,118,3,847,110,957,5780,2021-01-27 21:03:35
5845,832,2,898,116,1014,5781,2021-01-27 17:47:35
5846,518,5,1295,168,1463,5782,2021-01-27 09:48:58
5847,791,3,1127,146,1273,5783,2021-01-27 00:46:51
5848,165,3,1327,172,1499,5784,2021-01-26 14:20:48
5849,383,2,598,77,675,5785,2021-01-26 18:30:38
5850,751,2,498,64,562,5786,2021-01-26 19:37:53
5851,353,3,747,97,844,5787,2021-01-26 14:18:34
5852,909,3,647,84,731,5788,2021-01-26 18:01:30
5853,478,3,1027,133,1160,5789,2021-01-27 00:01:40
5854,241,2,498,64,562,5790,2021-01-27 00:17:57
5855,865,1,229,29,258,5791,2021-01-27 06:44:30
5856,914,2,659,85,744,5792,2021-01-27 11:25:26
5857,133,3,558,72,630,5793,2021-01-27 08:38:48
5858,173,3,927,120,1047,5794,2021-01-27 11:55:08
5859,498,3,478,62,540,5795,2021-01-27 00:39:48
5860,848,1,229,29,258,5796,2021-01-26 21:01:23
5861,391,1,599,77,676,5797,2021-01-26 22:41:57
5862,273,3,478,62,540,5798,2021-01-27 06:01:15
5863,815,3,1247,162,1409,5799,2021-01-27 02:13:19
5864,975,2,898,116,1014,5800,2021-01-28 08:55:33
5865,922,2,898,116,1014,5801,2021-01-28 10:02:17
5866,978,2,698,90,788,5802,2021-01-28 10:38:56
5867,847,3,847,110,957,5803,2021-01-28 02:53:05
5868,497,3,578,75,653,5804,2021-01-27 20:21:37
5869,143,3,997,129,1126,5805,2021-01-27 12:49:11
5870,751,4,1396,181,1577,5806,2021-01-27 10:20:59
5871,127,3,747,97,844,5807,2021-01-27 15:34:12
5872,148,6,1555,202,1757,5808,2021-01-27 17:10:30
5873,793,2,498,64,562,5809,2021-01-27 18:48:00
5874,513,3,797,103,900,5810,2021-01-28 05:23:45
5875,721,2,598,77,675,5811,2021-01-28 09:15:03
5876,889,3,697,90,787,5812,2021-01-27 19:16:26
5877,822,2,798,103,901,5813,2021-01-28 01:45:04
5878,574,3,1327,172,1499,5814,2021-01-28 15:49:26
5879,797,3,997,129,1126,5815,2021-01-28 11:15:09
5880,826,3,827,107,934,5816,2021-01-28 16:08:54
5881,70,3,758,98,856,5817,2021-01-28 14:47:55
5882,523,2,598,77,675,5818,2021-01-28 14:27:49
5883,948,3,947,123,1070,5819,2021-01-28 03:52:31
5884,783,3,847,110,957,5820,2021-01-28 21:52:45
5885,875,3,647,84,731,5821,2021-01-28 18:59:58
5886,667,2,1098,142,1240,5822,2021-01-28 07:07:19
5887,375,2,898,116,1014,5823,2021-01-28 02:21:10
5888,94,3,897,116,1013,5824,2021-01-27 00:34:47
5889,681,3,747,97,844,5825,2021-01-27 13:07:32
5890,313,2,798,103,901,5826,2021-01-27 08:35:39
5891,288,3,647,84,731,5827,2021-01-27 10:20:29
5892,772,3,688,89,777,5828,2021-01-27 06:58:43
5893,769,2,398,51,449,5829,2021-01-27 11:40:17
5894,191,1,699,90,789,5830,2021-01-27 12:48:14
5895,858,1,399,51,450,5831,2021-01-27 15:01:36
5896,656,5,1286,167,1453,5832,2021-01-27 19:07:05
5897,142,3,597,77,674,5833,2021-01-27 14:38:59
5898,60,2,1098,142,1240,5834,2021-01-27 22:10:16
5899,210,3,428,55,483,5835,2021-01-27 16:29:04
5900,814,3,997,129,1126,5836,2021-01-27 16:18:52
5901,29,2,898,116,1014,5837,2021-01-27 22:57:09
5902,904,3,647,84,731,5838,2021-01-28 00:13:55
5903,113,2,459,59,518,5839,2021-01-27 15:17:50
5904,647,3,578,75,653,5840,2021-01-27 22:48:04
5905,483,2,659,85,744,5841,2021-01-27 20:05:52
5906,464,2,498,64,562,5842,2021-01-27 08:54:26
5907,610,3,808,105,913,5843,2021-01-27 06:46:16
5908,406,2,848,110,958,5844,2021-01-27 05:05:22
5909,500,2,659,85,744,5845,2021-01-27 18:09:15
5910,904,2,898,116,1014,5846,2021-01-27 22:11:32
5911,412,2,598,77,675,5847,2021-01-27 20:05:30
5912,845,3,1247,162,1409,5848,2021-01-27 12:02:46
5913,555,3,597,77,674,5849,2021-01-27 01:35:44
5914,64,5,1176,152,1328,5850,2021-01-26 16:28:19
5915,678,3,747,97,844,5851,2021-01-26 20:53:26
5916,343,3,947,123,1070,5852,2021-01-26 20:57:11
5917,423,5,1217,158,1375,5853,2021-01-26 16:36:52
5918,629,3,1127,146,1273,5854,2021-01-26 19:24:28
5919,182,3,947,123,1070,5855,2021-01-27 02:19:08
5920,621,3,747,97,844,5856,2021-01-27 00:52:36
5921,518,1,229,29,258,5857,2021-01-27 08:04:49
5922,915,3,947,123,1070,5858,2021-01-27 12:46:14
5923,80,5,1825,237,2062,5859,2021-01-27 09:05:54
5924,514,3,1127,146,1273,5860,2021-01-27 13:38:30
5925,690,2,459,59,518,5861,2021-01-27 02:37:05
5926,260,3,1047,136,1183,5862,2021-01-26 22:14:16
5927,588,6,1974,256,2230,5863,2021-01-27 00:19:51
5928,781,2,898,116,1014,5864,2021-01-27 08:08:52
5929,183,2,329,42,371,5865,2021-01-27 02:52:51
5930,948,2,459,59,518,5866,2021-01-28 11:14:26
5931,42,2,498,64,562,5867,2021-01-28 11:25:53
5932,452,1,149,19,168,5868,2021-01-28 12:08:52
5933,195,3,808,105,913,5869,2021-01-28 03:22:58
5934,755,2,459,59,518,5870,2021-01-27 22:52:59
5935,698,2,659,85,744,5871,2021-01-27 13:35:17
5936,108,3,1247,162,1409,5872,2021-01-27 11:01:08
5937,412,2,429,55,484,5873,2021-01-27 16:31:08
5938,245,3,1327,172,1499,5874,2021-01-27 19:44:58
5939,113,5,1345,174,1519,5875,2021-01-27 20:47:10
5940,625,4,1246,161,1407,5876,2021-01-28 07:25:32
5941,44,3,1327,172,1499,5877,2021-01-28 10:21:06
5942,72,3,478,62,540,5878,2021-01-27 19:18:12
5943,644,3,528,68,596,5879,2021-01-28 01:46:50
5944,664,4,1096,142,1238,5880,2021-01-28 16:30:51
5945,901,2,798,103,901,5881,2021-01-28 11:19:58
5946,87,2,498,64,562,5882,2021-01-28 17:11:54
5947,328,2,459,59,518,5883,2021-01-28 15:35:28
5948,911,2,898,116,1014,5884,2021-01-28 16:55:32
5949,222,2,329,42,371,5885,2021-01-28 04:59:56
5950,420,3,428,55,483,5886,2021-01-28 23:18:48
5951,208,2,598,77,675,5887,2021-01-28 19:26:48
5952,535,1,229,29,258,5888,2021-01-28 09:10:51
5953,919,3,697,90,787,5889,2021-01-28 04:09:09
5954,135,1,229,29,258,5890,2021-01-27 00:44:31
5955,182,3,558,72,630,5891,2021-01-27 15:50:45
5956,532,3,528,68,596,5892,2021-01-27 10:40:25
5957,197,3,478,62,540,5893,2021-01-27 11:48:51
5958,897,3,558,72,630,5894,2021-01-27 08:44:58
5959,369,1,99,12,111,5895,2021-01-27 12:12:48
5960,759,2,598,77,675,5896,2021-01-27 14:33:00
5961,985,2,498,64,562,5897,2021-01-27 16:08:04
5962,866,6,1075,139,1214,5898,2021-01-27 21:10:24
5963,15,3,1127,146,1273,5899,2021-01-27 16:13:17
5964,523,3,608,79,687,5900,2021-01-28 00:17:32
5965,386,3,808,105,913,5901,2021-01-27 16:49:34
5966,836,2,598,77,675,5902,2021-01-27 17:28:52
5967,919,4,1426,185,1611,5903,2021-01-28 00:12:17
5968,175,1,599,77,676,5904,2021-01-28 01:07:32
5969,41,3,697,90,787,5905,2021-01-27 16:38:34
5970,424,2,659,85,744,5906,2021-01-27 22:59:13
5971,321,2,898,116,1014,5907,2021-01-27 22:01:22
5972,598,2,898,116,1014,5908,2021-01-27 09:21:03
5973,933,2,659,85,744,5909,2021-01-27 07:58:50
5974,817,3,997,129,1126,5910,2021-01-27 06:27:42
5975,947,2,928,120,1048,5911,2021-01-27 20:07:52
5976,670,5,1525,198,1723,5912,2021-01-27 23:04:46
5977,774,2,598,77,675,5913,2021-01-27 21:59:41
5978,698,3,747,97,844,5914,2021-01-27 13:24:38
5979,166,3,478,62,540,5915,2021-01-27 02:28:14
5980,398,3,558,72,630,5916,2021-01-26 18:43:04
5981,205,3,1327,172,1499,5917,2021-01-26 23:10:10
5982,21,3,697,90,787,5918,2021-01-26 23:18:23
5983,82,3,658,85,743,5919,2021-01-26 16:42:51
5984,610,2,659,85,744,5920,2021-01-26 21:49:38
5985,926,3,597,77,674,5921,2021-01-27 03:55:26
5986,336,3,597,77,674,5922,2021-01-27 01:13:58
5987,604,3,428,55,483,5923,2021-01-27 09:54:42
5988,567,3,758,98,856,5924,2021-01-27 14:48:31
5989,362,3,608,79,687,5925,2021-01-27 11:42:46
5990,755,2,898,116,1014,5926,2021-01-27 14:17:41
5991,676,3,808,105,913,5927,2021-01-27 04:42:41
5992,625,3,1047,136,1183,5928,2021-01-26 23:21:18
5993,944,3,747,97,844,5929,2021-01-27 01:42:38
5994,344,3,797,103,900,5930,2021-01-27 08:41:12
5995,467,5,1026,133,1159,5931,2021-01-27 05:26:13
5996,506,2,1098,142,1240,5932,2021-01-28 12:32:57
5997,516,5,1325,172,1497,5933,2021-01-28 13:05:16
5998,116,6,1285,167,1452,5934,2021-01-28 12:43:57
5999,661,4,1226,159,1385,5935,2021-01-28 04:38:41
6000,819,6,1694,220,1914,5936,2021-01-28 01:30:58
6001,658,3,428,55,483,5937,2021-01-27 16:00:28
6002,658,3,428,55,483,5937,2021-01-27 16:00:28
6003,199,3,808,105,913,5938,2021-01-27 13:16:07
6004,224,2,498,64,562,5939,2021-01-27 17:39:51
6005,381,4,1357,176,1533,5940,2021-01-27 20:05:26
6006,815,3,697,90,787,5941,2021-01-27 23:20:57
6007,353,3,797,103,900,5942,2021-01-28 10:08:03
6008,896,2,1098,142,1240,5943,2021-01-28 10:26:54
6009,693,5,1406,182,1588,5944,2021-01-27 21:05:34
6010,817,2,598,77,675,5945,2021-01-28 02:01:11
6011,337,2,528,68,596,5946,2021-01-28 17:32:59
6012,766,2,798,103,901,5947,2021-01-28 12:14:40
6013,17,4,1296,168,1464,5948,2021-01-28 19:41:22
6014,541,3,1197,155,1352,5949,2021-01-28 16:58:47
6015,695,3,1197,155,1352,5950,2021-01-28 17:55:52
6016,166,1,229,29,258,5951,2021-01-28 07:41:25
6017,308,5,1525,198,1723,5952,2021-01-29 00:38:06
6018,751,2,598,77,675,5953,2021-01-28 21:35:12
6019,345,3,1127,146,1273,5954,2021-01-28 09:33:15
6020,602,3,927,120,1047,5955,2021-01-28 06:00:20
6021,648,6,1086,141,1227,5956,2021-01-27 03:14:49
6022,416,3,747,97,844,5957,2021-01-27 18:37:01
6023,929,2,429,55,484,5958,2021-01-27 12:36:36
6024,510,2,1098,142,1240,5959,2021-01-27 12:54:56
6025,303,3,758,98,856,5960,2021-01-27 10:48:00
6026,304,4,1126,146,1272,5961,2021-01-27 13:51:25
6027,451,3,608,79,687,5962,2021-01-27 17:08:22
6028,986,3,758,98,856,5963,2021-01-27 16:37:52
6029,674,3,947,123,1070,5964,2021-01-27 23:36:07
6030,570,5,1356,176,1532,5965,2021-01-27 17:52:19
6031,103,5,1495,194,1689,5966,2021-01-28 00:57:40
6032,145,2,429,55,484,5967,2021-01-27 18:19:46
6033,2,2,698,90,788,5968,2021-01-27 19:10:40
6034,559,3,688,89,777,5969,2021-01-28 02:55:41
6035,47,2,329,42,371,5970,2021-01-28 03:19:49
6036,238,2,459,59,518,5971,2021-01-27 19:10:12
6037,950,2,798,103,901,5972,2021-01-27 22:59:19
6038,778,5,1106,143,1249,5973,2021-01-27 23:34:47
6039,571,3,697,90,787,5974,2021-01-27 10:08:01
6040,200,3,608,79,687,5975,2021-01-27 09:03:31
6041,97,3,747,97,844,5976,2021-01-27 07:06:18
6042,52,5,1186,154,1340,5977,2021-01-27 22:16:40
6043,861,2,329,42,371,5978,2021-01-27 23:57:39
6044,342,3,1047,136,1183,5979,2021-01-27 23:57:16
6045,841,3,658,85,743,5980,2021-01-27 16:04:24
6046,365,2,798,103,901,5981,2021-01-27 04:42:35
6047,629,2,648,84,732,5982,2021-01-26 19:43:29
6048,536,5,1425,185,1610,5983,2021-01-26 23:41:08
6049,321,2,329,42,371,5984,2021-01-27 01:10:32
6050,652,3,428,55,483,5985,2021-01-26 18:39:34
6051,940,2,898,116,1014,5986,2021-01-27 00:06:03
6052,31,1,499,64,563,5987,2021-01-27 05:34:18
6053,869,5,1795,233,2028,5988,2021-01-27 03:11:19
6054,166,2,798,103,901,5989,2021-01-27 10:03:52
6055,987,2,598,77,675,5990,2021-01-27 16:54:38
6056,677,4,1126,146,1272,5991,2021-01-27 13:06:43
6057,385,3,558,72,630,5992,2021-01-27 14:44:34
6058,582,2,329,42,371,5993,2021-01-27 04:45:44
6059,236,5,1695,220,1915,5994,2021-01-27 01:30:52
6060,9,3,997,129,1126,5995,2021-01-27 04:15:53
6061,866,3,528,68,596,5996,2021-01-27 09:29:32
6062,340,2,329,42,371,5997,2021-01-27 07:40:47
6063,709,5,1676,217,1893,5998,2021-01-28 13:17:27
6064,825,3,1027,133,1160,5999,2021-01-28 14:07:08
6065,362,2,648,84,732,6000,2021-01-28 13:29:40
6066,73,2,498,64,562,6001,2021-01-28 06:40:06
6067,95,3,528,68,596,6002,2021-01-28 01:40:23
6068,275,3,658,85,743,6003,2021-01-27 18:14:50
6069,481,3,478,62,540,6004,2021-01-27 16:57:07
6070,67,2,648,84,732,6005,2021-01-27 15:20:38
6071,778,3,597,77,674,6006,2021-01-27 19:06:59
6072,433,2,1098,142,1240,6007,2021-01-27 20:27:35
6073,410,3,1197,155,1352,6008,2021-01-27 23:42:42
6074,522,6,1954,254,2208,6009,2021-01-28 10:39:15
6075,834,5,1625,211,1836,6010,2021-01-28 12:06:00
6076,13,2,898,116,1014,6011,2021-01-27 21:51:38
6077,883,3,1027,133,1160,6012,2021-01-28 03:54:55
6078,950,3,688,89,777,6013,2021-01-28 19:02:15
6079,781,3,747,97,844,6014,2021-01-28 14:38:39
6080,728,2,698,90,788,6015,2021-01-28 20:22:46
6081,970,1,599,77,676,6016,2021-01-28 18:29:44
6082,189,2,659,85,744,6017,2021-01-28 18:24:09
6083,250,3,747,97,844,6018,2021-01-28 08:17:19
6084,993,2,798,103,901,6019,2021-01-29 00:54:57
6085,217,2,898,116,1014,6020,2021-01-28 22:16:34
6086,936,3,1047,136,1183,6021,2021-01-28 12:00:58
6087,80,2,659,85,744,6022,2021-01-28 07:54:15
6088,817,3,797,103,900,6023,2021-01-27 04:34:40
6089,558,2,329,42,371,6024,2021-01-27 19:18:14
6090,628,3,478,62,540,6025,2021-01-27 12:39:27
6091,407,2,429,55,484,6026,2021-01-27 14:17:52
6092,862,3,758,98,856,6027,2021-01-27 12:44:37
6093,768,6,1774,230,2004,6028,2021-01-27 16:24:39
6094,120,5,1547,201,1748,6029,2021-01-27 18:39:27
6095,110,5,2025,263,2288,6030,2021-01-27 17:32:24
6096,546,3,888,115,1003,6031,2021-01-28 01:43:31
6097,546,3,888,115,1003,6031,2021-01-28 01:43:31
6098,744,2,329,42,371,6032,2021-01-27 19:30:27
6099,537,2,498,64,562,6033,2021-01-28 01:21:09
6100,813,2,598,77,675,6034,2021-01-27 20:15:34
6101,992,3,688,89,777,6035,2021-01-27 20:05:21
6102,717,3,747,97,844,6036,2021-01-28 03:44:30
6103,278,3,947,123,1070,6037,2021-01-28 04:03:10
6104,479,1,99,12,111,6038,2021-01-27 19:42:01
6105,121,2,548,71,619,6039,2021-01-27 23:31:27
6106,473,3,827,107,934,6040,2021-01-28 02:20:09
6107,639,2,659,85,744,6041,2021-01-27 11:15:40
6108,621,5,1625,211,1836,6042,2021-01-27 11:03:54
6109,676,5,1256,163,1419,6043,2021-01-27 07:21:11
6110,660,5,1825,237,2062,6044,2021-01-27 23:57:29
6111,1000,2,659,85,744,6045,2021-01-28 00:41:42
6112,987,1,599,77,676,6046,2021-01-28 01:31:24
6113,101,3,1027,133,1160,6047,2021-01-27 16:50:27
6114,431,1,99,12,111,6048,2021-01-27 07:02:33
6115,468,1,99,12,111,6049,2021-01-26 19:43:36
6116,249,2,1098,142,1240,6050,2021-01-27 00:31:43
6117,132,3,1127,146,1273,6051,2021-01-27 02:14:17
6118,665,3,1127,146,1273,6052,2021-01-26 19:19:50
6119,449,3,1247,162,1409,6053,2021-01-27 02:08:29
6120,839,1,599,77,676,6054,2021-01-27 08:15:06
6121,147,2,598,77,675,6055,2021-01-27 04:10:33
6122,941,3,827,107,934,6056,2021-01-27 11:37:23
6123,956,3,747,97,844,6057,2021-01-27 17:38:52
6124,939,2,598,77,675,6058,2021-01-27 13:50:41
6125,669,4,2026,263,2289,6059,2021-01-27 16:34:30
6126,138,3,758,98,856,6060,2021-01-27 06:15:47
6127,708,1,399,51,450,6061,2021-01-27 03:28:23
6128,551,2,329,42,371,6062,2021-01-27 04:35:59
6129,331,3,1497,194,1691,6063,2021-01-27 12:11:03
6130,495,2,598,77,675,6064,2021-01-27 09:27:42
6131,887,3,927,120,1047,6065,2021-01-28 15:45:50
6132,73,5,1825,237,2062,6066,2021-01-28 15:39:37
6133,103,3,827,107,934,6067,2021-01-28 14:12:34
6134,197,1,599,77,676,6068,2021-01-28 08:10:42
6135,21,3,827,107,934,6069,2021-01-28 02:37:50
6136,164,3,1027,133,1160,6070,2021-01-27 18:19:51
6137,911,3,997,129,1126,6071,2021-01-27 17:14:57
6138,434,2,898,116,1014,6072,2021-01-27 15:31:59
6139,183,2,898,116,1014,6073,2021-01-27 21:48:32
6140,839,3,827,107,934,6074,2021-01-27 23:01:05
6141,882,4,1146,148,1294,6075,2021-01-28 01:50:59
6142,362,4,1157,150,1307,6076,2021-01-28 10:56:34
6143,945,3,647,84,731,6077,2021-01-28 14:02:19
6144,817,6,1805,234,2039,6078,2021-01-27 23:19:58
6145,217,3,558,72,630,6079,2021-01-28 05:23:29
6146,540,5,1645,213,1858,6080,2021-01-28 21:35:19
6147,437,3,697,90,787,6081,2021-01-28 15:11:11
6148,111,3,697,90,787,6082,2021-01-28 22:19:51
6149,206,3,688,89,777,6083,2021-01-28 19:06:16
6150,244,3,758,98,856,6084,2021-01-28 19:13:16
6151,57,3,478,62,540,6085,2021-01-28 10:40:43
6152,699,3,1197,155,1352,6086,2021-01-29 03:09:28
6153,717,3,947,123,1070,6087,2021-01-28 23:48:55
6154,293,5,2145,278,2423,6088,2021-01-28 14:33:16
6155,138,3,947,123,1070,6089,2021-01-28 08:17:06
6156,497,3,897,116,1013,6090,2021-01-27 05:37:59
6157,116,2,898,116,1014,6091,2021-01-27 21:08:43
6158,439,2,329,42,371,6092,2021-01-27 14:51:20
6159,230,3,1027,133,1160,6093,2021-01-27 16:16:05
6160,378,5,1395,181,1576,6094,2021-01-27 14:37:57
6161,751,3,808,105,913,6095,2021-01-27 17:09:13
6162,440,3,1327,172,1499,6096,2021-01-27 20:05:00
6163,254,2,659,85,744,6097,2021-01-27 17:49:49
6164,254,2,659,85,744,6097,2021-01-27 17:49:49
6165,13,2,798,103,901,6098,2021-01-28 01:55:48
6166,914,3,727,94,821,6099,2021-01-28 02:43:56
6167,101,5,1475,191,1666,6100,2021-01-27 20:39:17
6168,307,3,1127,146,1273,6101,2021-01-28 02:19:16
6169,883,6,1705,221,1926,6102,2021-01-27 21:34:26
6170,860,2,429,55,484,6103,2021-01-27 20:20:08
6171,267,2,1098,142,1240,6104,2021-01-28 06:06:04
6172,92,3,597,77,674,6105,2021-01-28 04:49:16
6173,917,2,898,116,1014,6106,2021-01-27 22:21:42
6174,489,2,898,116,1014,6107,2021-01-28 00:55:47
6175,100,5,1206,156,1362,6108,2021-01-28 04:24:33
6176,807,3,428,55,483,6109,2021-01-27 13:59:02
6177,772,1,229,29,258,6110,2021-01-27 13:20:30
6178,924,2,798,103,901,6111,2021-01-27 08:19:06
6179,98,2,329,42,371,6112,2021-01-28 00:06:07
6180,115,3,558,72,630,6113,2021-01-28 03:19:25
6181,841,3,1027,133,1160,6114,2021-01-28 02:34:31
6182,958,3,997,129,1126,6115,2021-01-27 18:01:43
6183,442,3,727,94,821,6116,2021-01-27 08:51:12
6184,205,3,827,107,934,6117,2021-01-26 20:15:10
6185,692,3,758,98,856,6118,2021-01-27 01:43:48
6186,272,2,598,77,675,6119,2021-01-27 04:40:27
6187,950,3,528,68,596,6120,2021-01-26 21:28:53
6188,529,3,997,129,1126,6121,2021-01-27 04:31:08
6189,856,3,647,84,731,6122,2021-01-27 09:51:47
6190,68,3,697,90,787,6123,2021-01-27 06:38:58
6191,797,2,898,116,1014,6124,2021-01-27 11:44:51
6192,221,5,1576,204,1780,6125,2021-01-27 18:39:36
6193,733,2,928,120,1048,6126,2021-01-27 14:53:02
6194,633,6,1994,259,2253,6127,2021-01-27 19:15:10
6195,605,5,1317,171,1488,6128,2021-01-27 06:56:36
6196,452,3,428,55,483,6129,2021-01-27 04:01:29
6197,263,3,747,97,844,6130,2021-01-27 04:37:17
6198,942,3,827,107,934,6131,2021-01-27 13:07:21
6199,417,5,1117,145,1262,6132,2021-01-27 11:06:45
6200,229,3,727,94,821,6133,2021-01-28 18:21:45
6201,808,5,1276,165,1441,6134,2021-01-28 16:26:44
6202,808,1,399,51,450,6135,2021-01-28 15:24:21
6203,969,3,697,90,787,6136,2021-01-28 10:00:19
6204,60,1,229,29,258,6137,2021-01-28 04:49:06
6205,994,2,798,103,901,6138,2021-01-27 18:46:58
6206,702,3,528,68,596,6139,2021-01-27 18:19:02
6207,789,3,647,84,731,6140,2021-01-27 17:46:00
6208,296,6,1366,177,1543,6141,2021-01-27 22:05:22
6209,379,3,1047,136,1183,6142,2021-01-28 01:01:31
6210,616,5,976,126,1102,6143,2021-01-28 03:06:17
6211,680,3,1127,146,1273,6144,2021-01-28 13:13:12
6212,902,3,927,120,1047,6145,2021-01-28 16:43:01
6213,222,3,1047,136,1183,6146,2021-01-28 01:05:47
6214,293,3,997,129,1126,6147,2021-01-28 05:25:19
6215,583,2,898,116,1014,6148,2021-01-28 21:56:55
6216,649,3,997,129,1126,6149,2021-01-28 15:20:32
6217,13,2,459,59,518,6150,2021-01-29 00:26:13
6218,201,3,1327,172,1499,6151,2021-01-28 20:41:32
6219,915,2,598,77,675,6152,2021-01-28 20:28:35
6220,644,3,927,120,1047,6153,2021-01-28 10:56:10
6221,961,2,798,103,901,6154,2021-01-29 03:17:35
6222,4,6,1874,243,2117,6155,2021-01-29 02:07:34
6223,106,5,1395,181,1576,6156,2021-01-28 14:59:15
6224,465,2,598,77,675,6157,2021-01-28 09:44:18
6225,722,5,1456,189,1645,6158,2021-01-27 07:51:56
6226,678,3,528,68,596,6159,2021-01-27 23:47:53
6227,64,3,688,89,777,6160,2021-01-27 15:19:21
6228,30,3,1127,146,1273,6161,2021-01-27 16:27:12
6229,990,3,747,97,844,6162,2021-01-27 16:12:25
6230,622,3,688,89,777,6163,2021-01-27 17:56:32
6231,967,1,99,12,111,6164,2021-01-27 21:56:19
6232,441,3,528,68,596,6165,2021-01-27 18:43:40
6233,117,2,548,71,619,6166,2021-01-27 20:23:13
6234,375,2,828,107,935,6167,2021-01-28 03:03:49
6235,544,6,1974,256,2230,6168,2021-01-28 03:07:14
6236,17,2,528,68,596,6169,2021-01-27 22:00:55
6237,625,3,927,120,1047,6170,2021-01-28 04:22:37
6238,99,3,897,116,1013,6171,2021-01-27 23:44:58
6239,442,2,898,116,1014,6172,2021-01-27 20:34:39
6240,885,3,897,116,1013,6173,2021-01-28 06:54:24
6241,766,3,528,68,596,6174,2021-01-28 05:14:55
6242,795,4,1396,181,1577,6175,2021-01-28 00:08:59
6243,700,2,329,42,371,6176,2021-01-28 01:07:23
6244,73,6,1425,185,1610,6177,2021-01-28 05:53:08
6245,602,3,1047,136,1183,6178,2021-01-27 14:17:50
6246,95,3,747,97,844,6179,2021-01-27 15:27:28
6247,949,3,997,129,1126,6180,2021-01-27 10:19:33
6248,949,3,997,129,1126,6180,2021-01-27 10:19:33
6249,13,2,748,97,845,6181,2021-01-28 02:13:12
6250,531,5,1845,239,2084,6182,2021-01-28 04:01:38
6251,398,2,798,103,901,6183,2021-01-28 03:15:17
6252,13,3,647,84,731,6184,2021-01-27 20:27:08
6253,218,3,947,123,1070,6185,2021-01-27 08:56:27
6254,11,3,597,77,674,6186,2021-01-26 21:32:21
6255,948,1,229,29,258,6187,2021-01-27 03:31:12
6256,895,2,598,77,675,6188,2021-01-27 05:58:47
6257,839,6,1255,163,1418,6189,2021-01-26 22:24:34
6258,571,2,528,68,596,6190,2021-01-27 06:40:13
6259,188,2,1098,142,1240,6191,2021-01-27 11:16:38
6260,801,3,727,94,821,6192,2021-01-27 06:59:20
6261,273,1,499,64,563,6193,2021-01-27 12:52:49
6262,974,3,608,79,687,6194,2021-01-27 21:24:58
6263,37,3,697,90,787,6195,2021-01-27 15:15:05
6264,254,4,1946,252,2198,6196,2021-01-27 21:28:23
6265,266,2,598,77,675,6197,2021-01-27 07:22:31
6266,778,2,728,94,822,6198,2021-01-27 06:16:42
6267,553,3,647,84,731,6199,2021-01-27 07:06:48
6268,971,3,758,98,856,6200,2021-01-27 13:16:10
6269,953,2,329,42,371,6201,2021-01-27 12:46:29
6270,533,4,1346,174,1520,6202,2021-01-28 19:28:15
6271,975,2,698,90,788,6203,2021-01-28 16:31:42
6272,889,3,847,110,957,6204,2021-01-28 16:23:27
6273,528,2,798,103,901,6205,2021-01-28 10:50:13
6274,197,2,898,116,1014,6206,2021-01-28 04:52:53
6275,736,3,658,85,743,6207,2021-01-27 20:58:55
6276,460,6,1186,154,1340,6208,2021-01-27 20:17:05
6277,989,3,797,103,900,6209,2021-01-27 18:01:49
6278,173,3,658,85,743,6210,2021-01-28 00:47:28
6279,401,3,558,72,630,6211,2021-01-28 02:08:50
6280,919,3,808,105,913,6212,2021-01-28 04:14:21
6281,592,2,648,84,732,6213,2021-01-28 13:52:24
6282,711,2,728,94,822,6214,2021-01-28 19:15:47
6283,663,3,747,97,844,6215,2021-01-28 02:38:19
6284,796,2,698,90,788,6216,2021-01-28 06:06:46
6285,330,3,747,97,844,6217,2021-01-29 00:26:17
6286,25,3,608,79,687,6218,2021-01-28 17:51:37
6287,762,2,648,84,732,6219,2021-01-29 01:02:24
6288,95,3,997,129,1126,6220,2021-01-28 20:41:35
6289,346,4,1096,142,1238,6221,2021-01-28 21:26:34
6290,778,2,648,84,732,6222,2021-01-28 13:07:46
6291,350,2,329,42,371,6223,2021-01-29 06:02:05
6292,854,3,528,68,596,6224,2021-01-29 04:20:57
6293,107,2,898,116,1014,6225,2021-01-28 15:51:03
6294,800,2,928,120,1048,6226,2021-01-28 11:19:13
6295,706,3,847,110,957,6227,2021-01-27 09:58:27
6296,437,6,1385,180,1565,6228,2021-01-28 00:33:52
6297,339,3,658,85,743,6229,2021-01-27 17:52:41
6298,835,2,498,64,562,6230,2021-01-27 17:43:05
6299,910,1,499,64,563,6231,2021-01-27 18:03:52
6300,722,1,149,19,168,6232,2021-01-27 19:51:38
6301,931,3,797,103,900,6233,2021-01-27 22:14:28
6302,337,3,578,75,653,6234,2021-01-27 21:06:54
6303,265,2,329,42,371,6235,2021-01-27 22:15:29
6304,387,3,827,107,934,6236,2021-01-28 05:43:44
6305,387,3,827,107,934,6236,2021-01-28 05:43:44
6306,664,3,947,123,1070,6237,2021-01-28 03:50:29
6307,118,2,548,71,619,6238,2021-01-27 23:01:43
6308,118,2,548,71,619,6238,2021-01-27 23:01:43
6309,18,3,1047,136,1183,6239,2021-01-28 05:11:57
6310,253,3,997,129,1126,6240,2021-01-28 02:06:10
6311,786,3,808,105,913,6241,2021-01-27 22:34:16
6312,187,2,698,90,788,6242,2021-01-28 07:41:53
6313,508,3,697,90,787,6243,2021-01-28 05:15:21
6314,866,3,888,115,1003,6244,2021-01-28 00:47:24
6315,749,3,1027,133,1160,6245,2021-01-28 03:29:16
6316,267,3,1127,146,1273,6246,2021-01-28 06:05:48
6317,280,5,1076,139,1215,6247,2021-01-27 15:47:07
6318,326,3,558,72,630,6248,2021-01-27 18:00:29
6319,915,3,797,103,900,6249,2021-01-27 11:06:00
6320,343,3,1127,146,1273,6250,2021-01-27 11:16:36
6321,457,6,1474,191,1665,6251,2021-01-28 02:18:03
6322,365,2,429,55,484,6252,2021-01-28 04:06:20
6323,29,3,897,116,1013,6253,2021-01-28 03:45:21
6324,865,3,428,55,483,6254,2021-01-27 22:55:16
6325,953,2,1098,142,1240,6255,2021-01-27 09:06:57
6326,33,3,1197,155,1352,6256,2021-01-26 22:18:43
6327,905,2,659,85,744,6257,2021-01-27 05:48:12
6328,49,2,498,64,562,6258,2021-01-27 06:17:48
6329,842,6,1155,150,1305,6259,2021-01-26 22:30:22
6330,893,2,898,116,1014,6260,2021-01-27 09:01:55
6331,69,2,798,103,901,6261,2021-01-27 12:58:16
6332,11,2,659,85,744,6262,2021-01-27 07:48:54
6333,872,3,1327,172,1499,6263,2021-01-27 13:21:16
6334,12,6,1874,243,2117,6264,2021-01-27 23:23:58
6335,795,2,698,90,788,6265,2021-01-27 17:40:27
6336,943,3,1127,146,1273,6266,2021-01-27 23:26:07
6337,575,2,498,64,562,6267,2021-01-27 08:32:56
6338,798,6,986,128,1114,6268,2021-01-27 09:00:26
6339,774,3,597,77,674,6269,2021-01-27 09:36:08
6340,847,1,699,90,789,6270,2021-01-27 14:28:49
6341,184,3,1247,162,1409,6271,2021-01-27 13:27:45
6342,341,3,727,94,821,6272,2021-01-28 19:55:39
6343,739,3,528,68,596,6273,2021-01-28 16:53:36
6344,517,2,828,107,935,6274,2021-01-28 18:13:41
6345,776,2,898,116,1014,6275,2021-01-28 13:13:11
6346,4,4,1127,146,1273,6276,2021-01-28 07:22:53
6347,184,3,1247,162,1409,6277,2021-01-27 23:32:48
6348,802,5,1486,193,1679,6278,2021-01-27 21:11:53
6349,983,3,727,94,821,6279,2021-01-27 20:08:52
6350,135,2,1098,142,1240,6280,2021-01-28 02:16:41
6351,601,3,658,85,743,6281,2021-01-28 03:36:14
6352,551,3,697,90,787,6282,2021-01-28 04:48:04
6353,796,3,647,84,731,6283,2021-01-28 14:30:13
6354,608,3,758,98,856,6284,2021-01-28 20:48:12
6355,518,5,1545,200,1745,6285,2021-01-28 04:04:33
6356,380,3,747,97,844,6286,2021-01-28 07:14:25
6357,755,2,329,42,371,6287,2021-01-29 01:01:09
6358,421,3,727,94,821,6288,2021-01-28 18:39:19
6359,783,3,697,90,787,6289,2021-01-29 02:14:14
6360,737,3,697,90,787,6290,2021-01-28 23:02:13
6361,349,3,997,129,1126,6291,2021-01-28 22:08:14
6362,559,3,827,107,934,6292,2021-01-28 14:27:30
6363,2,2,429,55,484,6293,2021-01-29 07:40:12
6364,882,3,1247,162,1409,6294,2021-01-29 06:21:56
6365,12,3,888,115,1003,6295,2021-01-28 15:59:40
6366,656,2,598,77,675,6296,2021-01-28 12:43:31
6367,259,2,698,90,788,6297,2021-01-27 10:02:09
6368,596,3,888,115,1003,6298,2021-01-28 01:48:31
6369,545,3,1247,162,1409,6299,2021-01-27 18:31:37
6370,440,3,478,62,540,6300,2021-01-27 18:03:07
6371,385,3,847,110,957,6301,2021-01-27 20:21:45
6372,959,3,1327,172,1499,6302,2021-01-27 21:37:39
6373,421,2,429,55,484,6303,2021-01-27 22:17:53
6374,481,2,598,77,675,6304,2021-01-27 22:38:52
6375,940,5,1945,252,2197,6305,2021-01-28 00:49:59
6376,824,1,99,12,111,6306,2021-01-28 06:38:36
6377,846,2,448,58,506,6307,2021-01-28 08:11:50
6378,875,3,808,105,913,6308,2021-01-28 04:30:48
6379,102,3,608,79,687,6309,2021-01-28 00:14:59
6380,548,2,698,90,788,6310,2021-01-27 23:05:24
6381,80,2,598,77,675,6311,2021-01-28 07:43:32
6382,162,3,847,110,957,6312,2021-01-28 02:19:42
6383,669,3,1247,162,1409,6313,2021-01-28 00:18:16
6384,371,2,459,59,518,6314,2021-01-28 09:04:27
6385,521,5,1545,200,1745,6315,2021-01-28 05:39:35
6386,895,2,659,85,744,6316,2021-01-28 03:14:37
6387,148,2,728,94,822,6317,2021-01-28 05:32:45
6388,517,2,329,42,371,6318,2021-01-28 07:09:23
6389,812,2,698,90,788,6319,2021-01-27 17:00:42
6390,393,3,558,72,630,6320,2021-01-27 18:39:51
6391,506,3,697,90,787,6321,2021-01-27 11:51:35
6392,259,2,898,116,1014,6322,2021-01-27 12:43:12
6393,469,1,599,77,676,6323,2021-01-28 04:03:36
6394,474,1,229,29,258,6324,2021-01-28 06:33:01
6395,73,3,478,62,540,6325,2021-01-28 05:42:57
6396,545,3,1247,162,1409,6326,2021-01-27 23:08:08
6397,833,3,888,115,1003,6327,2021-01-27 11:24:08
6398,223,3,947,123,1070,6328,2021-01-26 23:31:28
6399,347,3,478,62,540,6329,2021-01-27 08:22:35
6400,431,1,229,29,258,6330,2021-01-27 08:25:08
6401,172,2,598,77,675,6331,2021-01-26 23:51:16
6402,94,2,698,90,788,6332,2021-01-27 10:32:56
6403,507,2,628,81,709,6333,2021-01-27 13:43:34
6404,400,6,1446,187,1633,6334,2021-01-27 08:01:17
6405,5,3,1127,146,1273,6335,2021-01-27 15:18:03
6406,451,3,758,98,856,6336,2021-01-28 02:07:02
6407,18,3,578,75,653,6337,2021-01-27 20:14:59
6408,170,3,578,75,653,6338,2021-01-27 23:32:26
6409,740,3,1027,133,1160,6339,2021-01-27 08:49:42
6410,711,3,827,107,934,6340,2021-01-27 09:26:43
6411,405,3,578,75,653,6341,2021-01-27 11:58:25
6412,394,3,797,103,900,6342,2021-01-27 16:16:46
6413,26,3,1127,146,1273,6343,2021-01-27 15:33:28
6414,623,6,2044,265,2309,6344,2021-01-28 22:30:50
6415,978,1,699,90,789,6345,2021-01-28 17:20:48
6416,38,3,578,75,653,6346,2021-01-28 18:19:00
6417,315,3,478,62,540,6347,2021-01-28 15:16:47
6418,224,3,997,129,1126,6348,2021-01-28 08:28:34
6419,623,3,528,68,596,6349,2021-01-28 01:40:34
6420,527,2,598,77,675,6350,2021-01-27 21:49:35
6421,942,1,399,51,450,6351,2021-01-27 21:02:52
6422,519,6,1305,169,1474,6352,2021-01-28 04:17:29
6423,607,2,459,59,518,6353,2021-01-28 03:48:53
6424,329,3,608,79,687,6354,2021-01-28 06:55:23
6425,356,2,898,116,1014,6355,2021-01-28 14:57:57
6426,634,4,1346,174,1520,6356,2021-01-28 22:44:18
6427,450,5,1256,163,1419,6357,2021-01-28 04:59:04
6428,996,3,1127,146,1273,6358,2021-01-28 08:50:35
6429,747,1,699,90,789,6359,2021-01-29 01:13:21
6430,657,3,1197,155,1352,6360,2021-01-28 20:00:12
6431,544,3,1327,172,1499,6361,2021-01-29 03:56:51
6432,942,1,399,51,450,6362,2021-01-28 23:26:14
6433,618,3,797,103,900,6363,2021-01-29 00:46:49
6434,497,3,1047,136,1183,6364,2021-01-28 15:34:49
6435,412,3,1127,146,1273,6365,2021-01-29 08:51:54
6436,257,3,1327,172,1499,6366,2021-01-29 07:26:54
6437,754,4,1007,130,1137,6367,2021-01-28 16:47:53
6438,802,3,1047,136,1183,6368,2021-01-28 14:58:05
6439,614,6,1505,195,1700,6369,2021-01-27 12:46:50
6440,134,3,597,77,674,6370,2021-01-28 03:57:25
6441,411,3,758,98,856,6371,2021-01-27 20:58:45
6442,908,3,1197,155,1352,6372,2021-01-27 19:03:35
6443,555,3,1247,162,1409,6373,2021-01-27 20:47:31
6444,329,3,808,105,913,6374,2021-01-27 22:04:41
6445,602,3,478,62,540,6375,2021-01-27 23:22:42
6446,602,3,478,62,540,6375,2021-01-27 23:22:42
6447,62,6,1555,202,1757,6376,2021-01-28 00:22:59
6448,56,3,578,75,653,6377,2021-01-28 02:29:11
6449,848,2,329,42,371,6378,2021-01-28 08:05:59
6450,730,3,578,75,653,6379,2021-01-28 10:24:47
6451,394,3,1047,136,1183,6380,2021-01-28 05:54:30
6452,411,5,1895,246,2141,6381,2021-01-28 01:00:35
6453,24,2,329,42,371,6382,2021-01-28 00:30:41
6454,151,3,947,123,1070,6383,2021-01-28 08:06:12
6455,201,3,997,129,1126,6384,2021-01-28 03:31:37
6456,205,3,747,97,844,6385,2021-01-28 01:56:22
6457,744,5,1126,146,1272,6386,2021-01-28 09:09:12
6458,640,3,808,105,913,6387,2021-01-28 08:14:17
6459,875,1,499,64,563,6388,2021-01-28 03:44:49
6460,33,3,1027,133,1160,6389,2021-01-28 07:43:46
6461,399,3,558,72,630,6390,2021-01-28 09:16:53
6462,425,3,1027,133,1160,6391,2021-01-27 19:02:23
6463,194,3,727,94,821,6392,2021-01-27 19:25:43
6464,749,2,429,55,484,6393,2021-01-27 13:46:49
6465,450,2,498,64,562,6394,2021-01-27 14:54:44
6466,91,2,429,55,484,6395,2021-01-28 05:19:07
6467,14,4,1457,189,1646,6396,2021-01-28 09:10:41
6468,799,2,548,71,619,6397,2021-01-28 08:16:17
6469,716,3,1047,136,1183,6398,2021-01-28 01:41:04
6470,440,5,1295,168,1463,6399,2021-01-27 12:07:03
6471,750,2,598,77,675,6400,2021-01-27 01:10:04
6472,983,2,698,90,788,6401,2021-01-27 10:15:24
6473,331,3,558,72,630,6402,2021-01-27 08:55:47
6474,994,2,628,81,709,6403,2021-01-27 00:21:55
6475,971,3,688,89,777,6404,2021-01-27 11:44:38
6476,183,2,598,77,675,6405,2021-01-27 14:03:37
6477,477,5,1226,159,1385,6406,2021-01-27 10:13:40
6478,502,3,1197,155,1352,6407,2021-01-27 15:36:07
6479,647,3,1047,136,1183,6408,2021-01-28 02:17:16
6480,273,3,897,116,1013,6409,2021-01-27 22:38:41
6481,916,3,997,129,1126,6410,2021-01-27 23:38:42
6482,802,3,1247,162,1409,6411,2021-01-27 09:58:48
6483,782,2,798,103,901,6412,2021-01-27 10:39:29
6484,789,3,1327,172,1499,6413,2021-01-27 12:46:07
6485,593,6,1305,169,1474,6414,2021-01-27 18:46:46
6486,499,3,688,89,777,6415,2021-01-27 17:32:50
6487,928,2,598,77,675,6416,2021-01-28 23:17:32
6488,117,2,528,68,596,6417,2021-01-28 17:48:36
6489,682,6,1874,243,2117,6418,2021-01-28 18:28:43
6490,641,2,598,77,675,6419,2021-01-28 17:07:55
6491,371,3,1327,172,1499,6420,2021-01-28 10:11:02
6492,325,2,898,116,1014,6421,2021-01-28 02:57:47
6493,443,3,797,103,900,6422,2021-01-27 22:41:22
6494,890,2,659,85,744,6423,2021-01-27 22:50:08
6495,878,2,459,59,518,6424,2021-01-28 06:50:36
6496,801,6,2024,263,2287,6425,2021-01-28 04:51:10
6497,656,2,459,59,518,6426,2021-01-28 08:36:11
6498,888,3,758,98,856,6427,2021-01-28 17:36:29
6499,191,3,578,75,653,6428,2021-01-29 00:54:32
6500,785,5,1026,133,1159,6429,2021-01-28 05:04:30
6501,376,2,628,81,709,6430,2021-01-28 09:49:37
6502,865,3,1247,162,1409,6431,2021-01-29 03:04:08
6503,354,2,548,71,619,6432,2021-01-28 21:26:35
6504,50,2,429,55,484,6433,2021-01-29 04:27:08
6505,400,3,688,89,777,6434,2021-01-28 23:29:43
6506,122,4,1088,141,1229,6435,2021-01-29 03:28:37
6507,703,6,1824,237,2061,6436,2021-01-28 18:15:47
6508,500,3,797,103,900,6437,2021-01-29 11:37:09
6509,457,2,798,103,901,6438,2021-01-29 07:44:01
6510,308,3,827,107,934,6439,2021-01-28 18:28:19
6511,828,3,528,68,596,6440,2021-01-28 16:49:36
6512,154,2,429,55,484,6441,2021-01-27 12:54:06
6513,15,4,1157,150,1307,6442,2021-01-28 06:04:26
6514,306,6,1086,141,1227,6443,2021-01-27 21:25:43
6515,797,3,1197,155,1352,6444,2021-01-27 20:33:04
6516,490,6,1225,159,1384,6445,2021-01-27 21:07:26
6517,916,3,947,123,1070,6446,2021-01-27 22:46:29
6518,237,3,888,115,1003,6447,2021-01-28 00:08:33
6519,408,3,808,105,913,6448,2021-01-28 01:57:45
6520,349,2,1098,142,1240,6449,2021-01-28 01:04:07
6521,814,3,888,115,1003,6450,2021-01-28 04:14:42
6522,198,3,697,90,787,6451,2021-01-28 10:01:38
6523,445,3,697,90,787,6452,2021-01-28 12:55:51
6524,493,3,797,103,900,6453,2021-01-28 07:23:09
6525,14,6,1844,239,2083,6454,2021-01-28 02:40:55
6526,229,2,429,55,484,6455,2021-01-28 02:52:59
6527,841,3,1197,155,1352,6456,2021-01-28 08:58:25
6528,748,3,428,55,483,6457,2021-01-28 04:09:12
6529,168,1,229,29,258,6458,2021-01-28 03:30:45
6530,213,1,299,38,337,6459,2021-01-28 11:40:12
6531,721,2,698,90,788,6460,2021-01-28 10:44:57
6532,373,3,597,77,674,6461,2021-01-28 05:55:42
6533,533,2,698,90,788,6462,2021-01-28 08:17:34
6534,717,2,429,55,484,6463,2021-01-28 09:55:33
6535,722,3,947,123,1070,6464,2021-01-27 19:23:42
6536,971,1,399,51,450,6465,2021-01-27 21:07:49
6537,179,3,1027,133,1160,6466,2021-01-27 16:24:07
6538,535,3,997,129,1126,6467,2021-01-27 15:44:22
6539,970,2,898,116,1014,6468,2021-01-28 06:46:22
6540,173,2,548,71,619,6469,2021-01-28 11:48:56
6541,539,2,928,120,1048,6470,2021-01-28 10:57:06
6542,665,3,758,98,856,6471,2021-01-28 02:23:42
6543,497,2,548,71,619,6472,2021-01-27 12:32:43
6544,367,3,608,79,687,6473,2021-01-27 03:20:34
6545,334,1,399,51,450,6474,2021-01-27 12:53:23
6546,568,2,448,58,506,6475,2021-01-27 10:52:07
6547,51,2,659,85,744,6476,2021-01-27 02:45:18
6548,930,3,997,129,1126,6477,2021-01-27 13:39:46
6549,111,3,1327,172,1499,6478,2021-01-27 15:27:29
6550,195,2,898,116,1014,6479,2021-01-27 12:20:22
6551,356,3,727,94,821,6480,2021-01-27 18:03:01
6552,324,3,797,103,900,6481,2021-01-28 03:48:34
6553,368,3,428,55,483,6482,2021-01-28 01:04:39
6554,399,1,229,29,258,6483,2021-01-28 00:14:13
6555,606,2,459,59,518,6484,2021-01-27 12:38:20
6556,377,3,1127,146,1273,6485,2021-01-27 12:21:42
6557,845,5,1575,204,1779,6486,2021-01-27 14:20:10
6558,759,3,688,89,777,6487,2021-01-27 19:14:45
6559,609,3,1127,146,1273,6488,2021-01-27 18:54:15
6560,5,3,997,129,1126,6489,2021-01-28 23:44:31
6561,776,3,688,89,777,6490,2021-01-28 18:15:46
6562,30,3,1047,136,1183,6491,2021-01-28 21:10:07
6563,44,3,997,129,1126,6492,2021-01-28 18:37:52
6564,200,2,498,64,562,6493,2021-01-28 12:54:38
6565,492,2,898,116,1014,6494,2021-01-28 05:19:37
6566,693,1,399,51,450,6495,2021-01-28 00:02:11
6567,23,3,947,123,1070,6496,2021-01-27 23:18:01
6568,295,6,1885,245,2130,6497,2021-01-28 07:22:47
6569,764,2,698,90,788,6498,2021-01-28 05:55:54
6570,526,2,498,64,562,6499,2021-01-28 10:19:33
6571,575,4,1296,168,1464,6500,2021-01-28 19:05:21
6572,951,3,897,116,1013,6501,2021-01-29 03:26:13
6573,80,3,747,97,844,6502,2021-01-28 06:06:25
6574,975,3,658,85,743,6503,2021-01-28 12:34:55
6575,804,5,1656,215,1871,6504,2021-01-29 04:59:51
6576,975,6,1844,239,2083,6505,2021-01-28 23:35:12
6577,860,4,1176,152,1328,6506,2021-01-29 06:31:11
6578,111,2,1098,142,1240,6507,2021-01-29 00:09:45
6579,729,2,548,71,619,6508,2021-01-29 05:19:33
6580,818,3,697,90,787,6509,2021-01-28 18:30:29
6581,476,3,1127,146,1273,6510,2021-01-29 13:27:54
6582,171,2,698,90,788,6511,2021-01-29 09:16:54
6583,325,3,997,129,1126,6512,2021-01-28 18:31:06
6584,60,2,429,55,484,6513,2021-01-28 18:15:22
6585,904,2,698,90,788,6514,2021-01-27 13:24:28
6586,843,3,558,72,630,6515,2021-01-28 06:13:37
6587,855,4,1126,146,1272,6516,2021-01-27 23:35:32
6588,232,1,399,51,450,6517,2021-01-27 21:51:52
6589,40,5,1545,200,1745,6518,2021-01-27 23:31:43
6590,721,3,727,94,821,6519,2021-01-27 23:33:45
6591,606,3,747,97,844,6520,2021-01-28 02:44:19
6592,416,2,598,77,675,6521,2021-01-28 03:23:06
6593,590,3,947,123,1070,6522,2021-01-28 02:36:38
6594,288,2,659,85,744,6523,2021-01-28 05:42:52
6595,6,5,1326,172,1498,6524,2021-01-28 12:42:05
6596,961,3,1097,142,1239,6525,2021-01-28 15:22:51
6597,832,3,847,110,957,6526,2021-01-28 08:44:52
6598,718,3,727,94,821,6527,2021-01-28 03:54:27
6599,731,3,1127,146,1273,6528,2021-01-28 05:24:27
6600,42,2,598,77,675,6529,2021-01-28 10:03:48
6601,832,3,888,115,1003,6530,2021-01-28 06:01:01
6602,736,3,897,116,1013,6531,2021-01-28 03:31:38
6603,540,1,699,90,789,6532,2021-01-28 12:55:28
6604,781,2,598,77,675,6533,2021-01-28 13:24:21
6605,739,3,558,72,630,6534,2021-01-28 08:04:25
6606,79,3,428,55,483,6535,2021-01-28 09:03:30
6607,369,2,659,85,744,6536,2021-01-28 11:00:33
6608,265,3,1327,172,1499,6537,2021-01-27 21:50:40
6609,270,3,827,107,934,6538,2021-01-27 21:23:25
6610,787,3,897,116,1013,6539,2021-01-27 18:05:04
6611,200,2,628,81,709,6540,2021-01-27 17:16:03
6612,362,3,747,97,844,6541,2021-01-28 07:29:17
6613,345,3,797,103,900,6542,2021-01-28 12:43:06
6614,700,6,1415,183,1598,6543,2021-01-28 11:14:10
6615,136,5,1267,164,1431,6544,2021-01-28 02:29:23
6616,5,6,1954,254,2208,6545,2021-01-27 14:56:34
6617,722,6,1874,243,2117,6546,2021-01-27 05:12:30
6618,909,3,478,62,540,6547,2021-01-27 13:28:58
6619,761,3,758,98,856,6548,2021-01-27 13:09:44
6620,904,1,499,64,563,6549,2021-01-27 02:58:18
6621,411,3,997,129,1126,6550,2021-01-27 14:51:43
6622,779,5,1645,213,1858,6551,2021-01-27 17:05:20
6623,87,2,798,103,901,6552,2021-01-27 14:40:50
6624,389,2,598,77,675,6553,2021-01-27 19:47:55
6625,957,3,997,129,1126,6554,2021-01-28 06:29:53
6626,42,3,688,89,777,6555,2021-01-28 03:22:20
6627,560,2,659,85,744,6556,2021-01-28 01:06:16
6628,90,3,578,75,653,6557,2021-01-27 13:33:47
6629,52,3,797,103,900,6558,2021-01-27 13:12:58
6630,77,3,608,79,687,6559,2021-01-27 15:39:02
6631,151,4,1246,161,1407,6560,2021-01-27 19:33:30
6632,190,2,459,59,518,6561,2021-01-27 20:29:28
6633,216,3,1047,136,1183,6562,2021-01-29 01:12:02
6634,16,3,997,129,1126,6563,2021-01-28 19:04:04
6635,843,1,229,29,258,6564,2021-01-28 21:20:28
6636,388,2,398,51,449,6565,2021-01-28 21:02:28
6637,287,3,1047,136,1183,6566,2021-01-28 13:41:17
6638,810,1,299,38,337,6567,2021-01-28 06:14:18
6639,930,2,1098,142,1240,6568,2021-01-28 01:17:24
6640,784,3,1047,136,1183,6569,2021-01-28 01:16:33
6641,402,3,747,97,844,6570,2021-01-28 08:25:41
6642,492,3,927,120,1047,6571,2021-01-28 08:18:32
6643,344,3,1197,155,1352,6572,2021-01-28 11:23:47
6644,910,2,628,81,709,6573,2021-01-28 21:25:53
6645,860,2,1098,142,1240,6574,2021-01-29 05:34:20
6646,679,3,758,98,856,6575,2021-01-28 06:39:34
6647,634,3,688,89,777,6576,2021-01-28 13:59:45
6648,100,5,1406,182,1588,6577,2021-01-29 07:18:59
6649,966,3,1327,172,1499,6578,2021-01-29 01:40:33
6650,786,3,697,90,787,6579,2021-01-29 08:45:08
6651,821,3,428,55,483,6580,2021-01-29 02:12:52
6652,298,3,727,94,821,6581,2021-01-29 05:20:27
6653,696,3,478,62,540,6582,2021-01-28 19:36:19
6654,718,2,598,77,675,6583,2021-01-29 14:01:24
6655,712,2,798,103,901,6584,2021-01-29 11:57:35
6656,263,2,548,71,619,6585,2021-01-28 19:54:56
6657,302,2,429,55,484,6586,2021-01-28 19:54:50
6658,289,3,947,123,1070,6587,2021-01-27 13:59:41
6659,285,2,898,116,1014,6588,2021-01-28 06:22:08
6660,91,3,888,115,1003,6589,2021-01-28 02:14:55
6661,454,2,598,77,675,6590,2021-01-27 23:36:55
6662,780,2,798,103,901,6591,2021-01-28 00:50:40
6663,971,2,798,103,901,6592,2021-01-28 00:33:20
6664,733,2,498,64,562,6593,2021-01-28 05:13:45
6665,226,3,697,90,787,6594,2021-01-28 03:41:42
6666,538,5,1126,146,1272,6595,2021-01-28 04:52:46
6667,811,3,808,105,913,6596,2021-01-28 07:48:46
6668,214,3,688,89,777,6597,2021-01-28 13:50:24
6669,696,3,997,129,1126,6598,2021-01-28 16:19:46
6670,880,6,1944,252,2196,6599,2021-01-28 10:15:31
6671,290,3,1127,146,1273,6600,2021-01-28 06:02:45
6672,330,2,648,84,732,6601,2021-01-28 06:48:07
6673,828,1,499,64,563,6602,2021-01-28 12:27:40
6674,858,3,1047,136,1183,6603,2021-01-28 06:34:02
6675,231,3,747,97,844,6604,2021-01-28 06:14:47
6676,153,3,647,84,731,6605,2021-01-28 14:42:47
6677,363,3,658,85,743,6606,2021-01-28 15:33:00
6678,55,3,697,90,787,6607,2021-01-28 09:17:15
6679,47,3,1047,136,1183,6608,2021-01-28 11:12:54
6680,715,3,727,94,821,6609,2021-01-28 13:44:48
6681,639,3,608,79,687,6610,2021-01-27 22:29:38
6682,409,2,459,59,518,6611,2021-01-27 21:25:26
6683,631,3,1027,133,1160,6612,2021-01-27 18:36:54
6684,757,3,1247,162,1409,6613,2021-01-27 17:47:28
6685,652,5,1186,154,1340,6614,2021-01-28 09:34:03
6686,82,6,1525,198,1723,6615,2021-01-28 13:58:22
6687,670,3,597,77,674,6616,2021-01-28 13:04:55
6688,417,2,498,64,562,6617,2021-01-28 03:43:20
6689,646,2,329,42,371,6618,2021-01-27 16:18:58
6690,165,3,697,90,787,6619,2021-01-27 05:52:42
6691,582,3,597,77,674,6620,2021-01-27 13:53:45
6692,108,3,727,94,821,6621,2021-01-27 14:02:29
6693,775,3,1127,146,1273,6622,2021-01-27 04:31:11
6694,214,2,648,84,732,6623,2021-01-27 17:23:00
6695,214,2,648,84,732,6623,2021-01-27 17:23:00
6696,764,2,429,55,484,6624,2021-01-27 19:18:04
6697,318,5,1256,163,1419,6625,2021-01-27 15:07:55
6698,905,3,947,123,1070,6626,2021-01-27 21:08:12
6699,38,3,558,72,630,6627,2021-01-28 08:31:11
6700,204,3,947,123,1070,6628,2021-01-28 05:16:16
6701,971,2,659,85,744,6629,2021-01-28 03:08:51
6702,989,4,1346,174,1520,6630,2021-01-27 13:37:16
6703,944,2,1098,142,1240,6631,2021-01-27 14:55:17
6704,10,3,888,115,1003,6632,2021-01-27 15:41:26
6705,524,3,888,115,1003,6633,2021-01-27 20:42:07
6706,483,3,888,115,1003,6634,2021-01-27 20:45:58
6707,226,3,1327,172,1499,6635,2021-01-29 01:49:07
6708,226,3,1327,172,1499,6635,2021-01-29 01:49:07
6709,228,3,697,90,787,6636,2021-01-28 19:24:19
6710,504,3,578,75,653,6637,2021-01-28 21:49:13
6711,431,3,647,84,731,6638,2021-01-28 23:11:46
6712,336,6,2244,291,2535,6639,2021-01-28 14:28:10
6713,944,2,598,77,675,6640,2021-01-28 06:54:29
6714,259,3,727,94,821,6641,2021-01-28 03:43:05
6715,241,3,827,107,934,6642,2021-01-28 03:54:04
6716,709,3,578,75,653,6643,2021-01-28 10:32:04
6717,776,3,1247,162,1409,6644,2021-01-28 10:06:04
6718,495,2,459,59,518,6645,2021-01-28 13:28:44
6719,662,5,1495,194,1689,6646,2021-01-29 00:01:53
6720,845,3,997,129,1126,6647,2021-01-29 06:10:56
6721,836,3,1047,136,1183,6648,2021-01-28 06:48:03
6722,624,3,597,77,674,6649,2021-01-28 14:52:19
6723,618,3,888,115,1003,6650,2021-01-29 08:18:00
6724,567,2,598,77,675,6651,2021-01-29 04:26:53
6725,725,3,597,77,674,6652,2021-01-29 08:45:08
6726,57,3,578,75,653,6653,2021-01-29 03:52:00
6727,899,5,1626,211,1837,6654,2021-01-29 07:41:54
6728,431,5,1625,211,1836,6655,2021-01-28 21:16:18
6729,466,2,798,103,901,6656,2021-01-29 15:43:05
6730,78,3,1127,146,1273,6657,2021-01-29 12:52:34
6731,237,3,697,90,787,6658,2021-01-28 20:39:51
6732,710,2,429,55,484,6659,2021-01-28 21:25:22
6733,211,2,928,120,1048,6660,2021-01-27 15:58:39
6734,561,1,599,77,676,6661,2021-01-28 08:50:06
6735,142,3,747,97,844,6662,2021-01-28 04:23:03
6736,275,3,927,120,1047,6663,2021-01-27 23:44:28
6737,467,3,808,105,913,6664,2021-01-28 01:04:58
6738,852,3,1047,136,1183,6665,2021-01-28 02:00:13
6739,133,3,558,72,630,6666,2021-01-28 06:23:44
6740,911,5,1586,206,1792,6667,2021-01-28 04:51:01
6741,598,3,947,123,1070,6668,2021-01-28 06:18:48
6742,755,2,1098,142,1240,6669,2021-01-28 10:03:23
6743,314,2,329,42,371,6670,2021-01-28 14:50:29
6744,421,2,698,90,788,6671,2021-01-28 17:41:43
6745,441,4,1196,155,1351,6672,2021-01-28 10:42:57
6746,989,1,699,90,789,6673,2021-01-28 06:29:37
6747,12,5,2145,278,2423,6674,2021-01-28 09:22:49
6748,558,3,747,97,844,6675,2021-01-28 14:47:28
6749,281,6,2324,302,2626,6676,2021-01-28 07:36:23
6750,1000,2,898,116,1014,6677,2021-01-28 08:15:57
6751,976,3,1247,162,1409,6678,2021-01-28 17:02:54
6752,155,2,659,85,744,6679,2021-01-28 17:56:20
6753,323,2,628,81,709,6680,2021-01-28 11:11:20
6754,720,3,1127,146,1273,6681,2021-01-28 12:37:32
6755,798,3,927,120,1047,6682,2021-01-28 15:08:05
6756,447,3,558,72,630,6683,2021-01-28 00:58:20
6757,450,2,698,90,788,6684,2021-01-27 22:02:45
6758,357,1,299,38,337,6685,2021-01-27 19:25:21
6759,490,5,1406,182,1588,6686,2021-01-27 18:55:30
6760,172,3,478,62,540,6687,2021-01-28 12:03:44
6761,990,1,99,12,111,6688,2021-01-28 16:29:23
6762,393,5,1845,239,2084,6689,2021-01-28 14:22:45
6763,656,3,697,90,787,6690,2021-01-28 04:08:18
6764,366,3,827,107,934,6691,2021-01-27 16:47:02
6765,244,1,699,90,789,6692,2021-01-27 07:18:30
6766,648,5,1445,187,1632,6693,2021-01-27 14:29:15
6767,837,3,927,120,1047,6694,2021-01-27 14:22:57
6768,325,3,578,75,653,6695,2021-01-27 05:49:41
6769,795,6,2224,289,2513,6696,2021-01-27 17:24:45
6770,137,3,528,68,596,6697,2021-01-27 19:17:03
6771,573,3,428,55,483,6698,2021-01-27 22:03:24
6772,732,2,548,71,619,6699,2021-01-27 15:11:02
6773,836,2,898,116,1014,6700,2021-01-27 23:17:54
6774,88,3,697,90,787,6701,2021-01-28 09:39:04
6775,858,3,1047,136,1183,6702,2021-01-28 05:37:37
6776,50,5,1325,172,1497,6703,2021-01-28 04:37:36
6777,912,2,698,90,788,6704,2021-01-27 14:06:10
6778,663,4,1296,168,1464,6705,2021-01-27 17:31:34
6779,708,2,329,42,371,6706,2021-01-27 17:54:13
6780,104,3,1247,162,1409,6707,2021-01-27 22:35:13
6781,982,3,1047,136,1183,6708,2021-01-27 21:47:12
6782,702,3,478,62,540,6709,2021-01-29 03:30:15
6783,845,3,558,72,630,6710,2021-01-29 02:34:03
6784,967,2,598,77,675,6711,2021-01-28 22:07:25
6785,348,5,1486,193,1679,6712,2021-01-29 00:01:34
6786,204,2,798,103,901,6713,2021-01-29 00:10:36
6787,681,3,608,79,687,6714,2021-01-28 15:35:55
6788,840,2,498,64,562,6715,2021-01-28 09:39:02
6789,27,3,1327,172,1499,6716,2021-01-28 04:23:33
6790,217,2,798,103,901,6717,2021-01-28 04:02:46
6791,804,2,548,71,619,6718,2021-01-28 10:43:30
6792,30,5,1575,204,1779,6719,2021-01-28 11:51:53
6793,248,3,847,110,957,6720,2021-01-28 14:05:41
6794,189,2,329,42,371,6721,2021-01-29 02:36:53
6795,350,3,558,72,630,6722,2021-01-29 08:05:11
6796,80,3,1127,146,1273,6723,2021-01-28 09:21:42
6797,569,3,888,115,1003,6724,2021-01-28 16:40:08
6798,519,5,1226,159,1385,6725,2021-01-29 10:55:18
6799,718,3,1127,146,1273,6726,2021-01-29 06:51:47
6800,345,2,698,90,788,6727,2021-01-29 10:28:56
6801,431,3,1127,146,1273,6728,2021-01-29 04:24:28
6802,582,3,1327,172,1499,6729,2021-01-29 10:25:25
6803,380,6,1924,250,2174,6730,2021-01-28 23:01:41
6804,389,3,897,116,1013,6731,2021-01-29 18:06:40
6805,426,3,827,107,934,6732,2021-01-29 13:50:05
6806,98,4,1257,163,1420,6733,2021-01-28 21:13:55
6807,679,5,1825,237,2062,6734,2021-01-28 23:30:18
6808,141,4,1146,148,1294,6735,2021-01-27 18:07:34
6809,421,3,428,55,483,6736,2021-01-28 10:18:02
6810,461,3,847,110,957,6737,2021-01-28 04:51:40
6811,711,5,1706,221,1927,6738,2021-01-28 02:17:02
6812,815,3,997,129,1126,6739,2021-01-28 02:34:51
6813,984,4,1257,163,1420,6740,2021-01-28 02:17:13
6814,579,2,1098,142,1240,6741,2021-01-28 07:06:13
6815,359,6,1644,213,1857,6742,2021-01-28 06:53:56
6816,125,3,997,129,1126,6743,2021-01-28 07:26:34
6817,243,2,448,58,506,6744,2021-01-28 10:03:54
6818,528,3,1197,155,1352,6745,2021-01-28 16:26:03
6819,200,3,597,77,674,6746,2021-01-28 18:42:46
6820,621,3,1127,146,1273,6747,2021-01-28 12:57:26
6821,628,3,827,107,934,6748,2021-01-28 06:39:03
6822,975,3,927,120,1047,6749,2021-01-28 11:10:52
6823,398,2,1098,142,1240,6750,2021-01-28 15:12:37
6824,228,2,598,77,675,6751,2021-01-28 07:50:45
6825,999,3,578,75,653,6752,2021-01-28 09:34:35
6826,794,2,429,55,484,6753,2021-01-28 18:36:33
6827,95,3,658,85,743,6754,2021-01-28 18:34:33
6828,349,2,848,110,958,6755,2021-01-28 13:52:56
6829,486,6,1455,189,1644,6756,2021-01-28 13:44:22
6830,491,2,598,77,675,6757,2021-01-28 17:32:47
6831,46,3,647,84,731,6758,2021-01-28 01:18:04
6832,370,2,598,77,675,6759,2021-01-27 22:06:01
6833,835,3,727,94,821,6760,2021-01-27 20:06:31
6834,134,2,459,59,518,6761,2021-01-27 21:07:40
6835,777,3,428,55,483,6762,2021-01-28 12:32:21
6836,616,1,399,51,450,6763,2021-01-28 18:42:11
6837,480,3,827,107,934,6764,2021-01-28 15:46:43
6838,491,3,1197,155,1352,6765,2021-01-28 05:33:10
6839,771,5,1555,202,1757,6766,2021-01-27 17:18:38
6840,670,3,927,120,1047,6767,2021-01-27 08:47:11
6841,551,3,1327,172,1499,6768,2021-01-27 16:13:38
6842,481,2,329,42,371,6769,2021-01-27 14:48:58
6843,424,2,429,55,484,6770,2021-01-27 05:57:38
6844,27,3,697,90,787,6771,2021-01-27 18:10:38
6845,605,2,459,59,518,6772,2021-01-27 19:50:40
6846,627,3,997,129,1126,6773,2021-01-28 00:21:21
6847,702,3,727,94,821,6774,2021-01-27 15:49:28
6848,766,4,1596,207,1803,6775,2021-01-28 00:20:36
6849,675,6,1974,256,2230,6776,2021-01-28 10:02:34
6850,1,3,1327,172,1499,6777,2021-01-28 06:01:29
6851,567,1,499,64,563,6778,2021-01-28 06:33:49
6852,486,3,897,116,1013,6779,2021-01-27 14:58:40
6853,340,2,898,116,1014,6780,2021-01-27 17:47:39
6854,62,1,149,19,168,6781,2021-01-27 19:41:10
6855,234,5,1495,194,1689,6782,2021-01-28 00:54:59
6856,426,3,697,90,787,6783,2021-01-27 22:48:25
6857,682,4,1257,163,1420,6784,2021-01-29 04:48:16
6858,145,2,598,77,675,6785,2021-01-29 04:55:07
6859,138,3,897,116,1013,6786,2021-01-28 22:37:34
6860,287,3,847,110,957,6787,2021-01-29 01:09:24
6861,521,5,1376,178,1554,6788,2021-01-29 02:33:04
6862,87,3,758,98,856,6789,2021-01-28 16:15:09
6863,935,2,698,90,788,6790,2021-01-28 10:36:55
6864,475,1,99,12,111,6791,2021-01-28 06:10:00
6865,217,2,898,116,1014,6792,2021-01-28 05:39:34
6866,681,3,727,94,821,6793,2021-01-28 13:16:21
6867,120,3,747,97,844,6794,2021-01-28 14:36:36
6868,275,2,498,64,562,6795,2021-01-28 16:48:01
6869,312,2,798,103,901,6796,2021-01-29 03:02:11
6870,374,3,1027,133,1160,6797,2021-01-29 10:44:11
6871,686,1,99,12,111,6798,2021-01-28 11:49:31
6872,853,4,1646,213,1859,6799,2021-01-28 17:32:45
6873,185,4,1177,153,1330,6800,2021-01-29 13:20:44
6874,630,2,628,81,709,6801,2021-01-29 07:23:50
6875,475,3,747,97,844,6802,2021-01-29 13:11:16
6876,365,3,658,85,743,6803,2021-01-29 05:11:51
6877,132,3,1047,136,1183,6804,2021-01-29 12:00:32
6878,851,2,898,116,1014,6805,2021-01-29 01:06:11
6879,534,3,1047,136,1183,6806,2021-01-29 19:45:08
6880,367,3,658,85,743,6807,2021-01-29 13:58:58
6881,152,1,99,12,111,6808,2021-01-28 23:59:20
6882,332,4,1446,187,1633,6809,2021-01-29 01:49:16
6883,214,3,697,90,787,6810,2021-01-27 19:51:23
6884,3,3,1047,136,1183,6811,2021-01-28 11:02:16
6885,597,2,498,64,562,6812,2021-01-28 07:02:19
6886,505,3,1127,146,1273,6813,2021-01-28 04:10:37
6887,370,3,827,107,934,6814,2021-01-28 05:17:11
6888,441,1,99,12,111,6815,2021-01-28 02:46:10
6889,935,2,659,85,744,6816,2021-01-28 08:55:51
6890,38,2,898,116,1014,6817,2021-01-28 08:33:16
6891,678,3,428,55,483,6818,2021-01-28 09:40:19
6892,730,2,598,77,675,6819,2021-01-28 10:12:30
6893,454,2,659,85,744,6820,2021-01-28 18:41:55
6894,514,3,888,115,1003,6821,2021-01-28 19:54:25
6895,293,2,329,42,371,6822,2021-01-28 14:05:06
6896,854,3,747,97,844,6823,2021-01-28 06:44:50
6897,76,3,578,75,653,6824,2021-01-28 11:51:35
6898,93,2,1098,142,1240,6825,2021-01-28 16:01:05
6899,388,2,329,42,371,6826,2021-01-28 10:24:25
6900,926,3,558,72,630,6827,2021-01-28 12:13:59
6901,918,2,598,77,675,6828,2021-01-28 19:40:47
6902,877,3,997,129,1126,6829,2021-01-28 19:43:52
6903,451,3,428,55,483,6830,2021-01-28 15:49:52
6904,181,3,558,72,630,6831,2021-01-28 14:38:48
6905,384,4,1526,198,1724,6832,2021-01-28 19:12:56
6906,65,5,1325,172,1497,6833,2021-01-28 02:16:24
6907,454,3,808,105,913,6834,2021-01-28 00:10:47
6908,734,3,697,90,787,6835,2021-01-27 21:10:57
6909,98,1,499,64,563,6836,2021-01-27 22:25:12
6910,184,3,1047,136,1183,6837,2021-01-28 13:28:03
6911,693,3,647,84,731,6838,2021-01-28 19:03:10
6912,137,2,698,90,788,6839,2021-01-28 15:55:18
6913,298,3,847,110,957,6840,2021-01-28 05:34:53
6914,128,3,827,107,934,6841,2021-01-27 17:32:13
6915,305,3,558,72,630,6842,2021-01-27 10:35:18
6916,758,4,877,114,991,6843,2021-01-27 16:45:58
6917,619,3,1327,172,1499,6844,2021-01-27 16:27:30
6918,912,5,1026,133,1159,6845,2021-01-27 06:04:17
6919,459,3,697,90,787,6846,2021-01-27 18:36:51
6920,148,3,747,97,844,6847,2021-01-27 21:37:33
6921,860,2,598,77,675,6848,2021-01-28 02:15:17
6922,241,3,688,89,777,6849,2021-01-27 16:56:28
6923,257,3,827,107,934,6850,2021-01-28 01:06:43
6924,391,3,1327,172,1499,6851,2021-01-28 11:49:00
6925,31,3,1197,155,1352,6852,2021-01-28 08:34:14
6926,804,3,897,116,1013,6853,2021-01-28 07:49:35
6927,412,3,1327,172,1499,6854,2021-01-27 16:01:39
6928,546,3,797,103,900,6855,2021-01-27 18:05:04
6929,861,3,808,105,913,6856,2021-01-27 20:35:36
6930,394,3,558,72,630,6857,2021-01-28 02:46:36
6931,375,4,1596,207,1803,6858,2021-01-27 23:38:39
6932,120,4,1396,181,1577,6859,2021-01-29 07:06:36
6933,674,2,698,90,788,6860,2021-01-29 06:23:45
6934,215,4,1037,134,1171,6861,2021-01-29 01:07:44
6935,829,6,1505,195,1700,6862,2021-01-29 01:10:49
6936,533,2,1098,142,1240,6863,2021-01-29 04:19:16
6937,481,3,927,120,1047,6864,2021-01-28 18:06:53
6938,756,3,578,75,653,6865,2021-01-28 13:15:36
6939,931,2,429,55,484,6866,2021-01-28 07:36:12
6940,768,3,797,103,900,6867,2021-01-28 08:00:12
6941,249,2,659,85,744,6868,2021-01-28 15:32:07
6942,578,3,1027,133,1160,6869,2021-01-28 16:08:06
6943,414,1,229,29,258,6870,2021-01-28 16:52:03
6944,13,3,597,77,674,6871,2021-01-29 03:54:52
6945,796,3,1247,162,1409,6872,2021-01-29 11:05:58
6946,998,3,758,98,856,6873,2021-01-28 12:57:43
6947,67,3,647,84,731,6874,2021-01-28 18:13:30
6948,101,2,429,55,484,6875,2021-01-29 13:20:46
6949,795,5,1525,198,1723,6876,2021-01-29 07:45:28
6950,27,3,797,103,900,6877,2021-01-29 14:13:59
6951,1000,2,659,85,744,6878,2021-01-29 07:12:27
6952,1000,2,659,85,744,6878,2021-01-29 07:12:27
6953,719,5,1126,146,1272,6879,2021-01-29 14:05:29
6954,671,2,498,64,562,6880,2021-01-29 01:38:02
6955,106,2,598,77,675,6881,2021-01-29 20:55:15
6956,800,4,1556,202,1758,6882,2021-01-29 14:13:36
6957,959,3,558,72,630,6883,2021-01-29 01:19:13
6958,188,6,1794,233,2027,6884,2021-01-29 03:51:43
6959,197,3,997,129,1126,6885,2021-01-27 21:43:22
6960,181,3,1047,136,1183,6886,2021-01-28 13:30:05
6961,516,6,1685,219,1904,6887,2021-01-28 08:14:16
6962,47,2,1098,142,1240,6888,2021-01-28 05:33:06
6963,151,3,1027,133,1160,6889,2021-01-28 06:55:59
6964,110,6,986,128,1114,6890,2021-01-28 04:18:49
6965,702,2,898,116,1014,6891,2021-01-28 09:27:46
6966,707,2,498,64,562,6892,2021-01-28 08:33:48
6967,493,3,558,72,630,6893,2021-01-28 11:34:58
6968,856,2,498,64,562,6894,2021-01-28 12:47:07
6969,611,3,688,89,777,6895,2021-01-28 20:16:20
6970,620,4,1057,137,1194,6896,2021-01-28 21:37:42
6971,720,2,429,55,484,6897,2021-01-28 16:12:21
6972,994,3,947,123,1070,6898,2021-01-28 09:14:04
6973,32,3,1197,155,1352,6899,2021-01-28 14:16:17
6974,962,3,558,72,630,6900,2021-01-28 17:41:31
6975,98,2,598,77,675,6901,2021-01-28 11:52:36
6976,247,3,827,107,934,6902,2021-01-28 14:07:07
6977,215,3,428,55,483,6903,2021-01-28 22:24:24
6978,632,1,99,12,111,6904,2021-01-28 21:36:06
6979,102,2,498,64,562,6905,2021-01-28 18:29:12
6980,195,3,1047,136,1183,6906,2021-01-28 15:55:49
6981,958,3,1127,146,1273,6907,2021-01-28 21:41:39
6982,282,3,997,129,1126,6908,2021-01-28 02:50:12
6983,47,3,747,97,844,6909,2021-01-28 02:14:22
6984,336,3,658,85,743,6910,2021-01-27 22:27:18
6985,980,3,528,68,596,6911,2021-01-27 22:46:09
6986,658,3,747,97,844,6912,2021-01-28 16:07:56
6987,239,3,758,98,856,6913,2021-01-28 20:53:19
6988,466,3,1347,175,1522,6914,2021-01-28 17:44:12
6989,480,3,997,129,1126,6915,2021-01-28 07:51:25
6990,118,3,578,75,653,6916,2021-01-27 19:21:22
6991,315,3,597,77,674,6917,2021-01-27 11:58:02
6992,198,3,827,107,934,6918,2021-01-27 19:01:13
6993,707,2,429,55,484,6919,2021-01-27 16:50:36
6994,217,3,1127,146,1273,6920,2021-01-27 07:22:24
6995,520,2,659,85,744,6921,2021-01-27 18:42:18
6996,834,2,548,71,619,6922,2021-01-27 22:26:06
6997,98,2,898,116,1014,6923,2021-01-28 03:08:18
6998,543,3,428,55,483,6924,2021-01-27 18:33:05
6999,423,6,1455,189,1644,6925,2021-01-28 01:20:10
7000,157,3,478,62,540,6926,2021-01-28 12:45:24
7001,12,4,796,103,899,6927,2021-01-28 10:09:27
7002,186,3,1047,136,1183,6928,2021-01-28 08:52:06
7003,304,4,1696,220,1916,6929,2021-01-27 17:51:56
7004,812,3,697,90,787,6930,2021-01-27 18:24:53
7005,332,2,598,77,675,6931,2021-01-27 23:17:35
7006,574,3,827,107,934,6932,2021-01-28 04:01:37
7007,419,4,1396,181,1577,6933,2021-01-27 23:46:11
7008,42,2,898,116,1014,6934,2021-01-29 08:43:45
7009,133,3,727,94,821,6935,2021-01-29 07:55:20
7010,604,3,797,103,900,6936,2021-01-29 02:54:55
7011,670,3,1047,136,1183,6937,2021-01-29 01:43:38
7012,8,3,1027,133,1160,6938,2021-01-29 05:11:11
7013,236,3,578,75,653,6939,2021-01-28 18:18:50
7014,480,6,1824,237,2061,6940,2021-01-28 13:33:51
7015,696,3,428,55,483,6941,2021-01-28 08:39:43
7016,113,3,747,97,844,6942,2021-01-28 10:19:35
7017,279,3,1127,146,1273,6943,2021-01-28 16:13:55
7018,120,3,827,107,934,6944,2021-01-28 18:24:02
7019,723,3,997,129,1126,6945,2021-01-28 18:24:14
7020,527,6,2354,306,2660,6946,2021-01-29 04:28:47
7021,395,3,1197,155,1352,6947,2021-01-29 12:10:06
7022,196,3,927,120,1047,6948,2021-01-28 13:51:59
7023,609,4,1326,172,1498,6949,2021-01-28 19:36:37
7024,150,5,1945,252,2197,6950,2021-01-29 15:58:07
7025,293,3,808,105,913,6951,2021-01-29 09:55:47
7026,623,2,828,107,935,6952,2021-01-29 14:24:44
7027,856,2,329,42,371,6953,2021-01-29 09:44:45
7028,928,2,498,64,562,6954,2021-01-29 08:46:55
7029,791,3,797,103,900,6955,2021-01-29 14:16:22
7030,791,3,797,103,900,6955,2021-01-29 14:16:22
7031,240,3,1047,136,1183,6956,2021-01-29 03:34:21
7032,137,2,898,116,1014,6957,2021-01-29 22:05:43
7033,715,5,1276,165,1441,6958,2021-01-29 16:22:10
7034,404,3,808,105,913,6959,2021-01-29 03:33:52
7035,500,2,698,90,788,6960,2021-01-29 05:06:28
7036,109,6,1755,228,1983,6961,2021-01-27 23:01:36
7037,321,3,1127,146,1273,6962,2021-01-28 15:06:41
7038,671,3,658,85,743,6963,2021-01-28 09:41:27
7039,359,2,459,59,518,6964,2021-01-28 06:27:55
7040,458,5,1345,174,1519,6965,2021-01-28 08:00:47
7041,886,5,1625,211,1836,6966,2021-01-28 05:11:22
7042,506,1,149,19,168,6967,2021-01-28 09:38:28
7043,463,3,1047,136,1183,6968,2021-01-28 10:39:13
7044,612,3,1247,162,1409,6969,2021-01-28 12:27:59
7045,60,2,598,77,675,6970,2021-01-28 15:26:12
7046,979,3,697,90,787,6971,2021-01-28 20:46:06
7047,388,2,598,77,675,6972,2021-01-28 22:37:30
7048,331,3,847,110,957,6973,2021-01-28 18:47:21
7049,269,2,398,51,449,6974,2021-01-28 10:04:54
7050,446,4,1296,168,1464,6975,2021-01-28 14:41:19
7051,456,3,827,107,934,6976,2021-01-28 19:09:25
7052,894,3,1247,162,1409,6977,2021-01-28 12:00:07
7053,23,6,1324,172,1496,6978,2021-01-28 15:30:31
7054,748,1,699,90,789,6979,2021-01-28 22:35:08
7055,405,3,1047,136,1183,6980,2021-01-28 22:50:56
7056,642,2,1098,142,1240,6981,2021-01-28 19:59:24
7057,52,3,478,62,540,6982,2021-01-28 17:00:53
7058,478,3,478,62,540,6983,2021-01-28 22:28:20
7059,998,2,898,116,1014,6984,2021-01-28 05:10:09
7060,717,2,898,116,1014,6985,2021-01-28 03:08:51
7061,101,6,1935,251,2186,6986,2021-01-28 00:25:40
7062,519,3,697,90,787,6987,2021-01-27 23:27:04
7063,737,6,1935,251,2186,6988,2021-01-28 17:05:51
7064,95,5,1226,159,1385,6989,2021-01-28 21:16:31
7065,130,3,1047,136,1183,6990,2021-01-28 18:10:40
7066,831,2,459,59,518,6991,2021-01-28 10:19:29
7067,552,3,747,97,844,6992,2021-01-27 20:43:30
7068,848,4,1596,207,1803,6993,2021-01-27 14:33:40
7069,788,3,688,89,777,6994,2021-01-27 21:44:07
7070,90,4,1257,163,1420,6995,2021-01-27 18:01:08
7071,889,3,1127,146,1273,6996,2021-01-27 09:26:37
7072,889,3,1197,155,1352,6997,2021-01-27 18:51:18
7073,757,2,329,42,371,6998,2021-01-27 23:16:06
7074,438,1,149,19,168,6999,2021-01-28 03:58:51
7075,869,3,1327,172,1499,7000,2021-01-27 18:33:36
7076,182,3,428,55,483,7001,2021-01-28 02:25:19
7077,337,6,1116,145,1261,7002,2021-01-28 15:09:34
7078,941,5,1156,150,1306,7003,2021-01-28 11:10:56
7079,984,2,598,77,675,7004,2021-01-28 09:23:28
7080,369,3,597,77,674,7005,2021-01-27 19:00:08
7081,707,3,1127,146,1273,7006,2021-01-27 21:02:05
7082,51,1,99,12,111,7007,2021-01-27 23:53:46
7083,822,3,478,62,540,7008,2021-01-28 04:37:47
7084,91,2,598,77,675,7009,2021-01-28 01:20:32
7085,792,2,898,116,1014,7010,2021-01-29 11:05:54
7086,79,3,558,72,630,7011,2021-01-29 09:29:52
7087,260,1,599,77,676,7012,2021-01-29 03:51:41
7088,785,3,847,110,957,7013,2021-01-29 03:16:02
7089,445,3,697,90,787,7014,2021-01-29 05:16:00
7090,225,3,847,110,957,7015,2021-01-28 20:59:27
7091,408,1,399,51,450,7016,2021-01-28 14:13:14
7092,500,2,698,90,788,7017,2021-01-28 08:54:17
7093,641,2,659,85,744,7018,2021-01-28 11:35:09
7094,677,2,429,55,484,7019,2021-01-28 16:56:27
7095,613,2,598,77,675,7020,2021-01-28 19:13:19
7096,51,3,747,97,844,7021,2021-01-28 19:39:22
7097,210,3,578,75,653,7022,2021-01-29 04:40:38
7098,24,2,498,64,562,7023,2021-01-29 13:36:03
7099,507,3,888,115,1003,7024,2021-01-28 15:44:59
7100,758,4,1396,181,1577,7025,2021-01-28 22:00:32
7101,300,3,558,72,630,7026,2021-01-29 18:41:23
7102,423,3,1297,168,1465,7027,2021-01-29 12:28:16
7103,232,2,329,42,371,7028,2021-01-29 17:11:21
7104,486,3,558,72,630,7029,2021-01-29 12:00:26
7105,37,3,1047,136,1183,7030,2021-01-29 09:13:34
7106,286,3,1027,133,1160,7031,2021-01-29 14:40:51
7107,886,3,558,72,630,7032,2021-01-29 15:39:52
7108,42,3,997,129,1126,7033,2021-01-29 04:44:48
7109,29,3,528,68,596,7034,2021-01-30 00:01:17
7110,978,2,659,85,744,7035,2021-01-29 16:24:09
7111,370,3,428,55,483,7036,2021-01-29 03:41:08
7112,807,3,608,79,687,7037,2021-01-29 05:46:30
7113,148,3,847,110,957,7038,2021-01-28 01:11:32
7114,682,3,997,129,1126,7039,2021-01-28 16:22:59
7115,413,1,699,90,789,7040,2021-01-28 12:23:14
7116,869,5,1575,204,1779,7041,2021-01-28 09:13:48
7117,695,3,927,120,1047,7042,2021-01-28 08:16:16
7118,763,3,947,123,1070,7043,2021-01-28 05:47:59
7119,195,4,1296,168,1464,7044,2021-01-28 11:09:09
7120,374,2,1098,142,1240,7045,2021-01-28 12:19:26
7121,245,3,758,98,856,7046,2021-01-28 14:45:26
7122,157,3,558,72,630,7047,2021-01-28 15:44:15
7123,768,2,459,59,518,7048,2021-01-28 22:40:48
7124,480,3,897,116,1013,7049,2021-01-28 23:29:57
7125,564,2,548,71,619,7050,2021-01-28 18:56:48
7126,731,2,429,55,484,7051,2021-01-28 11:03:27
7127,468,3,478,62,540,7052,2021-01-28 14:54:44
7128,558,3,1247,162,1409,7053,2021-01-28 21:14:38
7129,976,5,1745,226,1971,7054,2021-01-28 13:14:23
7130,692,3,697,90,787,7055,2021-01-28 16:16:46
7131,357,3,808,105,913,7056,2021-01-29 00:03:20
7132,727,3,528,68,596,7057,2021-01-29 00:46:16
7133,15,5,1286,167,1453,7058,2021-01-28 21:46:09
7134,409,3,827,107,934,7059,2021-01-28 19:29:47
7135,437,3,647,84,731,7060,2021-01-29 01:07:37
7136,53,1,499,64,563,7061,2021-01-28 06:23:48
7137,743,2,748,97,845,7062,2021-01-28 05:09:20
7138,694,3,888,115,1003,7063,2021-01-28 02:33:23
7139,691,3,927,120,1047,7064,2021-01-28 01:58:08
7140,695,3,558,72,630,7065,2021-01-28 17:22:58
7141,772,2,659,85,744,7066,2021-01-28 23:26:58
7142,408,2,498,64,562,7067,2021-01-28 19:36:05
7143,714,3,578,75,653,7068,2021-01-28 11:14:53
7144,234,2,598,77,675,7069,2021-01-27 22:23:56
7145,443,2,698,90,788,7070,2021-01-27 14:57:23
7146,707,2,598,77,675,7071,2021-01-27 23:19:35
7147,413,2,598,77,675,7072,2021-01-27 19:00:38
7148,840,3,827,107,934,7073,2021-01-27 10:26:19
7149,185,3,1327,172,1499,7074,2021-01-27 20:59:35
7150,868,3,808,105,913,7075,2021-01-28 01:29:43
7151,758,3,608,79,687,7076,2021-01-28 05:41:36
7152,608,2,728,94,822,7077,2021-01-27 20:40:10
7153,722,3,697,90,787,7078,2021-01-28 02:50:26
7154,249,6,1355,176,1531,7079,2021-01-28 15:40:19
7155,510,2,459,59,518,7080,2021-01-28 13:00:45
7156,763,3,428,55,483,7081,2021-01-28 09:38:40
7157,763,3,428,55,483,7081,2021-01-28 09:38:40
7158,611,3,1247,162,1409,7082,2021-01-27 20:46:10
7159,736,2,1098,142,1240,7083,2021-01-27 21:12:28
7160,124,3,1197,155,1352,7084,2021-01-28 01:37:10
7161,255,2,598,77,675,7085,2021-01-28 05:08:39
7162,160,3,797,103,900,7086,2021-01-28 01:35:27
7163,536,3,597,77,674,7087,2021-01-29 12:56:11
7164,116,3,897,116,1013,7088,2021-01-29 11:19:04
7165,984,3,1047,136,1183,7089,2021-01-29 05:23:54
7166,176,5,1725,224,1949,7090,2021-01-29 03:21:20
7167,953,3,697,90,787,7091,2021-01-29 06:47:36
7168,404,2,459,59,518,7092,2021-01-28 23:21:00
7169,968,3,1197,155,1352,7093,2021-01-28 15:34:51
7170,901,1,599,77,676,7094,2021-01-28 10:23:03
7171,398,5,1456,189,1645,7095,2021-01-28 13:22:57
7172,735,3,1197,155,1352,7096,2021-01-28 19:03:19
7173,655,3,1247,162,1409,7097,2021-01-28 19:22:46
7174,249,3,1047,136,1183,7098,2021-01-28 20:28:04
7175,1,3,478,62,540,7099,2021-01-29 05:13:02
7176,247,2,598,77,675,7100,2021-01-29 14:17:23
7177,66,2,628,81,709,7101,2021-01-28 16:42:19
7178,242,1,599,77,676,7102,2021-01-28 22:24:04
7179,331,3,847,110,957,7103,2021-01-29 18:42:19
7180,400,2,698,90,788,7104,2021-01-29 13:32:22
7181,78,3,1247,162,1409,7105,2021-01-29 19:52:32
7182,8,3,697,90,787,7106,2021-01-29 12:41:37
7183,252,3,597,77,674,7107,2021-01-29 09:19:34
7184,828,6,1355,176,1531,7108,2021-01-29 15:59:35
7185,577,3,647,84,731,7109,2021-01-29 18:00:40
7186,554,3,608,79,687,7110,2021-01-29 07:07:18
7187,147,3,597,77,674,7111,2021-01-30 02:37:51
7188,164,3,808,105,913,7112,2021-01-29 17:48:37
7189,283,3,478,62,540,7113,2021-01-29 05:51:14
7190,142,3,758,98,856,7114,2021-01-29 06:02:37
7191,451,3,1327,172,1499,7115,2021-01-28 02:46:23
7192,733,3,1027,133,1160,7116,2021-01-28 18:14:18
7193,97,2,329,42,371,7117,2021-01-28 15:05:36
7194,31,2,698,90,788,7118,2021-01-28 10:53:21
7195,140,2,898,116,1014,7119,2021-01-28 10:52:54
7196,173,3,1197,155,1352,7120,2021-01-28 07:49:49
7197,370,1,229,29,258,7121,2021-01-28 12:22:57
7198,693,3,997,129,1126,7122,2021-01-28 12:33:59
7199,830,3,1127,146,1273,7123,2021-01-28 15:40:32
7200,919,3,597,77,674,7124,2021-01-28 16:25:50
7201,48,3,578,75,653,7125,2021-01-29 01:18:41
7202,948,3,727,94,821,7126,2021-01-29 02:09:51
7203,419,3,1247,162,1409,7127,2021-01-28 21:15:08
7204,15,3,727,94,821,7128,2021-01-28 13:33:18
7205,23,3,747,97,844,7129,2021-01-28 17:15:29
7206,702,3,897,116,1013,7130,2021-01-28 22:10:39
7207,227,2,659,85,744,7131,2021-01-28 13:49:24
7208,828,2,329,42,371,7132,2021-01-28 18:41:55
7209,525,5,1286,167,1453,7133,2021-01-29 01:03:26
7210,29,4,1396,181,1577,7134,2021-01-29 03:00:52
7211,966,3,558,72,630,7135,2021-01-28 22:49:24
7212,990,3,947,123,1070,7136,2021-01-28 20:24:43
7213,462,3,1127,146,1273,7137,2021-01-29 02:58:52
7214,509,1,99,12,111,7138,2021-01-28 08:58:50
7215,843,6,1394,181,1575,7139,2021-01-28 06:49:45
7216,750,3,997,129,1126,7140,2021-01-28 02:33:32
7217,839,3,1027,133,1160,7141,2021-01-28 02:04:37
7218,738,3,578,75,653,7142,2021-01-28 19:13:36
7219,135,2,598,77,675,7143,2021-01-29 00:56:44
7220,205,2,698,90,788,7144,2021-01-28 21:51:00
7221,328,1,599,77,676,7145,2021-01-28 13:27:35
7222,753,3,558,72,630,7146,2021-01-27 23:08:53
7223,954,5,807,104,911,7147,2021-01-27 15:22:10
7224,729,3,747,97,844,7148,2021-01-27 23:48:05
7225,169,1,229,29,258,7149,2021-01-27 21:31:35
7226,879,5,1137,147,1284,7150,2021-01-27 10:34:47
7227,563,2,698,90,788,7151,2021-01-27 22:22:24
7228,728,2,898,116,1014,7152,2021-01-28 03:51:48
7229,124,2,698,90,788,7153,2021-01-28 07:26:41
7230,493,2,798,103,901,7154,2021-01-27 20:54:48
7231,30,3,747,97,844,7155,2021-01-28 05:28:45
7232,850,3,947,123,1070,7156,2021-01-28 15:43:53
7233,736,2,628,81,709,7157,2021-01-28 13:40:26
7234,765,3,797,103,900,7158,2021-01-28 12:04:20
7235,87,3,647,84,731,7159,2021-01-28 10:52:53
7236,355,2,329,42,371,7160,2021-01-27 22:31:41
7237,753,3,697,90,787,7161,2021-01-27 23:06:09
7238,247,2,659,85,744,7162,2021-01-28 01:58:44
7239,338,3,647,84,731,7163,2021-01-28 06:32:47
7240,447,3,697,90,787,7164,2021-01-28 02:40:42
7241,602,4,1426,185,1611,7165,2021-01-29 15:04:15
7242,621,3,658,85,743,7166,2021-01-29 11:46:28
7243,79,5,2095,272,2367,7167,2021-01-29 07:12:52
7244,896,3,478,62,540,7168,2021-01-29 05:25:37
7245,189,3,897,116,1013,7169,2021-01-29 07:35:08
7246,966,2,498,64,562,7170,2021-01-29 00:39:23
7247,596,2,598,77,675,7171,2021-01-28 17:43:02
7248,655,5,1137,147,1284,7172,2021-01-28 11:31:18
7249,48,2,1098,142,1240,7173,2021-01-28 14:45:53
7250,885,2,898,116,1014,7174,2021-01-28 19:11:53
7251,219,2,598,77,675,7175,2021-01-28 19:32:09
7252,391,2,898,116,1014,7176,2021-01-28 22:34:11
7253,874,3,608,79,687,7177,2021-01-29 07:30:30
7254,731,5,1995,259,2254,7178,2021-01-29 16:12:22
7255,571,3,1127,146,1273,7179,2021-01-28 18:49:23
7256,740,3,1127,146,1273,7180,2021-01-28 23:11:26
7257,887,2,728,94,822,7181,2021-01-29 19:41:06
7258,826,3,1197,155,1352,7182,2021-01-29 15:14:58
7259,491,3,797,103,900,7183,2021-01-29 22:02:19
7260,222,4,1396,181,1577,7184,2021-01-29 15:09:41
7261,36,3,697,90,787,7185,2021-01-29 09:21:39
7262,570,3,597,77,674,7186,2021-01-29 17:05:33
7263,613,2,698,90,788,7187,2021-01-29 19:00:49
7264,891,3,428,55,483,7188,2021-01-29 09:08:34
7265,475,3,997,129,1126,7189,2021-01-30 04:13:08
7266,169,2,598,77,675,7190,2021-01-29 19:51:27
7267,656,3,827,107,934,7191,2021-01-29 08:13:39
7268,851,4,1696,220,1916,7192,2021-01-29 06:10:41
7269,805,2,728,94,822,7193,2021-01-28 05:06:32
7270,112,2,548,71,619,7194,2021-01-28 20:31:26
7271,670,2,498,64,562,7195,2021-01-28 17:31:49
7272,926,3,1327,172,1499,7196,2021-01-28 13:27:59
7273,2,2,728,94,822,7197,2021-01-28 13:25:03
7274,362,3,1247,162,1409,7198,2021-01-28 08:11:33
7275,330,3,1047,136,1183,7199,2021-01-28 14:06:04
7276,991,2,459,59,518,7200,2021-01-28 15:07:24
7277,963,2,628,81,709,7201,2021-01-28 17:00:31
7278,664,3,827,107,934,7202,2021-01-28 18:51:23
7279,150,3,797,103,900,7203,2021-01-29 02:47:35
7280,207,3,697,90,787,7204,2021-01-29 03:24:02
7281,26,1,99,12,111,7205,2021-01-28 23:23:36
7282,315,3,1047,136,1183,7206,2021-01-28 14:56:42
7283,641,2,828,107,935,7207,2021-01-28 18:39:05
7284,757,3,1127,146,1273,7208,2021-01-28 23:24:06
7285,941,3,897,116,1013,7209,2021-01-28 16:19:03
7286,941,3,897,116,1013,7209,2021-01-28 16:19:03
7287,320,3,558,72,630,7210,2021-01-28 21:04:28
7288,584,3,1047,136,1183,7211,2021-01-29 01:20:32
7289,829,2,898,116,1014,7212,2021-01-29 03:57:18
7290,104,2,429,55,484,7213,2021-01-28 22:50:58
7291,475,2,659,85,744,7214,2021-01-28 21:24:10
7292,101,3,947,123,1070,7215,2021-01-29 04:26:32
7293,262,3,897,116,1013,7216,2021-01-28 11:11:40
7294,483,3,697,90,787,7217,2021-01-28 06:49:54
7295,266,5,1345,174,1519,7218,2021-01-28 03:36:09
7296,22,3,428,55,483,7219,2021-01-28 02:27:11
7297,164,3,808,105,913,7220,2021-01-28 19:55:10
7298,625,3,1047,136,1183,7221,2021-01-29 01:30:54
7299,773,3,647,84,731,7222,2021-01-28 23:56:32
7300,773,3,647,84,731,7222,2021-01-28 23:56:32
7301,2,3,428,55,483,7223,2021-01-28 14:14:12
7302,291,2,598,77,675,7224,2021-01-28 01:30:22
7303,474,2,898,116,1014,7225,2021-01-27 16:14:11
7304,139,2,598,77,675,7226,2021-01-28 00:15:00
7305,148,2,659,85,744,7227,2021-01-27 22:02:04
7306,55,2,598,77,675,7228,2021-01-27 12:36:30
7307,338,3,658,85,743,7229,2021-01-27 23:31:44
7308,694,2,598,77,675,7230,2021-01-28 04:24:55
7309,143,3,747,97,844,7231,2021-01-28 08:32:06
7310,153,2,928,120,1048,7232,2021-01-27 23:07:45
7311,184,5,1187,154,1341,7233,2021-01-28 07:36:12
7312,318,3,597,77,674,7234,2021-01-28 15:59:33
7313,78,2,648,84,732,7235,2021-01-28 14:39:56
7314,235,2,429,55,484,7236,2021-01-28 13:26:33
7315,640,1,399,51,450,7237,2021-01-28 12:49:55
7316,938,5,1226,159,1385,7238,2021-01-28 00:18:17
7317,259,3,947,123,1070,7239,2021-01-27 23:13:01
7318,337,3,1027,133,1160,7240,2021-01-28 02:54:13
7319,376,5,1786,232,2018,7241,2021-01-28 06:35:31
7320,755,3,558,72,630,7242,2021-01-28 03:59:09
7321,786,3,947,123,1070,7243,2021-01-29 16:29:32
7322,960,4,1626,211,1837,7244,2021-01-29 11:50:37
7323,444,3,827,107,934,7245,2021-01-29 08:44:38
7324,35,3,1247,162,1409,7246,2021-01-29 07:28:00
7325,829,3,947,123,1070,7247,2021-01-29 08:32:07
7326,388,3,808,105,913,7248,2021-01-29 01:16:18
7327,253,2,648,84,732,7249,2021-01-28 19:57:58
7328,61,2,698,90,788,7250,2021-01-28 14:10:06
7329,388,3,558,72,630,7251,2021-01-28 15:29:03
7330,889,5,1345,174,1519,7252,2021-01-28 20:51:38
7331,721,3,727,94,821,7253,2021-01-28 22:16:35
7332,407,3,1127,146,1273,7254,2021-01-29 01:20:48
7333,561,5,1186,154,1340,7255,2021-01-29 08:46:28
7334,18,2,448,58,506,7256,2021-01-29 17:23:25
7335,215,3,997,129,1126,7257,2021-01-28 21:12:06
7336,233,3,747,97,844,7258,2021-01-29 00:53:59
7337,707,3,888,115,1003,7259,2021-01-29 22:17:40
7338,248,2,659,85,744,7260,2021-01-29 17:14:45
7339,542,6,1744,226,1970,7261,2021-01-29 23:49:06
7340,844,3,888,115,1003,7262,2021-01-29 15:20:48
7341,8,2,848,110,958,7263,2021-01-29 11:24:39
7342,352,3,727,94,821,7264,2021-01-29 17:13:37
7343,733,3,688,89,777,7265,2021-01-29 19:36:14
7344,498,3,847,110,957,7266,2021-01-29 09:21:03
7345,640,3,578,75,653,7267,2021-01-30 05:27:35
7346,164,3,1027,133,1160,7268,2021-01-29 21:54:17
7347,894,3,647,84,731,7269,2021-01-29 10:29:51
7348,528,5,1786,232,2018,7270,2021-01-29 08:06:08
7349,776,3,888,115,1003,7271,2021-01-28 06:27:54
7350,507,3,997,129,1126,7272,2021-01-28 21:00:26
7351,102,3,558,72,630,7273,2021-01-28 19:56:13
7352,467,2,898,116,1014,7274,2021-01-28 16:14:32
7353,471,3,747,97,844,7275,2021-01-28 16:00:07
7354,435,3,888,115,1003,7276,2021-01-28 10:19:51
7355,435,3,888,115,1003,7276,2021-01-28 10:19:51
7356,726,5,1356,176,1532,7277,2021-01-28 15:23:55
7357,690,3,797,103,900,7278,2021-01-28 16:14:13
7358,235,2,628,81,709,7279,2021-01-28 18:00:10
7359,241,3,1127,146,1273,7280,2021-01-28 18:54:22
7360,590,3,897,116,1013,7281,2021-01-29 03:10:27
7361,27,1,149,19,168,7282,2021-01-29 05:05:30
7362,83,3,528,68,596,7283,2021-01-29 00:44:29
7363,23,3,697,90,787,7284,2021-01-28 15:21:29
7364,941,2,598,77,675,7285,2021-01-28 19:26:19
7365,165,2,528,68,596,7286,2021-01-29 01:42:34
7366,877,5,1156,150,1306,7287,2021-01-28 17:21:55
7367,532,3,827,107,934,7288,2021-01-28 16:50:26
7368,669,3,927,120,1047,7289,2021-01-28 22:57:47
7369,66,3,827,107,934,7290,2021-01-29 03:37:29
7370,409,2,659,85,744,7291,2021-01-29 04:53:51
7371,522,5,1226,159,1385,7292,2021-01-29 00:26:18
7372,737,3,847,110,957,7293,2021-01-28 23:42:19
7373,245,4,1226,159,1385,7294,2021-01-29 06:06:23
7374,215,1,99,12,111,7295,2021-01-28 11:29:20
7375,514,3,797,103,900,7296,2021-01-28 07:28:01
7376,749,4,758,98,856,7297,2021-01-28 05:05:56
7377,49,5,1376,178,1554,7298,2021-01-28 03:45:41
7378,770,3,578,75,653,7299,2021-01-28 22:19:23
7379,730,3,1047,136,1183,7300,2021-01-29 03:59:22
7380,857,3,608,79,687,7301,2021-01-29 02:39:09
7381,498,6,1485,193,1678,7302,2021-01-29 00:38:47
7382,643,6,1594,207,1801,7303,2021-01-28 16:52:31
7383,734,3,1297,168,1465,7304,2021-01-28 02:49:27
7384,499,3,478,62,540,7305,2021-01-27 17:26:26
7385,512,3,997,129,1126,7306,2021-01-28 01:40:28
7386,370,2,898,116,1014,7307,2021-01-28 00:43:22
7387,370,2,898,116,1014,7307,2021-01-28 00:43:22
7388,105,3,1127,146,1273,7308,2021-01-27 14:24:33
7389,899,1,699,90,789,7309,2021-01-28 00:05:28
7390,179,3,1047,136,1183,7310,2021-01-28 07:02:06
7391,61,3,478,62,540,7311,2021-01-28 09:31:06
7392,9,1,699,90,789,7312,2021-01-28 01:25:08
7393,461,3,927,120,1047,7313,2021-01-28 09:32:20
7394,564,3,1027,133,1160,7314,2021-01-28 17:15:07
7395,321,3,947,123,1070,7315,2021-01-28 15:58:23
7396,699,3,758,98,856,7316,2021-01-28 15:41:44
7397,987,3,747,97,844,7317,2021-01-28 15:28:26
7398,521,2,498,64,562,7318,2021-01-28 02:33:43
7399,573,3,647,84,731,7319,2021-01-28 01:08:39
7400,367,3,758,98,856,7320,2021-01-28 04:30:05
7401,113,3,827,107,934,7321,2021-01-28 07:14:55
7402,508,3,1247,162,1409,7322,2021-01-28 04:34:53
7403,744,2,598,77,675,7323,2021-01-29 16:38:33
7404,31,5,1325,172,1497,7324,2021-01-29 12:06:58
7405,838,3,997,129,1126,7325,2021-01-29 09:08:25
7406,570,3,1027,133,1160,7326,2021-01-29 09:11:18
7407,864,2,528,68,596,7327,2021-01-29 08:58:03
7408,763,3,747,97,844,7328,2021-01-29 03:04:49
7409,994,3,997,129,1126,7329,2021-01-28 21:27:09
7410,624,3,797,103,900,7330,2021-01-28 14:20:20
7411,208,5,1226,159,1385,7331,2021-01-28 17:26:14
7412,638,3,758,98,856,7332,2021-01-28 22:01:17
7413,930,3,558,72,630,7333,2021-01-28 22:44:53
7414,721,1,499,64,563,7334,2021-01-29 02:24:11
7415,874,2,1098,142,1240,7335,2021-01-29 11:25:54
7416,992,3,1247,162,1409,7336,2021-01-29 18:31:28
7417,386,2,1098,142,1240,7337,2021-01-28 23:10:15
7418,751,3,608,79,687,7338,2021-01-29 03:35:42
7419,757,3,1127,146,1273,7339,2021-01-29 22:19:44
7420,68,3,578,75,653,7340,2021-01-29 17:14:51
7421,474,3,688,89,777,7341,2021-01-30 01:50:26
7422,469,3,827,107,934,7342,2021-01-29 17:26:23
7423,925,2,798,103,901,7343,2021-01-29 13:36:52
7424,486,3,727,94,821,7344,2021-01-29 17:52:30
7425,486,3,727,94,821,7344,2021-01-29 17:52:30
7426,105,2,459,59,518,7345,2021-01-29 22:11:22
7427,214,5,1195,155,1350,7346,2021-01-29 11:22:59
7428,27,1,149,19,168,7347,2021-01-30 06:56:57
7429,851,3,1127,146,1273,7348,2021-01-29 23:52:30
7430,19,2,898,116,1014,7349,2021-01-29 11:08:25
7431,93,3,1197,155,1352,7350,2021-01-29 09:25:50
7432,236,3,697,90,787,7351,2021-01-28 06:57:56
7433,555,3,797,103,900,7352,2021-01-28 21:01:33
7434,973,2,548,71,619,7353,2021-01-28 22:22:29
7435,982,3,927,120,1047,7354,2021-01-28 18:31:58
7436,887,3,897,116,1013,7355,2021-01-28 16:51:45
7437,591,3,1047,136,1183,7356,2021-01-28 12:45:12
7438,638,6,1855,241,2096,7357,2021-01-28 11:26:10
7439,265,3,727,94,821,7358,2021-01-28 16:00:26
7440,262,2,459,59,518,7359,2021-01-28 16:47:08
7441,262,2,459,59,518,7359,2021-01-28 16:47:08
7442,340,1,399,51,450,7360,2021-01-28 19:18:15
7443,855,4,1307,169,1476,7361,2021-01-28 19:43:29
7444,245,2,598,77,675,7362,2021-01-29 05:11:24
7445,411,2,429,55,484,7363,2021-01-29 07:13:17
7446,725,3,897,116,1013,7364,2021-01-29 03:29:13
7447,639,4,1246,161,1407,7365,2021-01-28 15:52:47
7448,837,5,1325,172,1497,7366,2021-01-28 21:07:26
7449,111,2,898,116,1014,7367,2021-01-29 03:59:42
7450,703,6,1106,143,1249,7368,2021-01-28 17:23:07
7451,456,3,688,89,777,7369,2021-01-28 17:15:00
7452,624,3,747,97,844,7370,2021-01-28 23:57:12
7453,160,2,648,84,732,7371,2021-01-29 06:01:35
7454,800,3,1197,155,1352,7372,2021-01-29 05:49:55
7455,63,3,727,94,821,7373,2021-01-29 01:27:13
7456,888,3,997,129,1126,7374,2021-01-29 02:14:12
7457,32,2,598,77,675,7375,2021-01-29 07:22:40
7458,322,6,1574,204,1778,7376,2021-01-28 11:38:45
7459,712,3,528,68,596,7377,2021-01-28 08:07:52
7460,452,3,658,85,743,7378,2021-01-28 07:10:37
7461,847,3,1247,162,1409,7379,2021-01-28 04:39:55
7462,117,3,528,68,596,7380,2021-01-28 23:31:07
7463,52,3,658,85,743,7381,2021-01-29 04:44:33
7464,642,3,1127,146,1273,7382,2021-01-29 04:29:35
7465,910,2,659,85,744,7383,2021-01-29 02:48:34
7466,469,3,597,77,674,7384,2021-01-28 18:06:40
7467,551,2,459,59,518,7385,2021-01-28 04:09:58
7468,620,2,848,110,958,7386,2021-01-27 18:24:10
7469,928,1,99,12,111,7387,2021-01-28 04:08:06
7470,394,5,1875,243,2118,7388,2021-01-28 02:11:00
7471,131,2,898,116,1014,7389,2021-01-28 00:49:17
7472,807,5,1226,159,1385,7390,2021-01-27 16:29:47
7473,635,3,747,97,844,7391,2021-01-28 02:38:08
7474,37,2,628,81,709,7392,2021-01-28 08:15:22
7475,923,2,648,84,732,7393,2021-01-28 09:36:45
7476,2,3,1027,133,1160,7394,2021-01-28 01:25:48
7477,4,2,598,77,675,7395,2021-01-28 10:25:22
7478,470,2,659,85,744,7396,2021-01-28 18:15:51
7479,711,2,798,103,901,7397,2021-01-28 16:14:12
7480,297,1,99,12,111,7398,2021-01-28 16:38:50
7481,770,3,888,115,1003,7399,2021-01-28 16:55:40
7482,991,2,598,77,675,7400,2021-01-28 05:18:52
7483,961,3,747,97,844,7401,2021-01-28 02:49:48
7484,454,3,1197,155,1352,7402,2021-01-28 05:46:09
7485,806,5,1795,233,2028,7403,2021-01-28 07:45:23
7486,87,5,887,115,1002,7404,2021-01-28 06:13:17
7487,680,2,548,71,619,7405,2021-01-29 17:30:34
7488,854,3,1027,133,1160,7406,2021-01-29 14:16:17
7489,948,5,1226,159,1385,7407,2021-01-29 09:37:03
7490,378,3,1047,136,1183,7408,2021-01-29 11:39:34
7491,655,4,1207,156,1363,7409,2021-01-29 10:03:45
7492,618,3,1047,136,1183,7410,2021-01-29 05:24:40
7493,643,3,888,115,1003,7411,2021-01-28 21:53:02
7494,557,2,548,71,619,7412,2021-01-28 15:52:53
7495,400,3,697,90,787,7413,2021-01-28 19:18:12
7496,905,3,808,105,913,7414,2021-01-28 23:43:13
7497,16,2,498,64,562,7415,2021-01-28 23:51:25
7498,245,3,597,77,674,7416,2021-01-29 04:53:13
7499,53,2,329,42,371,7417,2021-01-29 14:04:20
7500,834,3,658,85,743,7418,2021-01-29 18:47:28
7501,993,3,578,75,653,7419,2021-01-29 01:11:43
7502,601,3,1197,155,1352,7420,2021-01-29 05:47:15
7503,208,3,1047,136,1183,7421,2021-01-29 22:41:36
7504,533,3,1127,146,1273,7422,2021-01-29 18:29:57
7505,776,3,697,90,787,7423,2021-01-30 04:15:28
7506,969,2,1098,142,1240,7424,2021-01-29 19:01:40
7507,385,6,1805,234,2039,7425,2021-01-29 14:46:33
7508,429,3,747,97,844,7426,2021-01-29 18:15:33
7509,53,3,947,123,1070,7427,2021-01-29 20:28:09
7510,920,4,1257,163,1420,7428,2021-01-29 23:29:26
7511,291,2,459,59,518,7429,2021-01-29 13:15:02
7512,272,3,688,89,777,7430,2021-01-30 07:22:20
7513,249,2,798,103,901,7431,2021-01-30 01:34:59
7514,554,4,926,120,1046,7432,2021-01-29 12:39:26
7515,588,3,597,77,674,7433,2021-01-29 12:10:38
7516,113,3,697,90,787,7434,2021-01-28 07:52:20
7517,106,2,398,51,449,7435,2021-01-28 22:05:49
7518,326,3,597,77,674,7436,2021-01-29 00:43:11
7519,350,2,659,85,744,7437,2021-01-28 18:37:38
7520,903,2,1098,142,1240,7438,2021-01-28 19:20:34
7521,304,5,1206,156,1362,7439,2021-01-28 12:58:35
7522,366,3,758,98,856,7440,2021-01-28 13:43:25
7523,252,1,149,19,168,7441,2021-01-28 18:24:36
7524,766,2,659,85,744,7442,2021-01-28 17:27:44
7525,619,3,947,123,1070,7443,2021-01-28 17:45:51
7526,667,2,728,94,822,7444,2021-01-28 21:35:21
7527,215,1,149,19,168,7445,2021-01-28 22:21:36
7528,994,2,659,85,744,7446,2021-01-29 06:43:24
7529,358,3,1327,172,1499,7447,2021-01-29 08:39:31
7530,98,5,1345,174,1519,7448,2021-01-29 05:40:46
7531,923,5,1495,194,1689,7449,2021-01-28 16:27:30
7532,232,3,927,120,1047,7450,2021-01-28 22:48:52
7533,83,3,827,107,934,7451,2021-01-29 06:21:51
7534,407,4,1726,224,1950,7452,2021-01-28 19:08:54
7535,826,2,698,90,788,7453,2021-01-28 18:43:16
7536,146,3,558,72,630,7454,2021-01-29 01:59:24
7537,386,2,329,42,371,7455,2021-01-29 08:05:54
7538,67,4,1327,172,1499,7456,2021-01-29 08:07:21
7539,885,3,1127,146,1273,7457,2021-01-29 01:41:13
7540,294,2,548,71,619,7458,2021-01-29 03:22:22
7541,709,2,429,55,484,7459,2021-01-29 09:03:18
7542,260,3,997,129,1126,7460,2021-01-28 13:25:31
7543,897,3,747,97,844,7461,2021-01-28 09:19:32
7544,996,1,299,38,337,7462,2021-01-28 09:29:47
7545,332,3,808,105,913,7463,2021-01-28 05:33:32
7546,583,2,898,116,1014,7464,2021-01-29 01:43:47
7547,43,2,798,103,901,7465,2021-01-29 05:55:13
7548,43,2,798,103,901,7465,2021-01-29 05:55:13
7549,925,3,727,94,821,7466,2021-01-29 04:57:32
7550,562,3,727,94,821,7467,2021-01-29 04:17:13
7551,38,3,647,84,731,7468,2021-01-28 19:25:01
7552,988,1,229,29,258,7469,2021-01-28 05:03:57
7553,242,2,898,116,1014,7470,2021-01-27 19:00:13
7554,711,3,747,97,844,7471,2021-01-28 05:10:44
7555,425,3,597,77,674,7472,2021-01-28 03:15:26
7556,331,1,99,12,111,7473,2021-01-28 02:27:55
7557,615,3,1127,146,1273,7474,2021-01-27 18:57:06
7558,555,3,597,77,674,7475,2021-01-28 03:36:35
7559,209,2,459,59,518,7476,2021-01-28 10:50:13
7560,522,2,698,90,788,7477,2021-01-28 12:11:25
7561,625,2,728,94,822,7478,2021-01-28 02:42:55
7562,565,2,648,84,732,7479,2021-01-28 12:39:51
7563,642,2,598,77,675,7480,2021-01-28 20:54:49
7564,546,3,747,97,844,7481,2021-01-28 18:58:26
7565,314,3,697,90,787,7482,2021-01-28 17:34:12
7566,920,2,598,77,675,7483,2021-01-28 17:11:06
7567,768,2,1098,142,1240,7484,2021-01-28 05:21:56
7568,963,3,897,116,1013,7485,2021-01-28 03:55:16
7569,356,2,598,77,675,7486,2021-01-28 08:15:53
7570,627,3,478,62,540,7487,2021-01-28 08:24:59
7571,80,2,1098,142,1240,7488,2021-01-28 06:56:41
7572,75,6,1255,163,1418,7489,2021-01-29 17:39:41
7573,531,2,429,55,484,7490,2021-01-29 16:35:19
7574,752,3,658,85,743,7491,2021-01-29 11:18:31
7575,323,2,329,42,371,7492,2021-01-29 13:00:19
7576,811,3,528,68,596,7493,2021-01-29 10:35:45
7577,111,2,628,81,709,7494,2021-01-29 06:20:04
7578,470,3,827,107,934,7495,2021-01-29 00:01:50
7579,95,3,528,68,596,7496,2021-01-28 17:04:19
7580,837,3,608,79,687,7497,2021-01-28 19:28:18
7581,532,2,798,103,901,7498,2021-01-29 00:40:03
7582,59,2,898,116,1014,7499,2021-01-29 02:14:25
7583,188,3,747,97,844,7500,2021-01-29 05:43:51
7584,912,3,797,103,900,7501,2021-01-29 15:53:09
7585,410,3,1127,146,1273,7502,2021-01-29 19:28:52
7586,780,2,598,77,675,7503,2021-01-29 01:20:35
7587,502,3,1127,146,1273,7504,2021-01-29 07:03:56
7588,884,3,528,68,596,7505,2021-01-29 23:19:01
7589,389,3,897,116,1013,7506,2021-01-29 20:13:17
7590,340,3,688,89,777,7507,2021-01-30 05:34:33
7591,196,2,698,90,788,7508,2021-01-29 19:44:29
7592,495,3,578,75,653,7509,2021-01-29 17:02:29
7593,223,3,1027,133,1160,7510,2021-01-29 19:48:05
7594,411,2,448,58,506,7511,2021-01-29 21:28:58
7595,635,2,498,64,562,7512,2021-01-30 01:25:44
7596,366,2,498,64,562,7513,2021-01-29 15:17:18
7597,931,3,1127,146,1273,7514,2021-01-30 09:12:04
7598,116,3,747,97,844,7515,2021-01-30 04:18:44
7599,754,3,847,110,957,7516,2021-01-29 15:09:03
7600,360,3,727,94,821,7517,2021-01-29 14:28:46
7601,197,3,1127,146,1273,7518,2021-01-28 09:17:10
7602,759,3,827,107,934,7519,2021-01-28 23:37:24
7603,393,2,698,90,788,7520,2021-01-29 01:57:38
7604,427,3,597,77,674,7521,2021-01-28 19:22:35
7605,194,3,997,129,1126,7522,2021-01-28 19:22:59
7606,822,3,997,129,1126,7523,2021-01-28 15:19:00
7607,739,5,1775,230,2005,7524,2021-01-28 14:40:59
7608,913,3,1047,136,1183,7525,2021-01-28 20:32:41
7609,952,3,1127,146,1273,7526,2021-01-28 17:44:30
7610,240,3,608,79,687,7527,2021-01-28 19:25:02
7611,492,3,897,116,1013,7528,2021-01-29 00:21:41
7612,817,3,697,90,787,7529,2021-01-28 22:26:44
7613,144,5,2095,272,2367,7530,2021-01-29 07:33:50
7614,151,3,688,89,777,7531,2021-01-29 10:35:09
7615,194,3,658,85,743,7532,2021-01-29 05:44:40
7616,924,3,1327,172,1499,7533,2021-01-28 18:09:08
7617,945,5,1725,224,1949,7534,2021-01-29 00:28:19
7618,859,3,747,97,844,7535,2021-01-29 07:16:14
7619,859,3,747,97,844,7535,2021-01-29 07:16:14
7620,265,6,1524,198,1722,7536,2021-01-28 20:04:26
7621,768,2,898,116,1014,7537,2021-01-28 18:50:39
7622,616,5,1006,130,1136,7538,2021-01-29 03:03:12
7623,71,2,398,51,449,7539,2021-01-29 09:07:49
7624,674,3,758,98,856,7540,2021-01-29 08:25:40
7625,35,3,1027,133,1160,7541,2021-01-29 03:21:16
7626,660,2,798,103,901,7542,2021-01-29 05:28:33
7627,478,2,429,55,484,7543,2021-01-29 10:29:11
7628,164,3,1247,162,1409,7544,2021-01-28 15:22:14
7629,884,5,1426,185,1611,7545,2021-01-28 09:42:25
7630,772,3,947,123,1070,7546,2021-01-28 09:33:26
7631,80,3,558,72,630,7547,2021-01-28 06:35:33
7632,856,3,997,129,1126,7548,2021-01-29 03:16:52
7633,856,3,997,129,1126,7548,2021-01-29 03:16:52
7634,541,3,808,105,913,7549,2021-01-29 08:13:21
7635,995,3,997,129,1126,7550,2021-01-29 07:21:37
7636,176,3,528,68,596,7551,2021-01-29 06:30:36
7637,40,3,827,107,934,7552,2021-01-29 05:48:46
7638,423,3,808,105,913,7553,2021-01-28 20:01:52
7639,17,3,827,107,934,7554,2021-01-28 06:40:15
7640,192,3,997,129,1126,7555,2021-01-27 20:16:45
7641,358,2,898,116,1014,7556,2021-01-28 05:52:54
7642,136,5,1186,154,1340,7557,2021-01-28 05:47:44
7643,834,3,808,105,913,7558,2021-01-28 04:08:26
7644,881,3,578,75,653,7559,2021-01-27 19:34:16
7645,786,2,698,90,788,7560,2021-01-28 04:04:21
7646,749,2,659,85,744,7561,2021-01-28 13:31:23
7647,483,6,1255,163,1418,7562,2021-01-28 12:50:55
7648,161,2,598,77,675,7563,2021-01-28 02:58:14
7649,623,6,1155,150,1305,7564,2021-01-28 13:48:24
7650,990,3,927,120,1047,7565,2021-01-28 22:14:03
7651,950,3,947,123,1070,7566,2021-01-28 21:36:47
7652,918,3,747,97,844,7567,2021-01-28 17:35:44
7653,153,3,428,55,483,7568,2021-01-28 19:20:47
7654,453,5,1356,176,1532,7569,2021-01-28 07:00:47
7655,975,2,748,97,845,7570,2021-01-28 04:53:33
7656,216,3,758,98,856,7571,2021-01-28 09:12:08
7657,727,3,697,90,787,7572,2021-01-28 10:09:53
7658,154,3,997,129,1126,7573,2021-01-28 07:49:40
7659,241,2,659,85,744,7574,2021-01-29 18:37:37
7660,213,3,697,90,787,7575,2021-01-29 19:08:45
7661,386,2,698,90,788,7576,2021-01-29 13:18:25
7662,317,3,808,105,913,7577,2021-01-29 13:08:53
7663,582,3,1027,133,1160,7578,2021-01-29 10:58:38
7664,170,3,688,89,777,7579,2021-01-29 06:26:54
7665,629,3,647,84,731,7580,2021-01-29 01:27:57
7666,17,5,1506,195,1701,7581,2021-01-28 17:13:51
7667,373,3,1047,136,1183,7582,2021-01-28 21:57:00
7668,860,2,398,51,449,7583,2021-01-29 02:23:08
7669,496,2,898,116,1014,7584,2021-01-29 03:21:16
7670,106,2,329,42,371,7585,2021-01-29 08:12:11
7671,964,2,329,42,371,7586,2021-01-29 17:43:00
7672,762,3,597,77,674,7587,2021-01-29 20:47:30
7673,701,1,299,38,337,7588,2021-01-29 03:42:54
7674,767,3,997,129,1126,7589,2021-01-29 08:38:27
7675,876,3,847,110,957,7590,2021-01-30 00:25:07
7676,481,2,548,71,619,7591,2021-01-29 21:19:39
7677,324,2,598,77,675,7592,2021-01-30 06:43:11
7678,263,2,898,116,1014,7593,2021-01-29 22:00:51
7679,41,2,459,59,518,7594,2021-01-29 18:17:11
7680,491,3,727,94,821,7595,2021-01-29 21:31:27
7681,555,3,558,72,630,7596,2021-01-30 00:14:49
7682,860,3,1127,146,1273,7597,2021-01-30 02:57:14
7683,142,3,1127,146,1273,7598,2021-01-29 15:34:27
7684,858,3,647,84,731,7599,2021-01-30 09:15:14
7685,783,3,808,105,913,7600,2021-01-30 06:07:14
7686,613,2,429,55,484,7601,2021-01-29 15:43:05
7687,960,3,847,110,957,7602,2021-01-29 14:41:31
7688,435,3,578,75,653,7603,2021-01-28 10:37:04
7689,496,5,1725,224,1949,7604,2021-01-29 01:18:23
7690,319,2,798,103,901,7605,2021-01-29 03:33:34
7691,663,3,827,107,934,7606,2021-01-28 21:46:30
7692,656,3,1247,162,1409,7607,2021-01-28 20:13:16
7693,345,3,597,77,674,7608,2021-01-28 17:34:36
7694,233,5,1706,221,1927,7609,2021-01-28 16:28:49
7695,392,3,697,90,787,7610,2021-01-28 20:39:14
7696,721,3,827,107,934,7611,2021-01-28 19:28:40
7697,69,2,429,55,484,7612,2021-01-28 21:27:37
7698,933,3,747,97,844,7613,2021-01-29 01:48:14
7699,74,3,997,129,1126,7614,2021-01-28 23:11:51
7700,868,3,797,103,900,7615,2021-01-29 10:12:00
7701,852,1,399,51,450,7616,2021-01-29 12:25:29
7702,547,2,698,90,788,7617,2021-01-29 06:34:07
7703,612,3,808,105,913,7618,2021-01-28 20:22:34
7704,570,3,808,105,913,7619,2021-01-29 00:50:21
7705,106,3,808,105,913,7620,2021-01-29 09:19:41
7706,839,2,748,97,845,7621,2021-01-29 09:55:08
7707,342,3,558,72,630,7622,2021-01-28 22:48:43
7708,966,3,827,107,934,7623,2021-01-28 20:08:38
7709,946,2,548,71,619,7624,2021-01-29 05:03:22
7710,160,3,808,105,913,7625,2021-01-29 09:08:42
7711,945,3,758,98,856,7626,2021-01-29 09:21:39
7712,837,3,1127,146,1273,7627,2021-01-29 04:04:40
7713,808,3,697,90,787,7628,2021-01-29 05:32:37
7714,147,3,997,129,1126,7629,2021-01-29 11:39:23
7715,888,2,598,77,675,7630,2021-01-28 16:43:17
7716,465,2,598,77,675,7631,2021-01-28 12:10:54
7717,752,3,797,103,900,7632,2021-01-28 09:48:16
7718,576,4,1287,167,1454,7633,2021-01-28 09:11:21
7719,159,3,997,129,1126,7634,2021-01-29 05:16:59
7720,150,3,997,129,1126,7635,2021-01-29 04:24:18
7721,673,3,997,129,1126,7636,2021-01-29 10:56:01
7722,957,2,598,77,675,7637,2021-01-29 07:55:21
7723,217,3,697,90,787,7638,2021-01-29 07:25:54
7724,328,2,798,103,901,7639,2021-01-29 07:30:47
7725,213,4,1326,172,1498,7640,2021-01-28 20:28:45
7726,299,3,478,62,540,7641,2021-01-28 07:05:33
7727,785,3,658,85,743,7642,2021-01-27 23:02:19
7728,975,3,827,107,934,7643,2021-01-28 05:56:36
7729,655,3,1197,155,1352,7644,2021-01-28 06:22:41
7730,103,2,1098,142,1240,7645,2021-01-28 06:33:57
7731,191,5,1995,259,2254,7646,2021-01-27 20:33:54
7732,543,2,898,116,1014,7647,2021-01-28 04:43:27
7733,170,1,299,38,337,7648,2021-01-28 16:03:55
7734,526,2,659,85,744,7649,2021-01-28 14:10:28
7735,372,4,1157,150,1307,7650,2021-01-28 03:02:40
7736,961,3,897,116,1013,7651,2021-01-28 16:21:26
7737,896,2,1098,142,1240,7652,2021-01-28 22:54:50
7738,810,2,898,116,1014,7653,2021-01-28 22:38:35
7739,712,3,1047,136,1183,7654,2021-01-28 19:16:49
7740,125,3,428,55,483,7655,2021-01-28 20:32:37
7741,772,3,1197,155,1352,7656,2021-01-28 08:55:46
7742,771,3,658,85,743,7657,2021-01-28 07:01:16
7743,188,3,808,105,913,7658,2021-01-28 09:49:50
7744,110,3,997,129,1126,7659,2021-01-28 12:31:02
7745,272,3,1247,162,1409,7660,2021-01-28 10:35:29
7746,561,2,898,116,1014,7661,2021-01-29 21:12:12
7747,522,3,697,90,787,7662,2021-01-29 19:26:04
7748,93,1,599,77,676,7663,2021-01-29 13:45:15
7749,137,1,499,64,563,7664,2021-01-29 15:42:53
7750,297,3,997,129,1126,7665,2021-01-29 13:38:27
7751,358,2,628,81,709,7666,2021-01-29 06:31:26
7752,849,3,997,129,1126,7667,2021-01-29 02:38:09
7753,515,3,658,85,743,7668,2021-01-28 17:56:43
7754,392,2,898,116,1014,7669,2021-01-29 00:20:44
7755,487,3,827,107,934,7670,2021-01-29 02:35:42
7756,695,3,808,105,913,7671,2021-01-29 05:10:12
7757,383,3,997,129,1126,7672,2021-01-29 10:49:05
7758,838,2,698,90,788,7673,2021-01-29 18:55:20
7759,851,2,598,77,675,7674,2021-01-29 21:24:22
7760,591,2,429,55,484,7675,2021-01-29 05:12:08
7761,77,2,398,51,449,7676,2021-01-29 10:34:50
7762,257,2,659,85,744,7677,2021-01-30 00:46:53
7763,839,2,898,116,1014,7678,2021-01-29 22:59:05
7764,431,5,1795,233,2028,7679,2021-01-30 09:00:41
7765,261,1,499,64,563,7680,2021-01-30 00:06:20
7766,780,4,1096,142,1238,7681,2021-01-29 18:22:49
7767,437,3,647,84,731,7682,2021-01-29 22:42:36
7768,292,3,1327,172,1499,7683,2021-01-30 01:10:25
7769,612,2,528,68,596,7684,2021-01-30 04:04:10
7770,174,3,758,98,856,7685,2021-01-29 18:08:15
7771,75,3,647,84,731,7686,2021-01-30 10:41:30
7772,867,3,558,72,630,7687,2021-01-30 08:31:12
7773,119,3,697,90,787,7688,2021-01-29 16:54:10
7774,303,3,927,120,1047,7689,2021-01-29 14:48:13
7775,230,5,1425,185,1610,7690,2021-01-28 12:56:55
7776,585,2,798,103,901,7691,2021-01-29 01:54:04
7777,294,2,898,116,1014,7692,2021-01-29 04:11:44
7778,273,6,1894,246,2140,7693,2021-01-29 00:32:33
7779,311,5,1575,204,1779,7694,2021-01-28 22:12:47
7780,56,3,1047,136,1183,7695,2021-01-28 19:26:02
7781,60,3,597,77,674,7696,2021-01-28 18:20:44
7782,350,2,459,59,518,7697,2021-01-28 21:13:56
7783,159,3,808,105,913,7698,2021-01-28 21:59:46
7784,283,2,898,116,1014,7699,2021-01-28 21:43:19
7785,520,2,698,90,788,7700,2021-01-29 04:15:51
7786,26,2,598,77,675,7701,2021-01-29 01:14:34
7787,474,2,598,77,675,7702,2021-01-29 10:28:27
7788,313,3,697,90,787,7703,2021-01-29 14:29:57
7789,742,2,898,116,1014,7704,2021-01-29 07:43:54
7790,555,3,997,129,1126,7705,2021-01-28 22:17:15
7791,303,2,1098,142,1240,7706,2021-01-29 03:12:53
7792,553,3,797,103,900,7707,2021-01-29 11:37:55
7793,200,2,798,103,901,7708,2021-01-29 11:37:40
7794,698,3,688,89,777,7709,2021-01-29 00:46:50
7795,784,3,827,107,934,7710,2021-01-28 21:58:29
7796,415,3,647,84,731,7711,2021-01-29 06:54:00
7797,587,3,847,110,957,7712,2021-01-29 09:43:14
7798,404,6,1525,198,1723,7713,2021-01-29 11:48:23
7799,621,3,747,97,844,7714,2021-01-29 05:34:13
7800,960,3,897,116,1013,7715,2021-01-29 06:28:29
7801,788,3,827,107,934,7716,2021-01-29 14:14:16
7802,368,3,997,129,1126,7717,2021-01-28 19:18:38
7803,957,2,728,94,822,7718,2021-01-28 12:33:51
7804,848,2,459,59,518,7719,2021-01-28 10:49:55
7805,918,5,1725,224,1949,7720,2021-01-28 09:40:14
7806,694,5,1556,202,1758,7721,2021-01-29 07:47:55
7807,580,3,1327,172,1499,7722,2021-01-29 06:10:33
7808,103,3,658,85,743,7723,2021-01-29 11:21:27
7809,549,2,598,77,675,7724,2021-01-29 09:58:08
7810,599,3,758,98,856,7725,2021-01-29 09:52:46
7811,386,3,597,77,674,7726,2021-01-29 07:33:45
7812,400,3,428,55,483,7727,2021-01-28 20:46:42
7813,804,2,598,77,675,7728,2021-01-28 08:07:03
7814,881,3,808,105,913,7729,2021-01-28 01:37:46
7815,400,3,1027,133,1160,7730,2021-01-28 07:57:04
7816,965,3,797,103,900,7731,2021-01-28 07:10:48
7817,722,5,1076,139,1215,7732,2021-01-28 09:06:18
7818,420,3,927,120,1047,7733,2021-01-27 21:40:01
7819,712,5,976,126,1102,7734,2021-01-28 05:42:55
7820,497,2,1098,142,1240,7735,2021-01-28 18:29:36
7821,89,3,897,116,1013,7736,2021-01-28 15:46:37
7822,738,2,898,116,1014,7737,2021-01-28 04:00:29
7823,80,2,659,85,744,7738,2021-01-28 16:57:13
7824,335,3,558,72,630,7739,2021-01-28 23:59:56
7825,453,5,2425,315,2740,7740,2021-01-28 23:46:18
7826,980,3,1047,136,1183,7741,2021-01-28 20:05:37
7827,431,2,459,59,518,7742,2021-01-28 20:53:58
7828,308,3,847,110,957,7743,2021-01-28 10:24:43
7829,977,3,578,75,653,7744,2021-01-28 07:45:52
7830,952,3,827,107,934,7745,2021-01-28 12:30:34
7831,534,2,528,68,596,7746,2021-01-28 12:55:57
7832,488,2,1098,142,1240,7747,2021-01-28 11:43:42
7833,146,4,1126,146,1272,7748,2021-01-29 22:16:26
7834,739,3,758,98,856,7749,2021-01-29 21:44:33
7835,75,3,1127,146,1273,7750,2021-01-29 16:25:54
7836,323,2,498,64,562,7751,2021-01-29 16:37:36
7837,74,3,747,97,844,7752,2021-01-29 16:16:26
7838,563,2,459,59,518,7753,2021-01-29 08:35:38
7839,51,2,598,77,675,7754,2021-01-29 04:22:43
7840,281,2,598,77,675,7755,2021-01-28 19:06:21
7841,601,6,1924,250,2174,7756,2021-01-29 02:35:34
7842,996,2,798,103,901,7757,2021-01-29 04:57:25
7843,328,2,598,77,675,7758,2021-01-29 06:38:36
7844,287,6,1955,254,2209,7759,2021-01-29 13:15:23
7845,840,3,827,107,934,7760,2021-01-29 19:31:01
7846,903,2,659,85,744,7761,2021-01-29 23:29:51
7847,552,3,997,129,1126,7762,2021-01-29 06:04:45
7848,684,1,699,90,789,7763,2021-01-29 11:38:26
7849,996,3,947,123,1070,7764,2021-01-30 01:30:30
7850,187,3,1247,162,1409,7765,2021-01-29 23:37:56
7851,91,2,898,116,1014,7766,2021-01-30 10:15:27
7852,19,3,558,72,630,7767,2021-01-30 01:29:31
7853,640,5,1456,189,1645,7768,2021-01-29 20:48:29
7854,122,3,747,97,844,7769,2021-01-30 00:27:10
7855,316,3,808,105,913,7770,2021-01-30 03:45:33
7856,305,3,888,115,1003,7771,2021-01-30 04:27:49
7857,191,2,1098,142,1240,7772,2021-01-29 19:30:53
7858,145,3,827,107,934,7773,2021-01-30 13:02:47
7859,117,5,1625,211,1836,7774,2021-01-30 09:16:45
7860,995,3,1197,155,1352,7775,2021-01-29 18:41:44
7861,742,5,1626,211,1837,7776,2021-01-29 15:39:02
7862,226,3,608,79,687,7777,2021-01-28 15:07:37
7863,381,3,947,123,1070,7778,2021-01-29 02:16:07
7864,997,3,1127,146,1273,7779,2021-01-29 04:48:00
7865,376,2,429,55,484,7780,2021-01-29 01:43:19
7866,431,3,478,62,540,7781,2021-01-28 22:49:16
7867,221,2,598,77,675,7782,2021-01-28 20:44:26
7868,849,3,727,94,821,7783,2021-01-28 18:44:22
7869,402,3,1047,136,1183,7784,2021-01-28 23:07:24
7870,576,5,1326,172,1498,7785,2021-01-28 23:38:56
7871,962,4,956,124,1080,7786,2021-01-28 23:59:20
7872,159,4,907,117,1024,7787,2021-01-29 04:58:04
7873,384,3,1047,136,1183,7788,2021-01-29 02:40:29
7874,819,5,1256,163,1419,7789,2021-01-29 10:35:28
7875,726,3,1247,162,1409,7790,2021-01-29 16:33:37
7876,778,5,1106,143,1249,7791,2021-01-29 08:37:07
7877,448,2,848,110,958,7792,2021-01-28 23:13:58
7878,605,3,688,89,777,7793,2021-01-29 05:40:58
7879,191,2,1098,142,1240,7794,2021-01-29 12:08:23
7880,372,3,597,77,674,7795,2021-01-29 13:58:47
7881,7,2,459,59,518,7796,2021-01-29 02:54:54
7882,475,2,498,64,562,7797,2021-01-28 22:51:14
7883,670,2,898,116,1014,7798,2021-01-29 07:22:40
7884,908,3,428,55,483,7799,2021-01-29 11:38:13
7885,690,6,1854,241,2095,7800,2021-01-29 13:32:54
7886,627,3,478,62,540,7801,2021-01-29 05:43:03
7887,997,3,997,129,1126,7802,2021-01-29 09:08:19
7888,767,1,699,90,789,7803,2021-01-29 15:04:59
7889,642,2,798,103,901,7804,2021-01-28 19:49:21
7890,477,3,1127,146,1273,7805,2021-01-28 14:44:42
7891,388,3,558,72,630,7806,2021-01-28 12:21:33
7892,597,3,428,55,483,7807,2021-01-28 10:08:21
7893,710,2,329,42,371,7808,2021-01-29 09:01:08
7894,411,2,698,90,788,7809,2021-01-29 08:20:47
7895,696,2,698,90,788,7810,2021-01-29 12:39:46
7896,578,2,648,84,732,7811,2021-01-29 11:49:51
7897,36,2,698,90,788,7812,2021-01-29 11:10:25
7898,664,2,498,64,562,7813,2021-01-29 09:16:55
7899,44,5,1475,191,1666,7814,2021-01-28 21:35:25
7900,749,3,1027,133,1160,7815,2021-01-28 09:18:28
7901,673,4,837,108,945,7816,2021-01-28 03:09:19
7902,67,1,99,12,111,7817,2021-01-28 10:13:54
7903,235,2,798,103,901,7818,2021-01-28 08:58:09
7904,373,2,898,116,1014,7819,2021-01-28 09:57:16
7905,373,2,628,81,709,7820,2021-01-27 22:56:13
7906,553,3,758,98,856,7821,2021-01-28 06:14:13
7907,324,3,647,84,731,7822,2021-01-28 20:45:30
7908,406,5,976,126,1102,7823,2021-01-28 17:42:40
7909,268,2,598,77,675,7824,2021-01-28 06:00:45
7910,462,2,648,84,732,7825,2021-01-28 18:48:07
7911,573,3,608,79,687,7826,2021-01-29 02:31:34
7912,691,6,2194,285,2479,7827,2021-01-29 02:14:07
7913,703,5,1606,208,1814,7828,2021-01-28 20:07:08
7914,371,2,898,116,1014,7829,2021-01-28 21:13:20
7915,910,2,459,59,518,7830,2021-01-28 12:03:41
7916,625,2,429,55,484,7831,2021-01-28 08:46:32
7917,453,3,608,79,687,7832,2021-01-28 15:03:34
7918,512,3,608,79,687,7833,2021-01-28 13:04:35
7919,224,2,798,103,901,7834,2021-01-28 12:50:12
7920,524,3,528,68,596,7835,2021-01-29 23:58:44
7921,890,1,229,29,258,7836,2021-01-29 23:37:43
7922,125,3,528,68,596,7837,2021-01-29 18:30:41
7923,268,3,528,68,596,7838,2021-01-29 17:23:52
7924,56,1,299,38,337,7839,2021-01-29 18:48:28
7925,26,3,658,85,743,7840,2021-01-29 09:20:06
7926,279,3,747,97,844,7841,2021-01-29 05:38:19
7927,572,5,1695,220,1915,7842,2021-01-28 21:47:55
7928,608,1,399,51,450,7843,2021-01-29 04:28:38
7929,705,2,429,55,484,7844,2021-01-29 06:22:01
7930,74,2,598,77,675,7845,2021-01-29 09:25:08
7931,926,2,659,85,744,7846,2021-01-29 13:49:45
7932,298,3,597,77,674,7847,2021-01-29 20:08:40
7933,926,3,758,98,856,7848,2021-01-30 00:39:55
7934,296,2,498,64,562,7849,2021-01-29 07:50:40
7935,921,3,597,77,674,7850,2021-01-29 12:36:16
7936,241,2,498,64,562,7851,2021-01-30 03:48:48
7937,387,3,947,123,1070,7852,2021-01-30 00:45:20
7938,929,3,827,107,934,7853,2021-01-30 12:01:20
7939,97,2,628,81,709,7854,2021-01-30 04:00:39
7940,343,5,1725,224,1949,7855,2021-01-29 22:16:17
7941,363,2,598,77,675,7856,2021-01-30 02:04:53
7942,835,4,1646,213,1859,7857,2021-01-30 04:08:18
7943,20,3,747,97,844,7858,2021-01-30 06:37:20
7944,440,3,528,68,596,7859,2021-01-29 21:43:32
7945,631,3,997,129,1126,7860,2021-01-30 14:20:18
7946,822,5,1026,133,1159,7861,2021-01-30 11:19:26
7947,151,3,478,62,540,7862,2021-01-29 20:05:31
7948,482,2,698,90,788,7863,2021-01-29 18:11:28
7949,341,2,898,116,1014,7864,2021-01-28 15:59:05
7950,260,3,1047,136,1183,7865,2021-01-29 03:49:20
7951,52,3,997,129,1126,7866,2021-01-29 06:59:41
7952,785,2,798,103,901,7867,2021-01-29 04:27:48
7953,184,2,459,59,518,7868,2021-01-28 22:52:49
7954,493,3,827,107,934,7869,2021-01-28 21:04:49
7955,414,3,997,129,1126,7870,2021-01-28 21:24:12
7956,549,2,659,85,744,7871,2021-01-29 01:04:59
7957,922,2,429,55,484,7872,2021-01-29 00:20:10
7958,667,3,478,62,540,7873,2021-01-29 00:29:48
7959,683,3,727,94,821,7874,2021-01-29 05:35:25
7960,166,3,947,123,1070,7875,2021-01-29 05:20:06
7961,855,3,1197,155,1352,7876,2021-01-29 12:13:59
7962,985,3,727,94,821,7877,2021-01-29 16:54:26
7963,281,5,1456,189,1645,7878,2021-01-29 09:27:04
7964,456,2,698,90,788,7879,2021-01-28 23:58:32
7965,753,3,808,105,913,7880,2021-01-29 06:08:25
7966,957,3,758,98,856,7881,2021-01-29 14:04:55
7967,564,3,827,107,934,7882,2021-01-29 14:38:43
7968,278,3,997,129,1126,7883,2021-01-29 05:28:36
7969,508,1,299,38,337,7884,2021-01-29 00:13:02
7970,872,2,329,42,371,7885,2021-01-29 08:54:28
7971,345,1,149,19,168,7886,2021-01-29 14:08:37
7972,592,3,747,97,844,7887,2021-01-29 13:48:14
7973,952,3,727,94,821,7888,2021-01-29 08:20:59
7974,1,2,498,64,562,7889,2021-01-29 09:46:23
7975,234,2,498,64,562,7890,2021-01-29 16:29:11
7976,882,3,697,90,787,7891,2021-01-28 22:25:23
7977,188,2,329,42,371,7892,2021-01-28 15:17:17
7978,314,3,697,90,787,7893,2021-01-28 13:03:30
7979,500,3,758,98,856,7894,2021-01-28 12:29:34
7980,642,3,697,90,787,7895,2021-01-29 09:24:40
7981,230,5,1156,150,1306,7896,2021-01-29 09:43:49
7982,867,2,598,77,675,7897,2021-01-29 15:20:00
7983,494,2,798,103,901,7898,2021-01-29 12:36:29
7984,13,3,997,129,1126,7899,2021-01-29 12:17:05
7985,134,3,558,72,630,7900,2021-01-29 11:21:55
7986,570,3,428,55,483,7901,2021-01-28 22:57:02
7987,459,1,299,38,337,7902,2021-01-28 10:33:20
7988,879,3,897,116,1013,7903,2021-01-28 05:46:08
7989,703,3,827,107,934,7904,2021-01-28 12:51:13
7990,852,3,1047,136,1183,7905,2021-01-28 09:15:48
7991,978,3,747,97,844,7906,2021-01-28 11:55:42
7992,571,2,798,103,901,7907,2021-01-28 01:14:34
7993,985,3,847,110,957,7908,2021-01-28 06:49:55
7994,689,3,1127,146,1273,7909,2021-01-28 22:12:49
7995,326,3,827,107,934,7910,2021-01-28 17:58:14
7996,892,2,659,85,744,7911,2021-01-28 08:03:44
7997,362,6,1844,239,2083,7912,2021-01-28 20:01:10
7998,931,3,827,107,934,7913,2021-01-29 04:29:53
7999,449,2,898,116,1014,7914,2021-01-29 04:41:02
8000,796,2,498,64,562,7915,2021-01-28 20:37:45
8001,162,3,727,94,821,7916,2021-01-28 22:43:54
8002,126,5,887,115,1002,7917,2021-01-28 12:58:24
8003,559,2,598,77,675,7918,2021-01-28 08:56:10
8004,25,3,558,72,630,7919,2021-01-28 16:26:21
8005,585,3,827,107,934,7920,2021-01-28 14:50:03
8006,86,2,498,64,562,7921,2021-01-28 15:15:15
8007,400,2,498,64,562,7922,2021-01-30 00:36:56
8008,278,3,1327,172,1499,7923,2021-01-30 02:08:57
8009,923,2,498,64,562,7924,2021-01-29 19:17:41
8010,612,2,898,116,1014,7925,2021-01-29 19:35:58
8011,339,6,1225,159,1384,7926,2021-01-29 20:36:15
8012,457,3,827,107,934,7927,2021-01-29 11:31:07
8013,238,3,1127,146,1273,7928,2021-01-29 06:13:01
8014,782,3,827,107,934,7929,2021-01-28 23:35:53
8015,138,3,578,75,653,7930,2021-01-29 05:51:46
8016,8,5,1356,176,1532,7931,2021-01-29 07:16:24
8017,465,4,946,122,1068,7932,2021-01-29 09:53:27
8018,7,1,699,90,789,7933,2021-01-29 15:19:48
8019,61,3,747,97,844,7934,2021-01-29 20:15:24
8020,657,3,1047,136,1183,7935,2021-01-30 02:43:04
8021,769,3,578,75,653,7936,2021-01-29 10:18:40
8022,919,3,897,116,1013,7937,2021-01-29 13:27:07
8023,774,5,1825,237,2062,7938,2021-01-30 05:10:38
8024,317,3,1197,155,1352,7939,2021-01-30 01:12:31
8025,730,2,459,59,518,7940,2021-01-30 14:16:16
8026,970,3,808,105,913,7941,2021-01-30 05:24:01
8027,237,3,888,115,1003,7942,2021-01-30 00:19:37
8028,706,2,598,77,675,7943,2021-01-30 04:18:40
8029,632,2,1098,142,1240,7944,2021-01-30 05:04:57
8030,435,3,997,129,1126,7945,2021-01-30 06:39:28
8031,110,3,658,85,743,7946,2021-01-29 22:30:51
8032,558,3,947,123,1070,7947,2021-01-30 14:56:59
8033,337,3,1197,155,1352,7948,2021-01-30 12:32:54
8034,195,5,1775,230,2005,7949,2021-01-29 22:19:32
8035,105,3,758,98,856,7950,2021-01-29 20:13:48
8036,264,3,997,129,1126,7951,2021-01-28 16:15:12
8037,787,2,498,64,562,7952,2021-01-29 04:00:59
8038,238,2,659,85,744,7953,2021-01-29 09:36:49
8039,57,3,997,129,1126,7954,2021-01-29 05:50:24
8040,66,5,1126,146,1272,7955,2021-01-28 23:21:14
8041,104,2,598,77,675,7956,2021-01-28 22:54:26
8042,825,3,1047,136,1183,7957,2021-01-28 21:53:56
8043,695,3,897,116,1013,7958,2021-01-29 03:07:47
8044,123,2,459,59,518,7959,2021-01-29 02:06:34
8045,235,2,798,103,901,7960,2021-01-29 01:36:13
8046,50,2,329,42,371,7961,2021-01-29 07:13:00
8047,873,3,428,55,483,7962,2021-01-29 07:46:49
8048,267,5,926,120,1046,7963,2021-01-29 14:00:46
8049,858,1,399,51,450,7964,2021-01-29 17:27:18
8050,487,3,1027,133,1160,7965,2021-01-29 10:50:10
8051,906,2,598,77,675,7966,2021-01-29 02:26:58
8052,842,2,429,55,484,7967,2021-01-29 08:03:30
8053,221,5,1725,224,1949,7968,2021-01-29 15:22:43
8054,808,3,1027,133,1160,7969,2021-01-29 17:06:24
8055,486,1,229,29,258,7970,2021-01-29 06:50:06
8056,145,2,429,55,484,7971,2021-01-29 02:19:41
8057,309,2,698,90,788,7972,2021-01-29 09:53:54
8058,479,3,697,90,787,7973,2021-01-29 15:51:31
8059,772,2,598,77,675,7974,2021-01-29 14:06:35
8060,436,3,747,97,844,7975,2021-01-29 08:44:24
8061,902,3,428,55,483,7976,2021-01-29 12:05:59
8062,895,2,459,59,518,7977,2021-01-29 18:54:03
8063,823,1,399,51,450,7978,2021-01-29 00:35:59
8064,315,3,797,103,900,7979,2021-01-28 17:02:07
8065,333,3,927,120,1047,7980,2021-01-28 14:54:09
8066,942,3,478,62,540,7981,2021-01-28 12:58:20
8067,182,3,747,97,844,7982,2021-01-29 10:51:58
8068,162,2,528,68,596,7983,2021-01-29 10:57:14
8069,57,3,747,97,844,7984,2021-01-29 16:01:26
8070,126,3,478,62,540,7985,2021-01-29 14:20:25
8071,1000,3,688,89,777,7986,2021-01-29 13:31:10
8072,76,3,688,89,777,7987,2021-01-29 13:17:57
8073,86,1,229,29,258,7988,2021-01-28 23:43:09
8074,528,6,1355,176,1531,7989,2021-01-28 12:00:22
8075,27,3,997,129,1126,7990,2021-01-28 06:46:46
8076,827,3,558,72,630,7991,2021-01-28 14:47:50
8077,218,3,558,72,630,7992,2021-01-28 09:50:00
8078,432,3,478,62,540,7993,2021-01-28 13:03:30
8079,617,1,399,51,450,7994,2021-01-28 03:13:16
8080,281,3,888,115,1003,7995,2021-01-28 08:24:20
8081,809,3,727,94,821,7996,2021-01-29 00:54:22
8082,568,2,798,103,901,7997,2021-01-28 18:15:43
8083,215,2,698,90,788,7998,2021-01-28 10:08:35
8084,215,2,698,90,788,7998,2021-01-28 10:08:35
8085,913,3,528,68,596,7999,2021-01-28 21:25:06
8086,780,3,727,94,821,8000,2021-01-29 05:18:14
8087,804,3,478,62,540,8001,2021-01-29 06:34:50
8088,577,5,1945,252,2197,8002,2021-01-28 20:42:59
8089,68,3,608,79,687,8003,2021-01-28 23:53:28
8090,586,3,697,90,787,8004,2021-01-28 14:48:26
8091,627,2,1098,142,1240,8005,2021-01-28 09:42:53
8092,514,3,1127,146,1273,8006,2021-01-28 16:51:11
8093,462,2,329,42,371,8007,2021-01-28 17:07:29
8094,467,3,658,85,743,8008,2021-01-28 16:52:42
8095,527,3,1027,133,1160,8009,2021-01-30 03:16:43
8096,255,2,459,59,518,8010,2021-01-30 03:51:26
8097,671,3,747,97,844,8011,2021-01-29 21:43:42
8098,902,2,698,90,788,8012,2021-01-29 20:44:35
8099,942,2,598,77,675,8013,2021-01-29 23:07:27
8100,721,3,597,77,674,8014,2021-01-29 12:05:30
8101,590,5,1156,150,1306,8015,2021-01-29 08:13:25
8102,925,5,1026,133,1159,8016,2021-01-29 00:47:46
8103,520,3,727,94,821,8017,2021-01-29 07:42:03
8104,717,3,747,97,844,8018,2021-01-29 08:18:42
8105,959,3,1047,136,1183,8019,2021-01-29 10:30:37
8106,819,2,329,42,371,8020,2021-01-29 15:52:10
8107,451,2,429,55,484,8021,2021-01-29 22:58:21
8108,958,5,1356,176,1532,8022,2021-01-30 04:25:59
8109,407,3,747,97,844,8023,2021-01-29 12:47:40
8110,428,3,947,123,1070,8024,2021-01-29 14:13:32
8111,17,2,728,94,822,8025,2021-01-30 05:43:03
8112,414,2,448,58,506,8026,2021-01-30 03:08:31
8113,211,2,698,90,788,8027,2021-01-30 14:28:02
8114,932,2,498,64,562,8028,2021-01-30 06:54:40
8115,91,3,927,120,1047,8029,2021-01-30 00:58:23
8116,313,6,2024,263,2287,8030,2021-01-30 06:25:01
8117,97,2,498,64,562,8031,2021-01-30 07:09:02
8118,727,4,977,127,1104,8032,2021-01-30 07:13:31
8119,602,2,628,81,709,8033,2021-01-29 22:39:42
8120,950,2,598,77,675,8034,2021-01-30 16:03:11
8121,639,3,727,94,821,8035,2021-01-30 14:23:34
8122,376,1,499,64,563,8036,2021-01-30 00:04:18
8123,32,3,997,129,1126,8037,2021-01-29 20:35:37
8124,728,2,1098,142,1240,8038,2021-01-28 17:44:41
8125,17,5,1706,221,1927,8039,2021-01-29 06:47:34
8126,944,2,1098,142,1240,8040,2021-01-29 11:41:45
8127,682,5,1525,198,1723,8041,2021-01-29 08:26:45
8128,521,3,597,77,674,8042,2021-01-28 23:45:35
8129,631,2,448,58,506,8043,2021-01-28 23:04:32
8130,410,5,1906,247,2153,8044,2021-01-28 21:58:52
8131,205,2,598,77,675,8045,2021-01-29 03:54:12
8132,24,2,429,55,484,8046,2021-01-29 04:08:18
8133,352,3,578,75,653,8047,2021-01-29 01:54:13
8134,968,2,1098,142,1240,8048,2021-01-29 09:55:25
8135,177,2,659,85,744,8049,2021-01-29 10:31:29
8136,370,2,598,77,675,8050,2021-01-29 14:11:34
8137,1000,2,329,42,371,8051,2021-01-29 18:08:13
8138,280,3,558,72,630,8052,2021-01-29 11:29:39
8139,683,3,597,77,674,8053,2021-01-29 03:10:03
8140,97,2,659,85,744,8054,2021-01-29 09:50:19
8141,802,2,548,71,619,8055,2021-01-29 17:45:56
8142,834,2,628,81,709,8056,2021-01-29 18:32:20
8143,487,4,1096,142,1238,8057,2021-01-29 08:05:19
8144,902,3,558,72,630,8058,2021-01-29 03:44:04
8145,565,3,1247,162,1409,8059,2021-01-29 11:56:13
8146,310,1,499,64,563,8060,2021-01-29 18:21:54
8147,81,2,698,90,788,8061,2021-01-29 14:30:55
8148,650,3,797,103,900,8062,2021-01-29 08:56:47
8149,87,2,698,90,788,8063,2021-01-29 13:10:32
8150,261,3,478,62,540,8064,2021-01-29 20:41:09
8151,903,2,898,116,1014,8065,2021-01-29 00:47:06
8152,826,3,758,98,856,8066,2021-01-28 17:45:26
8153,626,3,997,129,1126,8067,2021-01-28 15:06:08
8154,906,4,1146,148,1294,8068,2021-01-28 15:40:18
8155,673,3,558,72,630,8069,2021-01-29 11:48:44
8156,282,2,798,103,901,8070,2021-01-29 12:04:56
8157,188,3,847,110,957,8071,2021-01-29 17:04:05
8158,900,3,428,55,483,8072,2021-01-29 15:58:16
8159,547,3,997,129,1126,8073,2021-01-29 14:19:21
8160,653,2,1098,142,1240,8074,2021-01-29 15:59:09
8161,477,3,897,116,1013,8075,2021-01-29 02:03:22
8162,362,3,827,107,934,8076,2021-01-28 14:39:07
8163,325,2,498,64,562,8077,2021-01-28 08:41:53
8164,942,2,598,77,675,8078,2021-01-28 17:32:54
8165,308,3,578,75,653,8079,2021-01-28 10:47:53
8166,226,3,797,103,900,8080,2021-01-28 14:17:14
8167,904,2,898,116,1014,8081,2021-01-28 05:33:36
8168,608,2,659,85,744,8082,2021-01-28 09:03:55
8169,729,3,927,120,1047,8083,2021-01-29 01:52:58
8170,545,2,798,103,901,8084,2021-01-28 19:44:06
8171,933,3,1047,136,1183,8085,2021-01-28 11:43:29
8172,425,2,598,77,675,8086,2021-01-28 11:24:43
8173,320,2,898,116,1014,8087,2021-01-28 22:57:42
8174,479,2,329,42,371,8088,2021-01-29 05:52:17
8175,796,2,498,64,562,8089,2021-01-29 08:56:00
8176,254,4,946,122,1068,8090,2021-01-28 21:22:31
8177,620,3,558,72,630,8091,2021-01-29 02:10:25
8178,171,4,1296,168,1464,8092,2021-01-28 15:34:53
8179,58,2,459,59,518,8093,2021-01-28 10:58:30
8180,492,5,1506,195,1701,8094,2021-01-28 16:58:22
8181,502,3,478,62,540,8095,2021-01-28 19:17:59
8182,473,2,1098,142,1240,8096,2021-01-28 19:14:31
8183,862,2,659,85,744,8097,2021-01-30 03:39:59
8184,52,2,698,90,788,8098,2021-01-30 05:25:44
8185,419,5,1356,176,1532,8099,2021-01-30 00:04:43
8186,92,2,498,64,562,8100,2021-01-29 22:51:46
8187,285,3,658,85,743,8101,2021-01-29 23:49:05
8188,404,3,1047,136,1183,8102,2021-01-29 13:11:15
8189,517,2,798,103,901,8103,2021-01-29 10:02:59
8190,408,3,927,120,1047,8104,2021-01-29 03:17:09
8191,375,3,1027,133,1160,8105,2021-01-29 08:24:38
8192,518,3,997,129,1126,8106,2021-01-29 08:31:47
8193,149,1,399,51,450,8107,2021-01-29 11:59:48
8194,159,6,1316,171,1487,8108,2021-01-29 17:50:28
8195,297,5,1845,239,2084,8109,2021-01-30 01:28:57
8196,984,2,498,64,562,8110,2021-01-30 04:49:00
8197,159,6,1785,232,2017,8111,2021-01-29 14:58:56
8198,775,3,428,55,483,8112,2021-01-29 15:43:51
8199,498,3,697,90,787,8113,2021-01-30 06:37:20
8200,672,3,888,115,1003,8114,2021-01-30 03:38:15
8201,650,4,658,85,743,8115,2021-01-30 15:45:19
8202,807,1,99,12,111,8116,2021-01-30 07:51:55
8203,85,5,1575,204,1779,8117,2021-01-30 01:11:39
8204,388,3,927,120,1047,8118,2021-01-30 07:48:34
8205,50,3,558,72,630,8119,2021-01-30 08:52:56
8206,227,2,429,55,484,8120,2021-01-30 09:59:43
8207,46,1,299,38,337,8121,2021-01-29 23:56:34
8208,371,2,598,77,675,8122,2021-01-30 16:15:16
8209,599,2,459,59,518,8123,2021-01-30 16:04:41
8210,461,3,797,103,900,8124,2021-01-30 01:25:47
8211,964,3,1047,136,1183,8125,2021-01-29 22:33:50
8212,465,3,808,105,913,8126,2021-01-28 20:24:00
8213,893,3,758,98,856,8127,2021-01-29 07:55:26
8214,765,2,498,64,562,8128,2021-01-29 14:03:03
8215,901,3,897,116,1013,8129,2021-01-29 08:53:32
8216,416,3,758,98,856,8130,2021-01-29 00:43:27
8217,66,3,688,89,777,8131,2021-01-28 23:05:16
8218,921,3,1127,146,1273,8132,2021-01-28 23:58:27
8219,184,2,498,64,562,8133,2021-01-29 06:09:31
8220,827,2,459,59,518,8134,2021-01-29 04:11:46
8221,447,3,758,98,856,8135,2021-01-29 03:41:29
8222,895,3,827,107,934,8136,2021-01-29 12:14:25
8223,518,1,399,51,450,8137,2021-01-29 11:00:17
8224,204,6,1515,196,1711,8138,2021-01-29 15:31:32
8225,204,6,1515,196,1711,8138,2021-01-29 15:31:32
8226,46,2,659,85,744,8139,2021-01-29 19:20:35
8227,377,4,1376,178,1554,8140,2021-01-29 13:11:59
8228,751,2,598,77,675,8141,2021-01-29 05:50:49
8229,634,3,827,107,934,8142,2021-01-29 12:06:42
8230,565,2,898,116,1014,8143,2021-01-29 20:27:14
8231,583,3,478,62,540,8144,2021-01-29 19:14:21
8232,590,2,598,77,675,8145,2021-01-29 08:37:55
8233,367,3,797,103,900,8146,2021-01-29 05:03:06
8234,362,2,459,59,518,8147,2021-01-29 13:58:10
8235,897,3,827,107,934,8148,2021-01-29 20:12:52
8236,84,3,647,84,731,8149,2021-01-29 14:31:04
8237,996,3,727,94,821,8150,2021-01-29 10:02:58
8238,84,3,428,55,483,8151,2021-01-29 15:14:59
8239,799,3,558,72,630,8152,2021-01-29 21:15:11
8240,674,3,947,123,1070,8153,2021-01-29 01:26:28
8241,353,3,797,103,900,8154,2021-01-28 19:52:46
8242,204,5,1276,165,1441,8155,2021-01-28 15:18:38
8243,835,2,459,59,518,8156,2021-01-28 15:40:42
8244,870,3,797,103,900,8157,2021-01-29 13:10:58
8245,505,3,428,55,483,8158,2021-01-29 14:21:58
8246,163,3,808,105,913,8159,2021-01-29 17:53:11
8247,791,1,399,51,450,8160,2021-01-29 18:37:55
8248,441,3,758,98,856,8161,2021-01-29 15:37:45
8249,799,3,1047,136,1183,8162,2021-01-29 16:13:44
8250,610,1,299,38,337,8163,2021-01-29 02:27:47
8251,958,6,986,128,1114,8164,2021-01-28 15:46:23
8252,16,2,459,59,518,8165,2021-01-28 08:51:51
8253,631,1,149,19,168,8166,2021-01-28 19:04:09
8254,324,2,329,42,371,8167,2021-01-28 11:13:36
8255,48,5,1256,163,1419,8168,2021-01-28 14:44:49
8256,810,2,798,103,901,8169,2021-01-28 07:09:10
8257,588,5,926,120,1046,8170,2021-01-28 11:14:58
8258,944,3,1127,146,1273,8171,2021-01-29 02:43:16
8259,934,3,1247,162,1409,8172,2021-01-28 21:53:33
8260,491,2,798,103,901,8173,2021-01-28 13:06:17
8261,123,2,598,77,675,8174,2021-01-28 12:51:43
8262,612,4,1296,168,1464,8175,2021-01-29 00:39:55
8263,949,3,697,90,787,8176,2021-01-29 07:15:08
8264,335,1,499,64,563,8177,2021-01-29 11:16:55
8265,832,1,599,77,676,8178,2021-01-29 00:07:26
8266,145,3,1127,146,1273,8179,2021-01-29 02:13:23
8267,555,5,1595,207,1802,8180,2021-01-28 16:54:52
8268,830,3,558,72,630,8181,2021-01-28 11:59:45
8269,700,2,429,55,484,8182,2021-01-28 19:05:17
8270,219,3,927,120,1047,8183,2021-01-28 19:47:27
8271,574,3,847,110,957,8184,2021-01-28 19:34:15
8272,886,3,1047,136,1183,8185,2021-01-30 05:00:51
8273,117,2,429,55,484,8186,2021-01-30 05:48:26
8274,168,2,498,64,562,8187,2021-01-30 01:23:52
8275,120,5,1345,174,1519,8188,2021-01-30 00:06:10
8276,898,3,578,75,653,8189,2021-01-30 01:37:18
8277,16,1,299,38,337,8190,2021-01-29 14:49:09
8278,977,3,1497,194,1691,8191,2021-01-29 12:16:40
8279,176,5,1145,148,1293,8192,2021-01-29 04:56:38
8280,828,2,898,116,1014,8193,2021-01-29 09:25:20
8281,947,6,2374,308,2682,8194,2021-01-29 08:36:52
8282,184,2,459,59,518,8195,2021-01-29 13:04:43
8283,717,2,598,77,675,8196,2021-01-29 20:17:49
8284,721,2,698,90,788,8197,2021-01-30 03:33:41
8285,540,3,1047,136,1183,8198,2021-01-30 07:32:11
8286,626,3,688,89,777,8199,2021-01-29 16:39:38
8287,260,3,827,107,934,8200,2021-01-29 17:00:30
8288,646,3,647,84,731,8201,2021-01-30 08:28:00
8289,341,3,727,94,821,8202,2021-01-30 05:52:58
8290,579,2,498,64,562,8203,2021-01-30 16:35:42
8291,394,3,1047,136,1183,8204,2021-01-30 09:08:26
8292,446,3,1047,136,1183,8205,2021-01-30 02:30:49
8293,959,3,1247,162,1409,8206,2021-01-30 08:07:43
8294,330,3,647,84,731,8207,2021-01-30 11:02:48
8295,986,3,697,90,787,8208,2021-01-30 11:46:25
8296,6,2,459,59,518,8209,2021-01-30 00:32:12
8297,391,3,827,107,934,8210,2021-01-30 17:59:37
8298,549,3,647,84,731,8211,2021-01-30 17:25:40
8299,631,6,1724,224,1948,8212,2021-01-30 03:58:02
8300,414,4,1357,176,1533,8213,2021-01-29 23:13:35
8301,448,5,1106,143,1249,8214,2021-01-28 22:47:37
8302,147,5,907,117,1024,8215,2021-01-29 10:03:52
8303,332,2,598,77,675,8216,2021-01-29 16:35:33
8304,84,3,658,85,743,8217,2021-01-29 10:34:30
8305,450,3,727,94,821,8218,2021-01-29 01:05:17
8306,131,3,997,129,1126,8219,2021-01-28 23:16:13
8307,314,2,898,116,1014,8220,2021-01-29 00:37:44
8308,659,3,808,105,913,8221,2021-01-29 07:06:49
8309,104,4,1296,168,1464,8222,2021-01-29 06:32:29
8310,921,2,898,116,1014,8223,2021-01-29 05:53:17
8311,635,3,578,75,653,8224,2021-01-29 12:24:06
8312,907,3,727,94,821,8225,2021-01-29 13:13:05
8313,172,3,747,97,844,8226,2021-01-29 17:37:59
8314,924,2,329,42,371,8227,2021-01-29 17:54:38
8315,510,2,459,59,518,8228,2021-01-29 20:57:07
8316,439,3,847,110,957,8229,2021-01-29 14:19:53
8317,198,3,1047,136,1183,8230,2021-01-29 07:34:15
8318,798,3,688,89,777,8231,2021-01-29 12:43:22
8319,646,3,1027,133,1160,8232,2021-01-29 21:08:59
8320,635,3,1047,136,1183,8233,2021-01-29 20:10:23
8321,893,5,1545,200,1745,8234,2021-01-29 10:41:38
8322,744,6,1815,235,2050,8235,2021-01-29 05:26:18
8323,210,3,997,129,1126,8236,2021-01-29 14:16:42
8324,236,4,1426,185,1611,8237,2021-01-29 21:55:48
8325,192,3,688,89,777,8238,2021-01-29 16:26:28
8326,404,2,498,64,562,8239,2021-01-29 12:18:35
8327,194,2,798,103,901,8240,2021-01-29 17:51:40
8328,86,3,1047,136,1183,8241,2021-01-29 22:24:54
8329,802,3,808,105,913,8242,2021-01-29 02:14:35
8330,955,5,1325,172,1497,8243,2021-01-28 22:01:19
8331,551,6,1544,200,1744,8244,2021-01-28 16:11:31
8332,982,3,647,84,731,8245,2021-01-28 15:44:33
8333,156,3,927,120,1047,8246,2021-01-29 15:47:14
8334,735,3,697,90,787,8247,2021-01-29 14:59:13
8335,48,3,1247,162,1409,8248,2021-01-29 20:03:29
8336,901,2,898,116,1014,8249,2021-01-29 21:08:31
8337,213,2,598,77,675,8250,2021-01-29 17:09:02
8338,531,2,429,55,484,8251,2021-01-29 17:41:38
8339,302,2,1098,142,1240,8252,2021-01-29 05:04:13
8340,601,3,947,123,1070,8253,2021-01-28 17:37:07
8341,610,2,898,116,1014,8254,2021-01-28 10:36:14
8342,115,4,1526,198,1724,8255,2021-01-28 20:34:21
8343,786,2,598,77,675,8256,2021-01-28 13:10:19
8344,751,3,747,97,844,8257,2021-01-28 16:09:23
8345,133,3,647,84,731,8258,2021-01-28 07:38:56
8346,286,3,558,72,630,8259,2021-01-28 11:56:24
8347,500,2,598,77,675,8260,2021-01-29 04:15:13
8348,201,2,659,85,744,8261,2021-01-29 00:16:47
8349,617,5,1455,189,1644,8262,2021-01-28 14:03:23
8350,521,3,1197,155,1352,8263,2021-01-28 14:51:14
8351,72,2,459,59,518,8264,2021-01-29 01:29:40
8352,856,2,429,55,484,8265,2021-01-29 07:33:30
8353,108,1,299,38,337,8266,2021-01-29 12:22:03
8354,108,1,299,38,337,8266,2021-01-29 12:22:03
8355,165,2,329,42,371,8267,2021-01-29 02:25:15
8356,553,2,898,116,1014,8268,2021-01-29 04:54:36
8357,790,3,927,120,1047,8269,2021-01-28 17:24:33
8358,688,4,1077,140,1217,8270,2021-01-28 13:07:17
8359,440,3,1197,155,1352,8271,2021-01-28 21:39:41
8360,440,3,1197,155,1352,8271,2021-01-28 21:39:41
8361,780,2,1098,142,1240,8272,2021-01-28 20:00:21
8362,686,2,898,116,1014,8273,2021-01-28 19:49:03
8363,133,2,898,116,1014,8274,2021-01-30 05:59:10
8364,173,2,429,55,484,8275,2021-01-30 08:12:26
8365,330,6,1824,237,2061,8276,2021-01-30 02:46:02
8366,659,1,99,12,111,8277,2021-01-30 02:35:59
8367,546,3,558,72,630,8278,2021-01-30 03:41:43
8368,546,3,558,72,630,8278,2021-01-30 03:41:43
8369,996,1,229,29,258,8279,2021-01-29 17:22:27
8370,665,3,997,129,1126,8280,2021-01-29 13:48:54
8371,665,3,997,129,1126,8280,2021-01-29 13:48:54
8372,963,3,697,90,787,8281,2021-01-29 05:54:04
8373,56,5,1845,239,2084,8282,2021-01-29 10:38:26
8374,119,3,478,62,540,8283,2021-01-29 10:04:35
8375,798,3,1197,155,1352,8284,2021-01-29 13:38:09
8376,213,2,1098,142,1240,8285,2021-01-29 22:29:37
8377,683,3,747,97,844,8286,2021-01-30 06:07:42
8378,269,3,428,55,483,8287,2021-01-30 09:51:52
8379,538,2,498,64,562,8288,2021-01-29 18:35:06
8380,849,5,1855,241,2096,8289,2021-01-29 19:24:24
8381,117,2,798,103,901,8290,2021-01-30 09:01:18
8382,640,2,329,42,371,8291,2021-01-30 08:15:48
8383,290,3,697,90,787,8292,2021-01-30 18:51:16
8384,296,2,928,120,1048,8293,2021-01-30 11:02:06
8385,219,2,429,55,484,8294,2021-01-30 03:20:05
8386,519,2,898,116,1014,8295,2021-01-30 08:49:09
8387,784,3,558,72,630,8296,2021-01-30 12:14:47
8388,821,3,727,94,821,8297,2021-01-30 11:48:56
8389,339,3,888,115,1003,8298,2021-01-30 02:05:45
8390,80,2,498,64,562,8299,2021-01-30 18:31:40
8391,922,5,1795,233,2028,8300,2021-01-30 18:51:56
8392,827,3,747,97,844,8301,2021-01-30 06:33:42
8393,911,5,1586,206,1792,8302,2021-01-29 23:24:59
8394,500,2,898,116,1014,8303,2021-01-28 23:03:31
8395,143,1,229,29,258,8304,2021-01-29 12:47:08
8396,67,6,1605,208,1813,8305,2021-01-29 18:17:13
8397,846,2,498,64,562,8306,2021-01-29 11:36:42
8398,660,2,798,103,901,8307,2021-01-29 02:02:13
8399,57,3,1127,146,1273,8308,2021-01-28 23:44:33
8400,430,2,598,77,675,8309,2021-01-29 02:42:13
8401,909,1,149,19,168,8310,2021-01-29 08:28:41
8402,359,2,329,42,371,8311,2021-01-29 07:18:11
8403,476,3,697,90,787,8312,2021-01-29 07:33:28
8404,507,6,1485,193,1678,8313,2021-01-29 13:00:06
8405,117,3,658,85,743,8314,2021-01-29 14:13:25
8406,380,2,459,59,518,8315,2021-01-29 18:39:21
8407,885,3,578,75,653,8316,2021-01-29 20:09:30
8408,637,3,1327,172,1499,8317,2021-01-29 23:42:42
8409,844,3,1197,155,1352,8318,2021-01-29 15:33:57
8410,98,3,658,85,743,8319,2021-01-29 08:54:48
8411,761,2,598,77,675,8320,2021-01-29 13:04:14
8412,795,5,1676,217,1893,8321,2021-01-29 22:31:39
8413,474,3,747,97,844,8322,2021-01-29 20:16:53
8414,776,3,847,110,957,8323,2021-01-29 10:44:32
8415,338,3,697,90,787,8324,2021-01-29 05:34:10
8416,95,3,528,68,596,8325,2021-01-29 14:27:24
8417,41,2,429,55,484,8326,2021-01-29 23:07:14
8418,216,3,697,90,787,8327,2021-01-29 16:35:56
8419,894,3,478,62,540,8328,2021-01-29 13:40:46
8420,742,3,797,103,900,8329,2021-01-29 19:49:40
8421,917,6,1894,246,2140,8330,2021-01-29 23:11:02
8422,188,2,748,97,845,8331,2021-01-29 04:34:02
8423,88,2,698,90,788,8332,2021-01-29 00:46:31
8424,681,3,827,107,934,8333,2021-01-28 16:42:47
8425,875,3,697,90,787,8334,2021-01-28 16:49:31
8426,574,2,1098,142,1240,8335,2021-01-29 16:28:25
8427,365,6,1305,169,1474,8336,2021-01-29 15:21:14
8428,405,3,1047,136,1183,8337,2021-01-29 21:53:50
8429,613,3,727,94,821,8338,2021-01-29 21:45:35
8430,73,5,1645,213,1858,8339,2021-01-29 17:20:51
8431,533,3,1247,162,1409,8340,2021-01-29 19:43:57
8432,316,2,1098,142,1240,8341,2021-01-29 07:25:38
8433,770,3,1047,136,1183,8342,2021-01-28 19:46:27
8434,781,2,1098,142,1240,8343,2021-01-28 11:22:08
8435,752,3,727,94,821,8344,2021-01-28 23:05:06
8436,782,3,558,72,630,8345,2021-01-28 14:23:33
8437,706,2,459,59,518,8346,2021-01-28 18:13:50
8438,383,2,598,77,675,8347,2021-01-28 07:52:25
8439,435,6,2085,271,2356,8348,2021-01-28 14:28:52
8440,652,3,1047,136,1183,8349,2021-01-29 05:20:15
8441,791,3,597,77,674,8350,2021-01-29 02:38:49
8442,527,2,748,97,845,8351,2021-01-28 14:45:16
8443,184,3,658,85,743,8352,2021-01-28 16:31:42
8444,59,2,498,64,562,8353,2021-01-29 03:01:17
8445,142,2,598,77,675,8354,2021-01-29 09:15:03
8446,766,3,1247,162,1409,8355,2021-01-29 14:47:29
8447,399,2,429,55,484,8356,2021-01-29 14:46:34
8448,603,3,1247,162,1409,8357,2021-01-29 04:47:38
8449,190,3,697,90,787,8358,2021-01-29 05:53:24
8450,488,3,597,77,674,8359,2021-01-28 18:58:00
8451,940,2,429,55,484,8360,2021-01-28 13:52:05
8452,654,2,748,97,845,8361,2021-01-28 23:47:22
8453,170,3,478,62,540,8362,2021-01-28 22:47:48
8454,335,2,798,103,901,8363,2021-01-28 22:42:58
8455,934,5,1195,155,1350,8364,2021-01-28 20:59:20
8456,669,2,329,42,371,8365,2021-01-30 06:21:26
8457,850,3,758,98,856,8366,2021-01-30 08:21:00
8458,619,3,808,105,913,8367,2021-01-30 04:04:54
8459,599,1,149,19,168,8368,2021-01-30 04:48:24
8460,233,4,1257,163,1420,8369,2021-01-30 05:39:07
8461,96,2,459,59,518,8370,2021-01-30 05:02:07
8462,419,2,598,77,675,8371,2021-01-29 19:48:26
8463,41,3,578,75,653,8372,2021-01-29 15:31:46
8464,520,5,1395,181,1576,8373,2021-01-29 14:12:17
8465,856,4,1846,239,2085,8374,2021-01-29 07:27:13
8466,418,2,628,81,709,8375,2021-01-29 10:45:12
8467,324,2,628,81,709,8376,2021-01-29 12:42:45
8468,245,2,898,116,1014,8377,2021-01-29 15:58:15
8469,264,3,747,97,844,8378,2021-01-29 23:12:20
8470,82,2,798,103,901,8379,2021-01-30 07:02:58
8471,35,3,888,115,1003,8380,2021-01-30 10:24:49
8472,511,3,1247,162,1409,8381,2021-01-29 19:37:04
8473,315,3,758,98,856,8382,2021-01-29 20:04:04
8474,16,3,658,85,743,8383,2021-01-30 10:28:21
8475,156,3,827,107,934,8384,2021-01-30 09:50:58
8476,317,3,428,55,483,8385,2021-01-30 19:38:04
8477,169,2,698,90,788,8386,2021-01-30 12:34:12
8478,160,5,1906,247,2153,8387,2021-01-30 03:22:59
8479,372,3,558,72,630,8388,2021-01-30 10:19:20
8480,383,3,997,129,1126,8389,2021-01-30 13:49:21
8481,63,3,1127,146,1273,8390,2021-01-30 13:59:17
8482,780,2,598,77,675,8391,2021-01-30 04:11:41
8483,577,2,1098,142,1240,8392,2021-01-30 20:15:24
8484,931,2,898,116,1014,8393,2021-01-30 19:16:49
8485,5,3,1127,146,1273,8394,2021-01-30 08:33:06
8486,200,3,747,97,844,8395,2021-01-30 00:16:05
8487,859,2,498,64,562,8396,2021-01-29 00:20:43
8488,305,3,827,107,934,8397,2021-01-29 14:23:15
8489,300,3,1127,146,1273,8398,2021-01-29 20:23:08
8490,470,3,1247,162,1409,8399,2021-01-29 12:10:28
8491,923,6,1685,219,1904,8400,2021-01-29 03:26:45
8492,666,3,428,55,483,8401,2021-01-29 00:29:01
8493,800,2,429,55,484,8402,2021-01-29 03:15:34
8494,292,3,827,107,934,8403,2021-01-29 08:38:25
8495,712,2,329,42,371,8404,2021-01-29 08:16:11
8496,424,3,1027,133,1160,8405,2021-01-29 07:55:47
8497,583,2,329,42,371,8406,2021-01-29 15:33:22
8498,371,3,758,98,856,8407,2021-01-29 14:48:46
8499,58,2,598,77,675,8408,2021-01-29 19:08:14
8500,830,3,608,79,687,8409,2021-01-29 20:48:54
8501,830,3,747,97,844,8410,2021-01-30 01:25:54
8502,841,2,1098,142,1240,8411,2021-01-29 16:19:18
8503,374,2,598,77,675,8412,2021-01-29 10:36:50
8504,500,5,1326,172,1498,8413,2021-01-29 13:23:12
8505,741,2,459,59,518,8414,2021-01-30 00:35:01
8506,362,2,498,64,562,8415,2021-01-29 20:31:06
8507,159,2,898,116,1014,8416,2021-01-29 12:40:11
8508,342,4,1726,224,1950,8417,2021-01-29 05:39:01
8509,235,6,1944,252,2196,8418,2021-01-29 15:12:39
8510,635,2,659,85,744,8419,2021-01-29 23:52:04
8511,948,3,1247,162,1409,8420,2021-01-29 18:50:11
8512,705,1,699,90,789,8421,2021-01-29 14:48:41
8513,52,2,898,116,1014,8422,2021-01-29 21:48:04
8514,781,3,827,107,934,8423,2021-01-30 01:22:11
8515,781,3,827,107,934,8423,2021-01-30 01:22:11
8516,620,3,688,89,777,8424,2021-01-29 05:10:52
8517,96,5,1825,237,2062,8425,2021-01-29 02:09:21
8518,903,3,428,55,483,8426,2021-01-28 17:50:55
8519,120,3,808,105,913,8427,2021-01-28 19:13:15
8520,731,3,847,110,957,8428,2021-01-29 17:34:17
8521,579,2,898,116,1014,8429,2021-01-29 16:52:37
8522,364,3,747,97,844,8430,2021-01-29 23:32:24
8523,893,3,478,62,540,8431,2021-01-29 22:45:09
8524,952,3,697,90,787,8432,2021-01-29 17:36:35
8525,879,2,659,85,744,8433,2021-01-29 21:54:39
8526,537,3,1127,146,1273,8434,2021-01-29 07:39:08
8527,846,3,1027,133,1160,8435,2021-01-28 21:29:21
8528,297,2,659,85,744,8436,2021-01-28 12:34:46
8529,680,3,758,98,856,8437,2021-01-29 00:45:31
8530,92,5,1126,146,1272,8438,2021-01-28 14:51:52
8531,397,2,329,42,371,8439,2021-01-28 18:32:12
8532,604,3,927,120,1047,8440,2021-01-28 10:03:11
8533,766,2,459,59,518,8441,2021-01-28 14:41:04
8534,36,2,628,81,709,8442,2021-01-29 06:20:59
8535,663,5,1026,133,1159,8443,2021-01-29 05:11:31
8536,605,5,1217,158,1375,8444,2021-01-28 16:47:37
8537,649,2,798,103,901,8445,2021-01-28 18:18:49
8538,140,2,598,77,675,8446,2021-01-29 04:22:05
8539,383,3,1327,172,1499,8447,2021-01-29 09:48:18
8540,783,4,1387,180,1567,8448,2021-01-29 16:33:25
8541,960,6,1694,220,1914,8449,2021-01-29 16:06:42
8542,572,6,1446,187,1633,8450,2021-01-29 05:00:55
8543,329,3,428,55,483,8451,2021-01-29 06:35:19
8544,393,3,847,110,957,8452,2021-01-28 19:42:28
8545,528,2,498,64,562,8453,2021-01-28 15:43:47
8546,215,2,429,55,484,8454,2021-01-29 00:44:24
8547,487,3,1127,146,1273,8455,2021-01-29 00:43:02
8548,209,3,947,123,1070,8456,2021-01-28 23:35:54
8549,587,2,698,90,788,8457,2021-01-28 23:16:07
8550,360,6,1694,220,1914,8458,2021-01-30 08:16:16
8551,53,3,558,72,630,8459,2021-01-30 09:58:18
8552,319,3,428,55,483,8460,2021-01-30 06:14:22
8553,319,3,428,55,483,8460,2021-01-30 06:14:22
8554,937,2,459,59,518,8461,2021-01-30 06:58:16
8555,823,6,1344,174,1518,8462,2021-01-30 06:52:31
8556,456,3,558,72,630,8463,2021-01-30 07:34:42
8557,42,3,597,77,674,8464,2021-01-29 20:35:19
8558,66,2,628,81,709,8465,2021-01-29 16:22:42
8559,923,3,428,55,483,8466,2021-01-29 15:27:39
8560,314,4,1096,142,1238,8467,2021-01-29 07:36:22
8561,758,5,1256,163,1419,8468,2021-01-29 11:38:14
8562,652,3,847,110,957,8469,2021-01-29 15:01:14
8563,297,3,897,116,1013,8470,2021-01-29 16:27:50
8564,32,3,1027,133,1160,8471,2021-01-29 23:14:15
8565,236,3,1127,146,1273,8472,2021-01-30 08:40:57
8566,91,2,528,68,596,8473,2021-01-30 12:17:38
8567,671,3,947,123,1070,8474,2021-01-29 19:49:34
8568,89,3,558,72,630,8475,2021-01-29 21:36:23
8569,738,3,808,105,913,8476,2021-01-30 13:00:35
8570,763,3,997,129,1126,8477,2021-01-30 12:24:38
8571,896,3,697,90,787,8478,2021-01-30 20:08:05
8572,474,4,1276,165,1441,8479,2021-01-30 14:26:11
8573,681,1,399,51,450,8480,2021-01-30 04:37:51
8574,823,2,329,42,371,8481,2021-01-30 10:45:09
8575,736,3,747,97,844,8482,2021-01-30 13:58:18
8576,407,3,1047,136,1183,8483,2021-01-30 14:08:16
8577,933,3,927,120,1047,8484,2021-01-30 05:46:45
8578,756,3,697,90,787,8485,2021-01-30 21:17:41
8579,143,2,798,103,901,8486,2021-01-30 21:10:56
8580,523,2,798,103,901,8487,2021-01-30 10:58:15
8581,529,3,758,98,856,8488,2021-01-30 02:45:27
8582,844,3,808,105,913,8489,2021-01-29 01:07:19
8583,460,2,598,77,675,8490,2021-01-29 15:49:50
8584,961,3,847,110,957,8491,2021-01-29 21:00:25
8585,32,2,698,90,788,8492,2021-01-29 13:08:24
8586,294,4,1296,168,1464,8493,2021-01-29 04:56:01
8587,539,3,1127,146,1273,8494,2021-01-29 01:59:18
8588,226,3,428,55,483,8495,2021-01-29 05:30:33
8589,264,3,727,94,821,8496,2021-01-29 09:21:20
8590,14,2,1098,142,1240,8497,2021-01-29 10:11:20
8591,783,3,1197,155,1352,8498,2021-01-29 08:08:04
8592,917,1,149,19,168,8499,2021-01-29 18:09:40
8593,792,2,848,110,958,8500,2021-01-29 15:32:20
8594,696,4,1007,130,1137,8501,2021-01-29 21:25:32
8595,131,3,827,107,934,8502,2021-01-29 22:06:19
8596,400,3,1247,162,1409,8503,2021-01-30 04:09:45
8597,717,1,299,38,337,8504,2021-01-29 18:44:50
8598,749,3,558,72,630,8505,2021-01-29 12:29:56
8599,205,4,1526,198,1724,8506,2021-01-29 15:29:20
8600,882,3,1327,172,1499,8507,2021-01-30 02:09:58
8601,190,2,498,64,562,8508,2021-01-29 21:01:47
8602,346,2,498,64,562,8509,2021-01-29 15:01:11
8603,717,3,827,107,934,8510,2021-01-29 05:55:50
8604,667,3,1327,172,1499,8511,2021-01-29 17:33:23
8605,568,5,1345,174,1519,8512,2021-01-30 00:47:43
8606,637,3,1127,146,1273,8513,2021-01-29 21:02:06
8607,760,3,578,75,653,8514,2021-01-29 15:26:23
8608,181,3,808,105,913,8515,2021-01-29 22:35:27
8609,586,2,698,90,788,8516,2021-01-30 02:26:24
8610,940,3,1127,146,1273,8517,2021-01-30 03:05:03
8611,290,2,798,103,901,8518,2021-01-29 06:45:00
8612,400,2,898,116,1014,8519,2021-01-29 03:58:59
8613,882,2,898,116,1014,8520,2021-01-28 19:09:44
8614,948,3,558,72,630,8521,2021-01-28 20:56:22
8615,679,3,1047,136,1183,8522,2021-01-29 19:11:14
8616,157,3,428,55,483,8523,2021-01-29 18:18:48
8617,324,3,897,116,1013,8524,2021-01-30 00:42:40
8618,629,3,1047,136,1183,8525,2021-01-30 01:04:32
8619,658,3,578,75,653,8526,2021-01-29 18:21:12
8620,827,3,478,62,540,8527,2021-01-29 22:45:16
8621,626,2,898,116,1014,8528,2021-01-29 08:18:26
8622,695,6,1744,226,1970,8529,2021-01-28 23:49:51
8623,212,1,229,29,258,8530,2021-01-28 12:37:51
8624,434,3,658,85,743,8531,2021-01-29 02:17:35
8625,350,3,1097,142,1239,8532,2021-01-28 16:12:46
8626,752,1,99,12,111,8533,2021-01-28 20:29:25
8627,156,3,558,72,630,8534,2021-01-28 10:32:27
8628,452,2,698,90,788,8535,2021-01-28 17:20:08
8629,108,2,798,103,901,8536,2021-01-29 07:37:49
8630,889,3,827,107,934,8537,2021-01-29 06:46:35
8631,15,2,659,85,744,8538,2021-01-28 18:44:17
8632,422,5,1575,204,1779,8539,2021-01-28 18:38:18
8633,235,6,1574,204,1778,8540,2021-01-29 05:22:10
8634,895,2,798,103,901,8541,2021-01-29 09:57:40
8635,413,2,698,90,788,8542,2021-01-29 18:44:13
8636,495,3,827,107,934,8543,2021-01-29 18:27:09
8637,226,1,99,12,111,8544,2021-01-29 07:09:03
8638,815,3,758,98,856,8545,2021-01-29 08:39:16
8639,446,4,1746,226,1972,8546,2021-01-28 20:00:39
8640,577,3,1327,172,1499,8547,2021-01-28 16:49:33
8641,410,2,459,59,518,8548,2021-01-29 02:19:41
8642,884,4,1926,250,2176,8549,2021-01-29 01:25:19
8643,908,3,608,79,687,8550,2021-01-29 01:41:32
8644,913,3,478,62,540,8551,2021-01-29 01:14:55
8645,153,3,847,110,957,8552,2021-01-30 08:34:20
8646,10,3,697,90,787,8553,2021-01-30 09:59:48
8647,991,3,478,62,540,8554,2021-01-30 08:07:04
8648,147,2,329,42,371,8555,2021-01-30 08:07:22
8649,449,3,1197,155,1352,8556,2021-01-30 09:38:31
8650,962,3,808,105,913,8557,2021-01-30 07:11:09
8651,128,2,898,116,1014,8558,2021-01-30 09:34:13
8652,141,5,2145,278,2423,8559,2021-01-29 20:37:14
8653,931,3,608,79,687,8560,2021-01-29 18:54:11
8654,611,1,699,90,789,8561,2021-01-29 17:11:03
8655,817,3,997,129,1126,8562,2021-01-29 09:59:21
8656,773,3,747,97,844,8563,2021-01-29 12:36:53
8657,82,3,758,98,856,8564,2021-01-29 15:09:07
8658,43,2,898,116,1014,8565,2021-01-29 17:12:09
8659,757,2,528,68,596,8566,2021-01-30 01:24:07
8660,970,3,1197,155,1352,8567,2021-01-30 11:26:59
8661,323,3,428,55,483,8568,2021-01-30 14:52:10
8662,3,3,1127,146,1273,8569,2021-01-29 20:46:49
8663,303,3,478,62,540,8570,2021-01-29 23:19:14
8664,572,2,459,59,518,8571,2021-01-30 14:53:33
8665,76,3,1197,155,1352,8572,2021-01-30 13:42:01
8666,303,3,747,97,844,8573,2021-01-30 21:13:30
8667,680,3,747,97,844,8574,2021-01-30 16:13:49
8668,360,1,149,19,168,8575,2021-01-30 04:38:19
8669,967,2,459,59,518,8576,2021-01-30 11:43:04
8670,641,3,558,72,630,8577,2021-01-30 16:18:58
8671,46,3,747,97,844,8578,2021-01-30 16:02:53
8672,496,3,1127,146,1273,8579,2021-01-30 08:06:28
8673,275,3,847,110,957,8580,2021-01-30 21:25:54
8674,131,3,1127,146,1273,8581,2021-01-30 23:45:59
8675,123,3,947,123,1070,8582,2021-01-30 11:13:51
8676,197,2,329,42,371,8583,2021-01-30 03:32:35
8677,192,3,997,129,1126,8584,2021-01-29 01:08:29
8678,56,3,888,115,1003,8585,2021-01-29 17:14:47
8679,549,3,1127,146,1273,8586,2021-01-29 23:27:18
8680,233,4,1596,207,1803,8587,2021-01-29 13:25:21
8681,620,2,498,64,562,8588,2021-01-29 07:16:58
8682,505,3,747,97,844,8589,2021-01-29 02:20:35
8683,387,2,598,77,675,8590,2021-01-29 07:48:10
8684,250,3,558,72,630,8591,2021-01-29 12:02:49
8685,378,6,1175,152,1327,8592,2021-01-29 10:15:00
8686,865,2,329,42,371,8593,2021-01-29 08:27:35
8687,363,2,798,103,901,8594,2021-01-29 20:19:00
8688,284,2,698,90,788,8595,2021-01-29 18:06:03
8689,211,3,897,116,1013,8596,2021-01-29 22:17:50
8690,562,2,598,77,675,8597,2021-01-29 23:51:29
8691,925,3,927,120,1047,8598,2021-01-30 06:40:45
8692,11,3,727,94,821,8599,2021-01-29 19:13:20
8693,894,6,1494,194,1688,8600,2021-01-29 14:34:36
8694,355,2,648,84,732,8601,2021-01-29 16:23:16
8695,168,2,798,103,901,8602,2021-01-30 04:26:48
8696,348,3,697,90,787,8603,2021-01-29 22:04:33
8697,100,3,1127,146,1273,8604,2021-01-29 15:50:58
8698,259,3,1127,146,1273,8605,2021-01-29 06:04:51
8699,453,3,797,103,900,8606,2021-01-29 18:12:08
8700,297,3,428,55,483,8607,2021-01-30 02:21:00
8701,952,3,897,116,1013,8608,2021-01-29 23:28:09
8702,528,3,597,77,674,8609,2021-01-29 15:34:06
8703,811,3,727,94,821,8610,2021-01-30 00:15:49
8704,130,2,459,59,518,8611,2021-01-30 03:09:49
8705,368,3,558,72,630,8612,2021-01-30 05:27:24
8706,368,3,558,72,630,8612,2021-01-30 05:27:24
8707,617,3,997,129,1126,8613,2021-01-29 07:11:02
8708,315,2,459,59,518,8614,2021-01-29 06:37:24
8709,6,3,1127,146,1273,8615,2021-01-28 20:59:16
8710,18,3,888,115,1003,8616,2021-01-28 22:40:48
8711,906,3,797,103,900,8617,2021-01-29 21:50:09
8712,285,3,647,84,731,8618,2021-01-29 19:52:46
8713,573,3,797,103,900,8619,2021-01-30 01:03:48
8714,519,5,2125,276,2401,8620,2021-01-30 02:28:51
8715,203,3,827,107,934,8621,2021-01-29 18:58:17
8716,270,3,558,72,630,8622,2021-01-30 00:11:54
8717,774,3,1127,146,1273,8623,2021-01-29 09:05:44
8718,278,2,598,77,675,8624,2021-01-29 02:01:50
8719,342,5,1645,213,1858,8625,2021-01-28 14:26:36
8720,690,3,528,68,596,8626,2021-01-29 03:58:48
8721,107,3,558,72,630,8627,2021-01-28 17:57:05
8722,126,2,1098,142,1240,8628,2021-01-28 21:47:52
8723,301,3,947,123,1070,8629,2021-01-28 13:14:39
8724,722,3,658,85,743,8630,2021-01-28 17:44:53
8725,795,2,498,64,562,8631,2021-01-29 07:59:37
8726,4,2,498,64,562,8632,2021-01-29 06:57:38
8727,152,3,688,89,777,8633,2021-01-28 21:20:49
8728,903,2,898,116,1014,8634,2021-01-28 18:53:22
8729,768,1,299,38,337,8635,2021-01-29 06:18:25
8730,880,1,229,29,258,8636,2021-01-29 12:02:46
8731,668,2,598,77,675,8637,2021-01-29 19:40:02
8732,232,6,1305,169,1474,8638,2021-01-29 20:35:01
8733,644,3,827,107,934,8639,2021-01-29 08:10:57
8734,672,3,697,90,787,8640,2021-01-29 11:19:56
8735,283,5,2125,276,2401,8641,2021-01-28 20:34:10
8736,888,3,827,107,934,8642,2021-01-28 17:07:35
8737,85,3,888,115,1003,8643,2021-01-29 04:23:14
8738,389,5,1156,150,1306,8644,2021-01-29 03:26:34
8739,541,3,688,89,777,8645,2021-01-29 03:53:43
8740,109,3,478,62,540,8646,2021-01-29 02:40:10
8741,941,3,697,90,787,8647,2021-01-30 10:28:38
8742,720,1,599,77,676,8648,2021-01-30 11:12:52
8743,941,6,1474,191,1665,8649,2021-01-30 08:10:32
8744,499,3,827,107,934,8650,2021-01-30 08:48:12
8745,966,3,1247,162,1409,8651,2021-01-30 12:22:47
8746,715,2,459,59,518,8652,2021-01-30 09:49:32
8747,84,2,1098,142,1240,8653,2021-01-30 09:59:50
8748,382,2,698,90,788,8654,2021-01-29 22:50:29
8749,273,4,1296,168,1464,8655,2021-01-29 21:16:09
8750,613,2,429,55,484,8656,2021-01-29 18:34:47
8751,424,3,947,123,1070,8657,2021-01-29 11:47:40
8752,626,2,329,42,371,8658,2021-01-29 13:13:04
8753,778,3,808,105,913,8659,2021-01-29 15:59:27
8754,661,5,1825,237,2062,8660,2021-01-29 18:23:11
8755,608,2,728,94,822,8661,2021-01-30 02:43:48
8756,908,2,698,90,788,8662,2021-01-30 13:06:20
8757,146,3,847,110,957,8663,2021-01-30 17:24:12
8758,778,3,1327,172,1499,8664,2021-01-29 22:51:32
8759,480,3,697,90,787,8665,2021-01-29 23:42:12
8760,126,2,1098,142,1240,8666,2021-01-30 17:36:16
8761,782,2,598,77,675,8667,2021-01-30 15:26:54
8762,204,3,927,120,1047,8668,2021-01-30 22:57:02
8763,583,4,1626,211,1837,8669,2021-01-30 18:55:36
8764,336,3,847,110,957,8670,2021-01-30 06:42:47
8765,506,3,1027,133,1160,8671,2021-01-30 12:46:39
8766,35,3,608,79,687,8672,2021-01-30 18:18:01
8767,693,3,997,129,1126,8673,2021-01-30 17:50:33
8768,909,3,688,89,777,8674,2021-01-30 09:19:18
8769,653,2,398,51,449,8675,2021-01-30 21:52:41
8770,99,2,898,116,1014,8676,2021-01-31 01:52:12
8771,986,3,808,105,913,8677,2021-01-30 13:10:54
8772,429,2,598,77,675,8678,2021-01-30 04:36:00
8773,334,3,927,120,1047,8679,2021-01-29 02:53:24
8774,134,3,558,72,630,8680,2021-01-29 18:29:21
8775,681,3,697,90,787,8681,2021-01-30 00:11:03
8776,246,3,847,110,957,8682,2021-01-29 16:03:42
8777,213,3,847,110,957,8683,2021-01-29 08:24:26
8778,569,1,229,29,258,8684,2021-01-29 04:21:56
8779,390,3,578,75,653,8685,2021-01-29 10:29:44
8780,37,3,727,94,821,8686,2021-01-29 13:36:04
8781,280,3,827,107,934,8687,2021-01-29 12:31:55
8782,81,3,1247,162,1409,8688,2021-01-29 09:50:27
8783,152,2,898,116,1014,8689,2021-01-29 21:46:58
8784,761,6,1635,212,1847,8690,2021-01-29 20:28:58
8785,682,3,1127,146,1273,8691,2021-01-29 23:49:41
8786,699,3,727,94,821,8692,2021-01-30 01:02:34
8787,491,5,1206,156,1362,8693,2021-01-30 08:19:34
8788,46,2,898,116,1014,8694,2021-01-29 21:26:43
8789,647,2,429,55,484,8695,2021-01-29 16:34:30
8790,544,3,608,79,687,8696,2021-01-29 17:04:08
8791,273,3,747,97,844,8697,2021-01-30 05:04:49
8792,351,3,478,62,540,8698,2021-01-30 00:12:44
8793,711,3,558,72,630,8699,2021-01-29 17:48:59
8794,427,3,578,75,653,8700,2021-01-29 08:43:30
8795,453,2,598,77,675,8701,2021-01-29 19:44:05
8796,61,3,1327,172,1499,8702,2021-01-30 03:48:35
8797,92,6,1036,134,1170,8703,2021-01-30 00:27:48
8798,305,3,697,90,787,8704,2021-01-29 15:46:44
8799,772,6,1425,185,1610,8705,2021-01-30 00:27:17
8800,555,3,478,62,540,8706,2021-01-30 04:00:40
8801,101,6,1455,189,1644,8707,2021-01-30 07:11:59
8802,373,3,1027,133,1160,8708,2021-01-30 06:55:09
8803,241,2,698,90,788,8709,2021-01-29 07:26:53
8804,347,3,947,123,1070,8710,2021-01-29 07:34:07
8805,394,3,428,55,483,8711,2021-01-28 21:52:17
8806,355,3,827,107,934,8712,2021-01-29 00:03:18
8807,524,3,688,89,777,8713,2021-01-29 22:26:37
8808,242,3,888,115,1003,8714,2021-01-29 22:19:56
8809,581,3,688,89,777,8715,2021-01-30 02:15:55
8810,845,3,1327,172,1499,8716,2021-01-30 03:40:15
8811,299,2,598,77,675,8717,2021-01-29 21:34:59
8812,74,3,808,105,913,8718,2021-01-30 01:17:37
8813,783,3,478,62,540,8719,2021-01-29 10:12:40
8814,384,3,888,115,1003,8720,2021-01-29 02:10:42
8815,682,3,808,105,913,8721,2021-01-28 15:16:45
8816,270,3,1027,133,1160,8722,2021-01-29 05:09:33
8817,260,2,598,77,675,8723,2021-01-28 18:52:05
8818,16,5,1045,135,1180,8724,2021-01-28 22:51:08
8819,232,2,498,64,562,8725,2021-01-28 15:22:25
8820,192,3,558,72,630,8726,2021-01-28 17:56:59
8821,241,2,528,68,596,8727,2021-01-29 09:56:47
8822,523,3,727,94,821,8728,2021-01-29 07:39:19
8823,875,3,1047,136,1183,8729,2021-01-28 22:54:54
8824,97,3,827,107,934,8730,2021-01-28 21:20:27
8825,906,2,659,85,744,8731,2021-01-29 07:44:49
8826,170,3,1027,133,1160,8732,2021-01-29 14:00:35
8827,910,3,1327,172,1499,8733,2021-01-29 20:06:29
8828,701,3,558,72,630,8734,2021-01-29 22:51:11
8829,123,3,478,62,540,8735,2021-01-29 09:57:06
8830,489,3,1027,133,1160,8736,2021-01-29 12:40:04
8831,680,4,1296,168,1464,8737,2021-01-28 22:20:10
8832,210,4,826,107,933,8738,2021-01-28 17:59:58
8833,27,3,758,98,856,8739,2021-01-29 06:00:49
8834,318,3,1127,146,1273,8740,2021-01-29 05:13:13
8835,508,3,927,120,1047,8741,2021-01-29 04:00:49
8836,319,2,698,90,788,8742,2021-01-29 05:22:39
8837,175,2,659,85,744,8743,2021-01-30 12:26:26
8838,346,3,847,110,957,8744,2021-01-30 12:28:48
8839,629,3,608,79,687,8745,2021-01-30 09:49:38
8840,391,3,797,103,900,8746,2021-01-30 11:05:26
8841,287,2,898,116,1014,8747,2021-01-30 14:52:05
8842,79,3,1047,136,1183,8748,2021-01-30 11:45:53
8843,788,2,898,116,1014,8749,2021-01-30 10:16:12
8844,486,2,429,55,484,8750,2021-01-29 23:09:57
8845,956,6,2074,269,2343,8751,2021-01-29 23:57:03
8846,579,2,598,77,675,8752,2021-01-29 20:25:54
8847,542,3,797,103,900,8753,2021-01-29 14:28:53
8848,698,3,997,129,1126,8754,2021-01-29 13:13:20
8849,5,3,697,90,787,8755,2021-01-29 16:01:59
8850,961,3,1197,155,1352,8756,2021-01-29 19:10:49
8851,258,3,808,105,913,8757,2021-01-30 05:11:37
8852,473,3,688,89,777,8758,2021-01-30 14:15:52
8853,859,3,597,77,674,8759,2021-01-30 18:36:48
8854,906,2,1098,142,1240,8760,2021-01-29 23:16:26
8855,238,5,1226,159,1385,8761,2021-01-30 00:18:06
8856,973,2,798,103,901,8762,2021-01-30 19:44:58
8857,798,2,628,81,709,8763,2021-01-30 16:54:19
8858,90,3,808,105,913,8764,2021-01-30 23:38:39
8859,89,3,697,90,787,8765,2021-01-30 19:24:47
8860,977,2,898,116,1014,8766,2021-01-30 07:00:02
8861,42,2,429,55,484,8767,2021-01-30 12:51:51
8862,869,3,827,107,934,8768,2021-01-30 20:14:54
8863,87,2,548,71,619,8769,2021-01-30 18:45:30
8864,915,2,598,77,675,8770,2021-01-30 11:59:01
8865,877,2,598,77,675,8771,2021-01-30 23:32:51
8866,593,4,1557,202,1759,8772,2021-01-31 04:37:00
8867,625,3,727,94,821,8773,2021-01-30 14:24:26
8868,374,3,647,84,731,8774,2021-01-30 06:33:12
8869,633,2,548,71,619,8775,2021-01-29 03:19:00
8870,292,3,1127,146,1273,8776,2021-01-29 20:34:26
8871,550,2,498,64,562,8777,2021-01-30 01:07:23
8872,690,3,1127,146,1273,8778,2021-01-29 16:29:31
8873,16,2,798,103,901,8779,2021-01-29 09:51:14
8874,263,5,1645,213,1858,8780,2021-01-29 04:24:42
8875,607,3,747,97,844,8781,2021-01-29 12:20:18
8876,874,3,608,79,687,8782,2021-01-29 15:37:38
8877,370,3,528,68,596,8783,2021-01-29 14:10:58
8878,861,5,1245,161,1406,8784,2021-01-29 11:25:54
8879,696,3,528,68,596,8785,2021-01-29 21:48:08
8880,893,3,808,105,913,8786,2021-01-29 21:34:57
8881,444,2,598,77,675,8787,2021-01-30 01:55:58
8882,84,2,898,116,1014,8788,2021-01-30 01:28:42
8883,424,5,1576,204,1780,8789,2021-01-30 09:30:43
8884,824,2,659,85,744,8790,2021-01-29 21:37:26
8885,901,5,1256,163,1419,8791,2021-01-29 16:59:08
8886,705,2,398,51,449,8792,2021-01-29 17:19:44
8887,967,2,329,42,371,8793,2021-01-30 06:16:54
8888,731,3,797,103,900,8794,2021-01-30 00:20:09
8889,198,1,599,77,676,8795,2021-01-29 19:52:04
8890,748,3,697,90,787,8796,2021-01-29 10:38:30
8891,958,1,399,51,450,8797,2021-01-29 20:52:58
8892,467,3,888,115,1003,8798,2021-01-30 06:03:35
8893,822,3,697,90,787,8799,2021-01-30 01:34:20
8894,504,3,1127,146,1273,8800,2021-01-29 16:54:43
8895,913,3,888,115,1003,8801,2021-01-30 02:22:28
8896,711,2,1098,142,1240,8802,2021-01-30 04:36:06
8897,596,2,459,59,518,8803,2021-01-30 09:24:59
8898,497,3,888,115,1003,8804,2021-01-30 08:32:34
8899,641,4,826,107,933,8805,2021-01-29 07:56:56
8900,563,3,1127,146,1273,8806,2021-01-29 09:14:32
8901,944,3,558,72,630,8807,2021-01-28 22:58:35
8902,911,6,2054,267,2321,8808,2021-01-29 00:08:34
8903,965,3,847,110,957,8809,2021-01-30 00:36:11
8904,853,2,659,85,744,8810,2021-01-29 23:46:02
8905,396,2,828,107,935,8811,2021-01-30 02:39:14
8906,198,2,398,51,449,8812,2021-01-30 04:19:32
8907,357,1,229,29,258,8813,2021-01-29 23:28:28
8908,717,3,827,107,934,8814,2021-01-30 02:44:15
8909,331,3,997,129,1126,8815,2021-01-29 11:05:16
8910,341,3,797,103,900,8816,2021-01-29 02:13:51
8911,840,2,329,42,371,8817,2021-01-28 16:50:26
8912,428,3,997,129,1126,8818,2021-01-29 06:42:20
8913,227,3,697,90,787,8819,2021-01-28 19:17:27
8914,684,2,659,85,744,8820,2021-01-29 01:29:58
8915,826,2,628,81,709,8821,2021-01-28 17:52:22
8916,105,6,1774,230,2004,8822,2021-01-28 18:08:52
8917,26,3,997,129,1126,8823,2021-01-29 12:26:12
8918,46,3,797,103,900,8824,2021-01-29 08:23:54
8919,695,4,1246,161,1407,8825,2021-01-29 00:54:13
8920,458,4,1057,137,1194,8826,2021-01-28 22:13:03
8921,137,3,888,115,1003,8827,2021-01-29 10:03:25
8922,861,3,1327,172,1499,8828,2021-01-29 15:20:23
8923,105,6,1855,241,2096,8829,2021-01-29 21:34:31
8924,187,3,747,97,844,8830,2021-01-30 00:29:58
8925,447,3,1047,136,1183,8831,2021-01-29 10:53:16
8926,437,3,1327,172,1499,8832,2021-01-29 14:32:12
8927,233,3,888,115,1003,8833,2021-01-28 23:16:44
8928,575,3,1027,133,1160,8834,2021-01-28 18:12:19
8929,801,2,329,42,371,8835,2021-01-29 07:38:09
8930,916,3,697,90,787,8836,2021-01-29 06:14:40
8931,802,2,798,103,901,8837,2021-01-29 05:25:35
8932,845,2,898,116,1014,8838,2021-01-29 07:18:42
8933,254,3,727,94,821,8839,2021-01-30 14:29:53
8934,990,3,747,97,844,8840,2021-01-30 12:38:51
8935,505,3,1197,155,1352,8841,2021-01-30 12:08:27
8936,818,4,1526,198,1724,8842,2021-01-30 12:43:15
8937,323,3,897,116,1013,8843,2021-01-30 14:52:45
8938,296,6,1705,221,1926,8844,2021-01-30 14:20:09
8939,783,6,1336,173,1509,8845,2021-01-30 11:03:42
8940,536,2,659,85,744,8846,2021-01-30 00:22:28
8941,779,2,898,116,1014,8847,2021-01-30 02:14:50
8942,560,3,747,97,844,8848,2021-01-29 21:33:37
8943,549,2,459,59,518,8849,2021-01-29 16:32:29
8944,4,3,888,115,1003,8850,2021-01-29 15:55:44
8945,242,3,827,107,934,8851,2021-01-29 17:05:25
8946,84,5,1595,207,1802,8852,2021-01-29 21:06:28
8947,114,3,697,90,787,8853,2021-01-30 06:51:46
8948,988,3,888,115,1003,8854,2021-01-30 15:31:00
8949,120,4,1596,207,1803,8855,2021-01-30 20:30:45
8950,618,3,897,116,1013,8856,2021-01-30 01:52:53
8951,816,2,598,77,675,8857,2021-01-30 02:01:53
8952,215,3,827,107,934,8858,2021-01-30 21:24:48
8953,550,3,1197,155,1352,8859,2021-01-30 18:29:59
8954,204,3,608,79,687,8860,2021-01-30 23:53:08
8955,164,3,888,115,1003,8861,2021-01-30 22:10:47
8956,233,5,1676,217,1893,8862,2021-01-30 07:22:36
8957,465,5,1376,178,1554,8863,2021-01-30 15:12:45
8958,969,2,429,55,484,8864,2021-01-30 20:48:28
8959,192,3,997,129,1126,8865,2021-01-30 21:30:15
8960,181,3,1047,136,1183,8866,2021-01-30 13:59:29
8961,133,4,1126,146,1272,8867,2021-01-31 01:14:59
8962,803,3,688,89,777,8868,2021-01-31 05:23:26
8963,746,3,428,55,483,8869,2021-01-30 15:51:31
8964,784,3,697,90,787,8870,2021-01-30 07:26:33
8965,83,2,1098,142,1240,8871,2021-01-29 05:38:39
8966,62,3,578,75,653,8872,2021-01-29 20:42:42
8967,855,3,827,107,934,8873,2021-01-30 03:03:30
8968,516,3,827,107,934,8874,2021-01-29 18:06:33
8969,401,3,528,68,596,8875,2021-01-29 09:57:24
8970,626,3,658,85,743,8876,2021-01-29 05:07:31
8971,20,2,598,77,675,8877,2021-01-29 13:45:21
8972,170,4,957,124,1081,8878,2021-01-29 16:28:49
8973,947,3,1127,146,1273,8879,2021-01-29 14:56:10
8974,451,3,478,62,540,8880,2021-01-29 14:01:31
8975,98,3,558,72,630,8881,2021-01-29 23:51:24
8976,321,3,758,98,856,8882,2021-01-29 21:41:54
8977,712,3,1127,146,1273,8883,2021-01-30 03:00:32
8978,681,2,698,90,788,8884,2021-01-30 03:29:47
8979,537,3,1047,136,1183,8885,2021-01-30 09:37:56
8980,61,3,847,110,957,8886,2021-01-29 21:52:13
8981,445,2,1098,142,1240,8887,2021-01-29 18:27:48
8982,800,3,927,120,1047,8888,2021-01-29 19:37:43
8983,876,2,898,116,1014,8889,2021-01-30 08:31:56
8984,672,2,698,90,788,8890,2021-01-30 00:39:19
8985,265,2,698,90,788,8891,2021-01-29 20:05:17
8986,270,3,827,107,934,8892,2021-01-29 12:07:25
8987,550,3,1197,155,1352,8893,2021-01-29 20:56:19
8988,606,3,597,77,674,8894,2021-01-30 08:43:26
8989,177,3,688,89,777,8895,2021-01-30 02:59:53
8990,293,3,997,129,1126,8896,2021-01-29 18:38:00
8991,928,2,698,90,788,8897,2021-01-30 02:26:24
8992,276,1,229,29,258,8898,2021-01-30 06:43:58
8993,636,2,548,71,619,8899,2021-01-30 12:09:48
8994,7,5,1645,213,1858,8900,2021-01-30 08:48:34
8995,611,3,1197,155,1352,8901,2021-01-29 10:02:03
8996,286,4,1077,140,1217,8902,2021-01-29 09:33:50
8997,719,3,697,90,787,8903,2021-01-28 23:07:15
8998,805,2,898,116,1014,8904,2021-01-29 01:46:07
8999,155,2,1098,142,1240,8905,2021-01-30 01:55:53
9000,331,3,758,98,856,8906,2021-01-30 00:19:30
9001,456,3,428,55,483,8907,2021-01-30 03:40:21
9002,744,3,528,68,596,8908,2021-01-30 05:19:48
9003,678,3,608,79,687,8909,2021-01-29 23:40:09
9004,660,3,478,62,540,8910,2021-01-30 03:00:23
9005,395,3,697,90,787,8911,2021-01-29 13:39:40
9006,585,2,898,116,1014,8912,2021-01-29 02:58:29
9007,728,2,928,120,1048,8913,2021-01-28 17:22:36
9008,720,1,499,64,563,8914,2021-01-29 08:20:12
9009,524,3,697,90,787,8915,2021-01-28 21:45:33
9010,785,6,1674,217,1891,8916,2021-01-29 03:00:36
9011,93,2,898,116,1014,8917,2021-01-28 19:01:51
9012,773,3,1127,146,1273,8918,2021-01-28 18:39:27
9013,112,3,997,129,1126,8919,2021-01-29 13:32:35
9014,499,5,1056,137,1193,8920,2021-01-29 09:44:02
9015,328,3,478,62,540,8921,2021-01-29 01:05:25
9016,653,1,599,77,676,8922,2021-01-29 00:40:44
9017,800,3,758,98,856,8923,2021-01-29 12:24:31
9018,712,3,1127,146,1273,8924,2021-01-29 15:38:04
9019,41,2,429,55,484,8925,2021-01-29 21:46:32
9020,309,4,1096,142,1238,8926,2021-01-30 02:11:21
9021,685,2,928,120,1048,8927,2021-01-29 11:30:23
9022,132,2,798,103,901,8928,2021-01-29 16:36:47
9023,221,3,827,107,934,8929,2021-01-29 00:53:40
9024,988,3,997,129,1126,8930,2021-01-28 19:20:12
9025,925,3,997,129,1126,8931,2021-01-29 09:49:11
9026,220,2,498,64,562,8932,2021-01-29 06:32:12
9027,28,2,798,103,901,8933,2021-01-29 06:03:08
9028,697,3,1047,136,1183,8934,2021-01-29 07:55:27
9029,806,3,1197,155,1352,8935,2021-01-30 15:40:49
9030,506,3,528,68,596,8936,2021-01-30 13:59:53
9031,480,2,798,103,901,8937,2021-01-30 12:56:38
9032,490,2,598,77,675,8938,2021-01-30 13:14:19
9033,572,3,608,79,687,8939,2021-01-30 16:39:35
9034,669,3,1327,172,1499,8940,2021-01-30 15:01:47
9035,569,2,898,116,1014,8941,2021-01-30 13:37:42
9036,763,3,558,72,630,8942,2021-01-30 02:48:05
9037,162,6,1744,226,1970,8943,2021-01-30 04:33:51
9038,884,2,1098,142,1240,8944,2021-01-29 23:57:54
9039,990,5,1156,150,1306,8945,2021-01-29 16:44:51
9040,448,3,747,97,844,8946,2021-01-29 18:06:11
9041,851,2,598,77,675,8947,2021-01-29 17:37:40
9042,571,3,558,72,630,8948,2021-01-29 23:16:11
9043,848,5,1556,202,1758,8949,2021-01-30 06:52:33
9044,933,3,528,68,596,8950,2021-01-30 17:48:08
9045,236,2,429,55,484,8951,2021-01-30 21:53:00
9046,158,2,628,81,709,8952,2021-01-30 03:08:24
9047,564,3,808,105,913,8953,2021-01-30 04:36:19
9048,96,3,847,110,957,8954,2021-01-30 22:12:23
9049,694,2,429,55,484,8955,2021-01-30 18:51:59
9050,849,3,647,84,731,8956,2021-01-31 00:39:54
9051,228,3,888,115,1003,8957,2021-01-30 22:19:13
9052,776,3,947,123,1070,8958,2021-01-30 08:11:41
9053,636,2,898,116,1014,8959,2021-01-30 16:26:29
9054,546,4,1207,156,1363,8960,2021-01-30 21:31:21
9055,629,4,1126,146,1272,8961,2021-01-30 23:13:32
9056,471,1,699,90,789,8962,2021-01-30 16:42:22
9057,31,2,459,59,518,8963,2021-01-31 02:03:19
9058,937,6,1674,217,1891,8964,2021-01-31 05:49:48
9059,724,6,1444,187,1631,8965,2021-01-30 16:44:09
9060,624,2,698,90,788,8966,2021-01-30 08:33:14
9061,70,2,1098,142,1240,8967,2021-01-29 07:03:58
9062,226,2,498,64,562,8968,2021-01-29 22:26:04
9063,875,3,558,72,630,8969,2021-01-30 04:22:46
9064,563,6,2085,271,2356,8970,2021-01-29 20:17:52
9065,599,2,1098,142,1240,8971,2021-01-29 12:19:00
9066,66,3,1127,146,1273,8972,2021-01-29 05:24:24
9067,242,3,997,129,1126,8973,2021-01-29 16:12:46
9068,189,5,1386,180,1566,8974,2021-01-29 17:03:33
9069,643,2,698,90,788,8975,2021-01-29 16:43:29
9070,713,3,528,68,596,8976,2021-01-29 15:49:44
9071,103,2,898,116,1014,8977,2021-01-30 01:57:59
9072,893,6,1316,171,1487,8978,2021-01-29 22:38:39
9073,902,3,578,75,653,8979,2021-01-30 04:21:25
9074,111,3,997,129,1126,8980,2021-01-30 04:20:07
9075,225,2,798,103,901,8981,2021-01-30 09:41:52
9076,707,3,658,85,743,8982,2021-01-29 22:17:24
9077,173,3,827,107,934,8983,2021-01-29 20:21:15
9078,914,1,499,64,563,8984,2021-01-29 21:08:21
9079,329,3,558,72,630,8985,2021-01-30 08:33:29
9080,249,2,1098,142,1240,8986,2021-01-30 00:48:21
9081,40,3,808,105,913,8987,2021-01-29 21:29:22
9082,251,6,1535,199,1734,8988,2021-01-29 13:13:28
9083,355,3,597,77,674,8989,2021-01-29 22:55:36
9084,507,3,528,68,596,8990,2021-01-30 10:40:01
9085,506,2,898,116,1014,8991,2021-01-30 05:01:01
9086,532,3,578,75,653,8992,2021-01-29 20:23:38
9087,855,2,398,51,449,8993,2021-01-30 03:35:45
9088,25,5,1545,200,1745,8994,2021-01-30 07:15:13
9089,763,2,798,103,901,8995,2021-01-30 13:43:40
9090,680,1,599,77,676,8996,2021-01-30 10:19:40
9091,843,3,927,120,1047,8997,2021-01-29 11:10:28
9092,776,3,558,72,630,8998,2021-01-29 12:09:21
9093,203,4,1027,133,1160,8999,2021-01-29 01:37:17
9094,476,3,927,120,1047,9000,2021-01-29 02:39:25
9095,767,3,1247,162,1409,9001,2021-01-30 04:13:20
9096,654,3,747,97,844,9002,2021-01-30 02:38:07
9097,873,3,747,97,844,9003,2021-01-30 05:18:47
9098,797,3,597,77,674,9004,2021-01-30 05:33:36
9099,493,2,698,90,788,9005,2021-01-30 00:51:31
9100,290,2,798,103,901,9006,2021-01-30 04:23:58
9101,612,3,478,62,540,9007,2021-01-29 16:24:11
9102,585,2,898,116,1014,9008,2021-01-29 04:51:32
9103,986,3,697,90,787,9009,2021-01-28 18:17:54
9104,6,2,548,71,619,9010,2021-01-29 09:15:21
9105,126,3,1327,172,1499,9011,2021-01-29 00:31:44
9106,870,2,1098,142,1240,9012,2021-01-29 05:03:08
9107,741,3,558,72,630,9013,2021-01-28 21:16:16
9108,189,3,478,62,540,9014,2021-01-28 19:44:57
9109,756,1,399,51,450,9015,2021-01-29 15:16:48
9110,309,3,558,72,630,9016,2021-01-29 11:03:27
9111,807,2,898,116,1014,9017,2021-01-29 03:47:04
9112,781,3,827,107,934,9018,2021-01-29 02:11:17
9113,140,5,1575,204,1779,9019,2021-01-29 14:02:21
9114,7,3,558,72,630,9020,2021-01-29 17:00:29
9115,32,2,598,77,675,9021,2021-01-29 22:22:27
9116,616,4,1096,142,1238,9022,2021-01-30 04:08:57
9117,438,3,428,55,483,9023,2021-01-29 11:31:56
9118,144,2,498,64,562,9024,2021-01-29 16:57:51
9119,695,2,898,116,1014,9025,2021-01-29 02:05:52
9120,274,2,598,77,675,9026,2021-01-28 21:52:34
9121,547,5,1775,230,2005,9027,2021-01-29 10:28:00
9122,131,3,597,77,674,9028,2021-01-29 08:23:14
9123,815,2,898,116,1014,9029,2021-01-29 08:03:53
9124,432,2,329,42,371,9030,2021-01-29 09:01:55
9125,584,1,599,77,676,9031,2021-01-30 15:52:16
9126,819,2,598,77,675,9032,2021-01-30 15:17:09
9127,326,5,1456,189,1645,9033,2021-01-30 13:33:27
9128,51,3,747,97,844,9034,2021-01-30 15:45:12
9129,161,3,1027,133,1160,9035,2021-01-30 18:39:03
9130,645,3,1327,172,1499,9036,2021-01-30 15:38:54
9131,219,2,798,103,901,9037,2021-01-30 15:41:35
9132,122,2,748,97,845,9038,2021-01-30 04:15:14
9133,223,5,926,120,1046,9039,2021-01-30 07:10:22
9134,95,2,1098,142,1240,9040,2021-01-30 01:32:47
9135,960,2,498,64,562,9041,2021-01-29 16:45:53
9136,722,3,688,89,777,9042,2021-01-29 20:36:20
9137,13,3,827,107,934,9043,2021-01-29 18:13:43
9138,241,1,299,38,337,9044,2021-01-30 01:02:01
9139,555,2,598,77,675,9045,2021-01-30 07:22:18
9140,297,5,1547,201,1748,9046,2021-01-30 18:17:31
9141,732,2,598,77,675,9047,2021-01-30 23:54:39
9142,305,3,747,97,844,9048,2021-01-30 04:53:02
9143,526,3,528,68,596,9049,2021-01-30 04:44:45
9144,557,3,747,97,844,9050,2021-01-30 22:52:53
9145,196,2,628,81,709,9051,2021-01-30 19:04:06
9146,51,3,597,77,674,9052,2021-01-31 01:39:02
9147,683,3,608,79,687,9053,2021-01-30 22:27:30
9148,602,5,1406,182,1588,9054,2021-01-30 08:46:25
9149,94,2,898,116,1014,9055,2021-01-30 18:49:01
9150,77,2,698,90,788,9056,2021-01-30 23:30:43
9151,689,2,398,51,449,9057,2021-01-31 00:18:55
9152,236,2,898,116,1014,9058,2021-01-30 17:59:57
9153,986,6,1255,163,1418,9059,2021-01-31 02:18:01
9154,911,3,888,115,1003,9060,2021-01-31 08:09:32
9155,224,3,1197,155,1352,9061,2021-01-30 18:14:57
9156,754,3,727,94,821,9062,2021-01-30 10:57:12
9157,209,2,1098,142,1240,9063,2021-01-29 09:30:35
9158,883,3,1127,146,1273,9064,2021-01-29 22:34:27
9159,638,1,99,12,111,9065,2021-01-30 05:04:36
9160,336,2,429,55,484,9066,2021-01-29 22:21:09
9161,899,2,798,103,901,9067,2021-01-29 13:59:51
9162,910,2,429,55,484,9068,2021-01-29 07:56:02
9163,867,5,1026,133,1159,9069,2021-01-29 17:56:33
9164,427,3,997,129,1126,9070,2021-01-29 18:16:59
9165,91,2,498,64,562,9071,2021-01-29 17:34:45
9166,68,2,548,71,619,9072,2021-01-29 18:10:31
9167,903,3,888,115,1003,9073,2021-01-30 03:22:02
9168,34,3,478,62,540,9074,2021-01-30 00:57:16
9169,522,2,628,81,709,9075,2021-01-30 05:26:59
9170,784,2,698,90,788,9076,2021-01-30 06:35:12
9171,973,3,947,123,1070,9077,2021-01-30 11:14:59
9172,253,2,429,55,484,9078,2021-01-29 22:44:54
9173,961,3,697,90,787,9079,2021-01-29 22:15:40
9174,754,3,597,77,674,9080,2021-01-29 22:42:14
9175,144,3,747,97,844,9081,2021-01-30 09:46:46
9176,918,3,897,116,1013,9082,2021-01-30 03:06:18
9177,356,3,1247,162,1409,9083,2021-01-29 21:56:37
9178,800,3,727,94,821,9084,2021-01-29 14:11:12
9179,589,3,847,110,957,9085,2021-01-30 01:17:26
9180,982,2,1098,142,1240,9086,2021-01-30 12:26:47
9181,698,3,528,68,596,9087,2021-01-30 06:00:17
9182,458,2,628,81,709,9088,2021-01-29 21:51:58
9183,950,3,997,129,1126,9089,2021-01-30 04:20:10
9184,571,3,597,77,674,9090,2021-01-30 07:38:41
9185,886,3,428,55,483,9091,2021-01-30 14:56:29
9186,660,2,798,103,901,9092,2021-01-30 12:56:03
9187,574,3,478,62,540,9093,2021-01-29 11:59:41
9188,55,5,1306,169,1475,9094,2021-01-29 12:16:32
9189,415,5,1345,174,1519,9095,2021-01-29 03:03:11
9190,518,3,428,55,483,9096,2021-01-29 03:35:27
9191,221,5,1606,208,1814,9097,2021-01-30 05:41:28
9192,618,2,598,77,675,9098,2021-01-30 05:08:01
9193,945,3,428,55,483,9099,2021-01-30 05:43:34
9194,610,3,747,97,844,9100,2021-01-30 06:20:24
9195,122,5,1486,193,1679,9101,2021-01-30 02:14:49
9196,571,3,1197,155,1352,9102,2021-01-30 04:55:59
9197,600,3,658,85,743,9103,2021-01-29 17:17:40
9198,775,3,1247,162,1409,9104,2021-01-29 06:26:55
9199,335,3,478,62,540,9105,2021-01-28 19:26:27
9200,561,3,897,116,1013,9106,2021-01-29 11:24:13
9201,93,4,1646,213,1859,9107,2021-01-29 01:33:28
9202,123,3,1127,146,1273,9108,2021-01-29 06:10:57
9203,869,3,608,79,687,9109,2021-01-28 22:25:33
9204,160,3,1197,155,1352,9110,2021-01-28 21:28:31
9205,226,3,608,79,687,9111,2021-01-29 17:46:21
9206,382,3,697,90,787,9112,2021-01-29 13:04:20
9207,31,5,2145,278,2423,9113,2021-01-29 03:50:17
9208,306,2,429,55,484,9114,2021-01-29 02:48:48
9209,578,5,1395,181,1576,9115,2021-01-29 14:46:48
9210,825,6,1635,212,1847,9116,2021-01-29 19:06:30
9211,636,3,647,84,731,9117,2021-01-30 00:06:22
9212,724,3,597,77,674,9118,2021-01-30 05:05:42
9213,702,4,977,127,1104,9119,2021-01-29 11:53:39
9214,838,5,1495,194,1689,9120,2021-01-29 17:06:49
9215,50,3,597,77,674,9121,2021-01-29 03:50:37
9216,585,3,758,98,856,9122,2021-01-28 22:12:11
9217,671,3,1197,155,1352,9123,2021-01-29 13:05:59
9218,101,3,697,90,787,9124,2021-01-29 08:23:50
9219,758,5,1995,259,2254,9125,2021-01-29 08:54:29
9220,983,5,1506,195,1701,9126,2021-01-29 11:41:58
9221,503,2,659,85,744,9127,2021-01-30 17:32:57
9222,51,2,329,42,371,9128,2021-01-30 17:52:15
9223,948,3,1197,155,1352,9129,2021-01-30 14:56:12
9224,511,3,558,72,630,9130,2021-01-30 16:46:39
9225,649,3,758,98,856,9131,2021-01-30 18:56:31
9226,690,3,478,62,540,9132,2021-01-30 16:32:28
9227,946,3,647,84,731,9133,2021-01-30 16:42:01
9228,946,3,647,84,731,9133,2021-01-30 16:42:01
9229,891,2,429,55,484,9134,2021-01-30 06:10:21
9230,416,4,1526,198,1724,9135,2021-01-30 08:30:45
9231,270,4,1046,135,1181,9136,2021-01-30 03:08:45
9232,91,3,827,107,934,9137,2021-01-29 17:40:21
9233,663,2,898,116,1014,9138,2021-01-29 21:26:31
9234,633,2,598,77,675,9139,2021-01-29 18:55:39
9235,793,3,1127,146,1273,9140,2021-01-30 03:44:51
9236,360,5,1495,194,1689,9141,2021-01-30 09:06:54
9237,288,3,758,98,856,9142,2021-01-30 20:19:02
9238,791,3,1047,136,1183,9143,2021-01-31 02:30:35
9239,552,2,698,90,788,9144,2021-01-30 07:30:58
9240,391,2,798,103,901,9145,2021-01-30 06:25:30
9241,300,3,1247,162,1409,9146,2021-01-30 23:53:45
9242,90,2,429,55,484,9147,2021-01-30 19:10:54
9243,938,2,329,42,371,9148,2021-01-31 01:51:52
9244,795,5,1076,139,1215,9149,2021-01-31 01:02:28
9245,128,3,697,90,787,9150,2021-01-30 10:42:12
9246,457,3,847,110,957,9151,2021-01-30 19:44:31
9247,259,2,798,103,901,9152,2021-01-31 00:49:25
9248,674,3,897,116,1013,9153,2021-01-31 01:52:15
9249,566,3,608,79,687,9154,2021-01-30 19:02:10
9250,100,3,1327,172,1499,9155,2021-01-31 02:39:36
9251,622,2,329,42,371,9156,2021-01-31 10:32:54
9252,97,4,1046,135,1181,9157,2021-01-30 20:54:45
9253,405,3,558,72,630,9158,2021-01-30 13:17:17
9254,566,5,1345,174,1519,9159,2021-01-29 10:29:59
9255,736,2,329,42,371,9160,2021-01-30 00:18:19
9256,167,3,1247,162,1409,9161,2021-01-30 06:39:22
9257,337,4,1077,140,1217,9162,2021-01-30 00:58:49
9258,885,3,797,103,900,9163,2021-01-29 16:31:35
9259,480,3,797,103,900,9164,2021-01-29 08:45:03
9260,261,3,558,72,630,9165,2021-01-29 19:14:08
9261,116,2,429,55,484,9166,2021-01-29 20:59:57
9262,409,3,697,90,787,9167,2021-01-29 19:32:27
9263,345,3,478,62,540,9168,2021-01-29 18:21:58
9264,508,4,827,107,934,9169,2021-01-30 04:57:22
9265,936,1,229,29,258,9170,2021-01-30 03:43:19
9266,411,3,688,89,777,9171,2021-01-30 07:50:26
9267,398,3,428,55,483,9172,2021-01-30 08:25:09
9268,839,5,1076,139,1215,9173,2021-01-30 13:24:15
9269,17,5,1845,239,2084,9174,2021-01-29 23:35:46
9270,224,5,1326,172,1498,9175,2021-01-30 00:09:25
9271,789,4,1057,137,1194,9176,2021-01-29 23:53:07
9272,219,3,747,97,844,9177,2021-01-30 10:42:29
9273,577,2,898,116,1014,9178,2021-01-30 05:14:06
9274,494,5,1556,202,1758,9179,2021-01-29 22:08:27
9275,830,3,1047,136,1183,9180,2021-01-29 14:58:52
9276,958,3,808,105,913,9181,2021-01-30 03:02:07
9277,852,3,997,129,1126,9182,2021-01-30 13:21:31
9278,765,3,697,90,787,9183,2021-01-30 08:19:27
9279,682,3,688,89,777,9184,2021-01-29 22:49:48
9280,903,3,558,72,630,9185,2021-01-30 05:41:46
9281,210,2,698,90,788,9186,2021-01-30 10:18:00
9282,377,2,748,97,845,9187,2021-01-30 15:40:33
9283,984,3,697,90,787,9188,2021-01-30 15:30:25
9284,203,1,499,64,563,9189,2021-01-29 12:56:13
9285,253,6,2444,317,2761,9190,2021-01-29 12:18:56
9286,913,3,597,77,674,9191,2021-01-29 04:14:07
9287,727,3,1247,162,1409,9192,2021-01-29 04:27:47
9288,900,5,1245,161,1406,9193,2021-01-30 07:05:29
9289,9,2,898,116,1014,9194,2021-01-30 07:15:30
9290,362,3,697,90,787,9195,2021-01-30 06:28:20
9291,302,1,299,38,337,9196,2021-01-30 07:59:46
9292,854,3,697,90,787,9197,2021-01-30 03:37:56
9293,767,4,1646,213,1859,9198,2021-01-30 06:36:21
9294,670,2,498,64,562,9199,2021-01-29 19:22:27
9295,687,2,898,116,1014,9200,2021-01-29 07:17:45
9296,879,6,2274,295,2569,9201,2021-01-28 21:49:18
9297,354,3,478,62,540,9202,2021-01-29 12:34:04
9298,965,3,697,90,787,9203,2021-01-29 02:00:51
9299,696,3,528,68,596,9204,2021-01-29 06:37:44
9300,778,2,398,51,449,9205,2021-01-28 23:22:50
9301,599,3,528,68,596,9206,2021-01-28 23:35:00
9302,502,3,558,72,630,9207,2021-01-29 20:30:26
9303,315,3,1127,146,1273,9208,2021-01-29 13:44:54
9304,446,3,558,72,630,9209,2021-01-29 05:41:42
9305,674,3,927,120,1047,9210,2021-01-29 03:09:27
9306,803,3,758,98,856,9211,2021-01-29 16:10:46
9307,668,5,2295,298,2593,9212,2021-01-29 20:25:20
9308,785,2,498,64,562,9213,2021-01-30 00:30:40
9309,386,3,997,129,1126,9214,2021-01-30 06:18:01
9310,783,2,898,116,1014,9215,2021-01-29 13:01:05
9311,435,3,1047,136,1183,9216,2021-01-29 19:47:00
9312,200,5,1845,239,2084,9217,2021-01-29 04:47:38
9313,430,3,558,72,630,9218,2021-01-29 00:15:17
9314,695,3,808,105,913,9219,2021-01-29 13:14:58
9315,974,3,888,115,1003,9220,2021-01-29 08:35:48
9316,487,1,599,77,676,9221,2021-01-29 10:53:52
9317,1000,3,658,85,743,9222,2021-01-29 11:59:32
9318,531,3,997,129,1126,9223,2021-01-30 18:03:02
9319,804,3,578,75,653,9224,2021-01-30 17:54:31
9320,105,4,1296,168,1464,9225,2021-01-30 16:27:59
9321,386,3,528,68,596,9226,2021-01-30 17:01:52
9322,283,1,229,29,258,9227,2021-01-30 21:12:12
9323,547,2,848,110,958,9228,2021-01-30 17:21:18
9324,853,3,647,84,731,9229,2021-01-30 17:21:03
9325,806,2,429,55,484,9230,2021-01-30 18:36:34
9326,237,6,1605,208,1813,9231,2021-01-30 06:47:23
9327,784,2,498,64,562,9232,2021-01-30 10:04:41
9328,410,2,898,116,1014,9233,2021-01-30 05:31:45
9329,578,2,798,103,901,9234,2021-01-29 19:33:21
9330,593,2,1098,142,1240,9235,2021-01-29 22:34:00
9331,260,3,697,90,787,9236,2021-01-29 19:08:25
9332,751,2,329,42,371,9237,2021-01-30 04:59:10
9333,260,3,847,110,957,9238,2021-01-30 10:26:44
9334,59,2,329,42,371,9239,2021-01-30 20:21:02
9335,756,3,1047,136,1183,9240,2021-01-31 03:24:44
9336,196,3,808,105,913,9241,2021-01-30 07:58:51
9337,941,3,647,84,731,9242,2021-01-30 08:21:54
9338,363,3,688,89,777,9243,2021-01-31 01:10:48
9339,158,2,429,55,484,9244,2021-01-30 21:43:09
9340,427,3,1047,136,1183,9245,2021-01-31 02:13:11
9341,850,3,608,79,687,9246,2021-01-31 01:21:09
9342,655,2,429,55,484,9247,2021-01-30 11:27:31
9343,655,2,429,55,484,9247,2021-01-30 11:27:31
9344,228,3,688,89,777,9248,2021-01-30 22:27:41
9345,976,3,1127,146,1273,9249,2021-01-31 01:40:01
9346,149,3,897,116,1013,9250,2021-01-31 02:25:08
9347,545,5,1925,250,2175,9251,2021-01-30 21:11:40
9348,797,3,697,90,787,9252,2021-01-31 05:06:30
9349,425,2,798,103,901,9253,2021-01-31 12:09:58
9350,268,2,898,116,1014,9254,2021-01-30 22:03:26
9351,484,3,558,72,630,9255,2021-01-30 15:21:59
9352,171,3,1197,155,1352,9256,2021-01-29 11:58:04
9353,955,2,598,77,675,9257,2021-01-30 01:59:29
9354,545,2,598,77,675,9258,2021-01-30 08:57:26
9355,271,3,658,85,743,9259,2021-01-30 01:46:43
9356,318,2,798,103,901,9260,2021-01-29 16:44:29
9357,719,3,827,107,934,9261,2021-01-29 10:18:22
9358,16,3,697,90,787,9262,2021-01-29 20:36:40
9359,658,3,847,110,957,9263,2021-01-29 22:05:39
9360,962,3,608,79,687,9264,2021-01-29 21:00:54
9361,107,3,758,98,856,9265,2021-01-29 19:05:47
9362,377,2,828,107,935,9266,2021-01-30 06:55:14
9363,977,2,659,85,744,9267,2021-01-30 05:54:55
9364,332,2,548,71,619,9268,2021-01-30 09:53:30
9365,494,3,727,94,821,9269,2021-01-30 10:13:25
9366,108,2,459,59,518,9270,2021-01-30 16:02:39
9367,586,3,528,68,596,9271,2021-01-30 01:40:46
9368,657,3,558,72,630,9272,2021-01-30 00:11:20
9369,346,3,1127,146,1273,9273,2021-01-30 00:55:34
9370,65,6,1685,219,1904,9274,2021-01-30 11:41:44
9371,616,3,1247,162,1409,9275,2021-01-30 05:28:11
9372,102,5,2145,278,2423,9276,2021-01-30 00:26:58
9373,916,2,329,42,371,9277,2021-01-29 17:29:34
9374,933,3,558,72,630,9278,2021-01-30 03:59:29
9375,101,2,898,116,1014,9279,2021-01-30 13:42:36
9376,775,4,1926,250,2176,9280,2021-01-30 08:25:30
9377,911,5,1756,228,1984,9281,2021-01-30 00:06:19
9378,880,2,659,85,744,9282,2021-01-30 05:56:33
9379,748,2,898,116,1014,9283,2021-01-30 10:52:22
9380,626,2,798,103,901,9284,2021-01-30 16:13:51
9381,940,5,1325,172,1497,9285,2021-01-30 17:34:27
9382,103,5,1545,200,1745,9286,2021-01-29 13:41:57
9383,387,3,1047,136,1183,9287,2021-01-29 13:59:33
9384,451,2,329,42,371,9288,2021-01-29 06:03:11
9385,398,2,898,116,1014,9289,2021-01-29 06:15:41
9386,785,5,1706,221,1927,9290,2021-01-30 09:21:38
9387,434,1,99,12,111,9291,2021-01-30 07:40:06
9388,674,3,1047,136,1183,9292,2021-01-30 08:41:16
9389,471,2,698,90,788,9293,2021-01-30 08:34:40
9390,396,3,758,98,856,9294,2021-01-30 04:38:47
9391,36,3,888,115,1003,9295,2021-01-30 09:20:43
9392,873,5,1575,204,1779,9296,2021-01-29 20:08:11
9393,323,5,1195,155,1350,9297,2021-01-29 08:44:48
9394,939,2,429,55,484,9298,2021-01-29 00:12:48
9395,52,5,1056,137,1193,9299,2021-01-29 14:12:38
9396,708,3,827,107,934,9300,2021-01-29 02:16:05
9397,507,2,898,116,1014,9301,2021-01-29 09:10:10
9398,972,5,1786,232,2018,9302,2021-01-29 00:58:03
9399,764,3,897,116,1013,9303,2021-01-29 00:59:17
9400,736,3,1047,136,1183,9304,2021-01-29 21:05:59
9401,364,3,558,72,630,9305,2021-01-29 14:39:14
9402,236,2,659,85,744,9306,2021-01-29 06:55:43
9403,953,3,927,120,1047,9307,2021-01-29 04:44:01
9404,474,2,748,97,845,9308,2021-01-29 17:03:57
9405,349,3,428,55,483,9309,2021-01-29 22:54:52
9406,430,3,747,97,844,9310,2021-01-30 00:33:42
9407,992,3,608,79,687,9311,2021-01-30 09:00:08
9408,984,3,827,107,934,9312,2021-01-29 15:32:37
9409,513,1,599,77,676,9313,2021-01-29 21:49:25
9410,136,3,1047,136,1183,9314,2021-01-29 06:19:24
9411,537,2,498,64,562,9315,2021-01-29 01:39:42
9412,990,3,688,89,777,9316,2021-01-29 14:57:35
9413,951,5,1425,185,1610,9317,2021-01-29 11:16:42
9414,372,6,2374,308,2682,9318,2021-01-29 12:06:28
9415,805,3,827,107,934,9319,2021-01-29 13:28:06
9416,667,3,1047,136,1183,9320,2021-01-30 19:20:35
9417,383,3,528,68,596,9321,2021-01-30 19:45:15
9418,301,3,478,62,540,9322,2021-01-30 17:12:28
9419,476,3,597,77,674,9323,2021-01-30 17:48:30
9420,441,3,827,107,934,9324,2021-01-30 21:51:03
9421,950,2,628,81,709,9325,2021-01-30 17:29:17
9422,293,5,1356,176,1532,9326,2021-01-30 18:27:43
9423,571,5,1775,230,2005,9327,2021-01-30 19:44:28
9424,172,3,727,94,821,9328,2021-01-30 07:58:33
9425,141,3,1027,133,1160,9329,2021-01-30 12:08:38
9426,714,3,688,89,777,9330,2021-01-30 05:45:56
9427,285,3,1047,136,1183,9331,2021-01-29 20:58:44
9428,229,3,1027,133,1160,9332,2021-01-29 23:17:02
9429,553,3,578,75,653,9333,2021-01-29 20:52:57
9430,60,3,608,79,687,9334,2021-01-30 06:04:46
9431,541,3,1327,172,1499,9335,2021-01-30 12:40:38
9432,94,5,1087,141,1228,9336,2021-01-30 22:31:59
9433,683,2,498,64,562,9337,2021-01-31 03:31:58
9434,19,3,1197,155,1352,9338,2021-01-30 08:43:41
9435,572,3,1027,133,1160,9339,2021-01-30 08:26:56
9436,29,2,329,42,371,9340,2021-01-31 02:47:26
9437,902,3,747,97,844,9341,2021-01-30 23:51:39
9438,113,2,598,77,675,9342,2021-01-31 03:52:15
9439,638,4,956,124,1080,9343,2021-01-31 03:50:42
9440,680,3,747,97,844,9344,2021-01-30 12:17:36
9441,169,3,997,129,1126,9345,2021-01-30 12:09:39
9442,419,2,429,55,484,9346,2021-01-30 22:32:43
9443,964,2,498,64,562,9347,2021-01-31 02:03:28
9444,133,5,1325,172,1497,9348,2021-01-31 04:47:07
9445,120,2,1098,142,1240,9349,2021-01-30 22:50:10
9446,855,2,798,103,901,9350,2021-01-31 06:58:34
9447,594,5,1525,198,1723,9351,2021-01-31 14:11:25
9448,522,6,1774,230,2004,9352,2021-01-30 23:48:16
9449,152,2,498,64,562,9353,2021-01-30 16:35:50
9450,88,3,897,116,1013,9354,2021-01-29 12:27:48
9451,84,3,428,55,483,9355,2021-01-30 03:34:58
9452,94,2,598,77,675,9356,2021-01-30 11:41:06
9453,824,2,928,120,1048,9357,2021-01-30 03:19:30
9454,94,5,1445,187,1632,9358,2021-01-29 17:17:39
9455,777,2,429,55,484,9359,2021-01-29 10:59:05
9456,352,3,888,115,1003,9360,2021-01-29 22:32:16
9457,341,3,797,103,900,9361,2021-01-29 22:25:17
9458,996,2,429,55,484,9362,2021-01-29 21:18:30
9459,634,3,647,84,731,9363,2021-01-29 20:05:55
9460,481,5,1375,178,1553,9364,2021-01-30 07:34:53
9461,745,4,837,108,945,9365,2021-01-30 06:46:06
9462,673,3,608,79,687,9366,2021-01-30 12:39:41
9463,119,3,1047,136,1183,9367,2021-01-30 11:25:44
9464,517,6,1635,212,1847,9368,2021-01-30 16:38:19
9465,874,2,798,103,901,9369,2021-01-30 03:57:40
9466,364,6,1435,186,1621,9370,2021-01-30 01:50:31
9467,109,3,897,116,1013,9371,2021-01-30 02:53:51
9468,290,3,827,107,934,9372,2021-01-30 14:25:22
9469,476,3,847,110,957,9373,2021-01-30 05:32:44
9470,476,3,847,110,957,9373,2021-01-30 05:32:44
9471,193,2,798,103,901,9374,2021-01-30 00:39:04
9472,192,3,747,97,844,9375,2021-01-29 17:42:49
9473,674,2,329,42,371,9376,2021-01-30 04:49:49
9474,443,3,1027,133,1160,9377,2021-01-30 16:23:21
9475,175,6,1844,239,2083,9378,2021-01-30 10:49:47
9476,777,3,947,123,1070,9379,2021-01-30 02:17:41
9477,840,3,927,120,1047,9380,2021-01-30 06:18:44
9478,362,1,399,51,450,9381,2021-01-30 13:09:15
9479,533,2,598,77,675,9382,2021-01-30 16:41:33
9480,326,3,578,75,653,9383,2021-01-30 19:52:51
9481,969,3,808,105,913,9384,2021-01-29 14:47:43
9482,41,3,697,90,787,9385,2021-01-29 14:27:47
9483,942,2,898,116,1014,9386,2021-01-29 06:34:51
9484,102,3,1027,133,1160,9387,2021-01-29 06:21:44
9485,151,3,827,107,934,9388,2021-01-30 10:06:27
9486,461,3,927,120,1047,9389,2021-01-30 10:11:04
9487,603,5,1656,215,1871,9390,2021-01-30 08:55:40
9488,7,3,827,107,934,9391,2021-01-30 10:38:39
9489,158,3,428,55,483,9392,2021-01-30 05:25:40
9490,555,2,598,77,675,9393,2021-01-30 09:56:44
9491,940,2,798,103,901,9394,2021-01-29 20:18:50
9492,441,5,1395,181,1576,9395,2021-01-29 09:07:04
9493,535,2,898,116,1014,9396,2021-01-29 01:30:26
9494,841,2,898,116,1014,9397,2021-01-29 15:35:01
9495,952,3,1127,146,1273,9398,2021-01-29 04:03:25
9496,77,3,608,79,687,9399,2021-01-29 09:22:20
9497,915,1,399,51,450,9400,2021-01-29 02:22:16
9498,489,2,429,55,484,9401,2021-01-29 02:59:27
9499,80,3,1047,136,1183,9402,2021-01-29 21:59:18
9500,666,2,659,85,744,9403,2021-01-29 16:48:36
9501,11,3,997,129,1126,9404,2021-01-29 08:22:04
9502,858,5,1656,215,1871,9405,2021-01-29 05:07:44
9503,706,3,608,79,687,9406,2021-01-29 17:34:18
9504,426,3,888,115,1003,9407,2021-01-29 23:14:30
9505,490,2,659,85,744,9408,2021-01-30 01:57:50
9506,968,6,1994,259,2253,9409,2021-01-30 10:04:14
9507,234,3,608,79,687,9410,2021-01-29 16:26:52
9508,136,3,658,85,743,9411,2021-01-29 23:08:35
9509,430,2,498,64,562,9412,2021-01-29 06:40:43
9510,331,3,727,94,821,9413,2021-01-29 04:12:09
9511,228,3,827,107,934,9414,2021-01-29 17:27:02
9512,620,2,898,116,1014,9415,2021-01-29 12:16:32
9513,787,2,429,55,484,9416,2021-01-29 14:12:15
9514,336,3,597,77,674,9417,2021-01-29 14:58:56
9515,43,3,808,105,913,9418,2021-01-30 20:52:29
9516,176,3,558,72,630,9419,2021-01-30 22:13:29
9517,4,2,429,55,484,9420,2021-01-30 18:04:17
9518,7,2,659,85,744,9421,2021-01-30 18:32:32
9519,81,6,1246,161,1407,9422,2021-01-30 22:13:45
9520,177,3,1197,155,1352,9423,2021-01-30 18:54:55
9521,960,5,1017,132,1149,9424,2021-01-30 19:50:58
9522,878,3,1047,136,1183,9425,2021-01-30 21:06:28
9523,496,3,478,62,540,9426,2021-01-30 08:34:24
9524,281,2,828,107,935,9427,2021-01-30 13:24:59
9525,281,2,828,107,935,9427,2021-01-30 13:24:59
9526,339,5,1795,233,2028,9428,2021-01-30 07:46:09
9527,276,2,1098,142,1240,9429,2021-01-29 21:33:36
9528,914,4,1177,153,1330,9430,2021-01-30 00:31:52
9529,271,3,1327,172,1499,9431,2021-01-29 22:32:49
9530,222,2,659,85,744,9432,2021-01-30 06:17:21
9531,969,5,2045,265,2310,9433,2021-01-30 15:18:50
9532,315,3,1327,172,1499,9434,2021-01-31 00:53:27
9533,86,3,1127,146,1273,9435,2021-01-31 04:22:45
9534,276,2,429,55,484,9436,2021-01-30 09:13:42
9535,179,3,888,115,1003,9437,2021-01-30 09:50:26
9536,635,2,459,59,518,9438,2021-01-31 04:34:08
9537,979,3,558,72,630,9439,2021-01-31 02:15:16
9538,877,2,798,103,901,9440,2021-01-31 05:12:08
9539,571,5,1306,169,1475,9441,2021-01-31 04:17:36
9540,831,3,997,129,1126,9442,2021-01-30 14:05:30
9541,865,3,927,120,1047,9443,2021-01-30 13:26:28
9542,237,3,827,107,934,9444,2021-01-30 22:56:27
9543,107,3,827,107,934,9445,2021-01-31 02:31:50
9544,803,2,598,77,675,9446,2021-01-31 06:17:32
9545,491,1,149,19,168,9447,2021-01-30 23:38:01
9546,966,2,898,116,1014,9448,2021-01-31 09:14:05
9547,4,3,758,98,856,9449,2021-01-31 14:18:52
9548,855,3,827,107,934,9450,2021-01-31 00:50:17
9549,716,2,548,71,619,9451,2021-01-30 18:13:01
9550,573,3,478,62,540,9452,2021-01-29 15:01:04
9551,509,1,399,51,450,9453,2021-01-30 06:12:29
9552,954,2,598,77,675,9454,2021-01-30 13:46:31
9553,734,3,688,89,777,9455,2021-01-30 05:35:28
9554,989,6,2054,267,2321,9456,2021-01-29 19:00:42
9555,596,3,808,105,913,9457,2021-01-29 13:43:09
9556,691,3,558,72,630,9458,2021-01-29 22:57:57
9557,926,3,997,129,1126,9459,2021-01-30 00:20:05
9558,283,2,429,55,484,9460,2021-01-29 21:37:09
9559,293,2,659,85,744,9461,2021-01-29 22:30:34
9560,532,5,1037,134,1171,9462,2021-01-30 10:11:45
9561,170,5,1495,194,1689,9463,2021-01-30 07:12:17
9562,94,5,1225,159,1384,9464,2021-01-30 14:13:27
9563,119,2,598,77,675,9465,2021-01-30 12:28:45
9564,693,1,299,38,337,9466,2021-01-30 18:12:03
9565,709,2,898,116,1014,9467,2021-01-30 04:35:19
9566,944,3,1028,133,1161,9468,2021-01-30 02:29:09
9567,666,3,747,97,844,9469,2021-01-30 05:30:38
9568,148,2,748,97,845,9470,2021-01-30 14:46:26
9569,897,2,1098,142,1240,9471,2021-01-30 08:08:05
9570,476,1,599,77,676,9472,2021-01-30 07:20:39
9571,430,3,1127,146,1273,9473,2021-01-30 03:04:41
9572,84,3,1027,133,1160,9474,2021-01-29 18:18:54
9573,983,3,1027,133,1160,9475,2021-01-30 05:35:24
9574,126,2,528,68,596,9476,2021-01-30 16:41:27
9575,363,1,499,64,563,9477,2021-01-30 13:27:45
9576,992,2,598,77,675,9478,2021-01-30 04:26:23
9577,102,3,897,116,1013,9479,2021-01-30 07:31:35
9578,34,3,428,55,483,9480,2021-01-30 13:54:07
9579,680,2,498,64,562,9481,2021-01-30 17:37:21
9580,920,1,149,19,168,9482,2021-01-30 21:55:32
9581,651,3,897,116,1013,9483,2021-01-29 15:52:19
9582,471,3,827,107,934,9484,2021-01-29 15:17:11
9583,393,2,329,42,371,9485,2021-01-29 08:50:05
9584,740,2,329,42,371,9486,2021-01-29 07:28:52
9585,954,2,598,77,675,9487,2021-01-30 12:31:50
9586,679,3,697,90,787,9488,2021-01-30 11:01:52
9587,19,3,658,85,743,9489,2021-01-30 09:06:57
9588,119,5,1445,187,1632,9490,2021-01-30 10:46:23
9589,293,5,1456,189,1645,9491,2021-01-30 05:53:21
9590,199,3,647,84,731,9492,2021-01-30 10:44:56
9591,97,1,229,29,258,9493,2021-01-29 22:19:43
9592,623,2,1098,142,1240,9494,2021-01-29 09:39:19
9593,302,3,528,68,596,9495,2021-01-29 02:38:29
9594,36,4,926,120,1046,9496,2021-01-29 16:39:16
9595,986,1,299,38,337,9497,2021-01-29 05:11:23
9596,990,3,597,77,674,9498,2021-01-29 10:13:10
9597,179,1,399,51,450,9499,2021-01-29 04:43:32
9598,301,2,498,64,562,9500,2021-01-29 04:28:52
9599,290,3,1327,172,1499,9501,2021-01-30 00:17:54
9600,111,2,698,90,788,9502,2021-01-29 17:37:17
9601,866,3,558,72,630,9503,2021-01-29 10:20:29
9602,716,3,997,129,1126,9504,2021-01-29 06:12:41
9603,486,3,1127,146,1273,9505,2021-01-29 19:01:26
9604,814,3,1327,172,1499,9506,2021-01-30 01:24:19
9605,450,2,898,116,1014,9507,2021-01-30 03:16:40
9606,506,3,1027,133,1160,9508,2021-01-30 12:31:58
9607,482,4,1276,165,1441,9509,2021-01-29 18:53:32
9608,494,3,1327,172,1499,9510,2021-01-30 00:12:06
9609,278,3,697,90,787,9511,2021-01-29 08:24:37
9610,356,3,1047,136,1183,9512,2021-01-29 04:18:39
9611,671,2,598,77,675,9513,2021-01-29 18:56:38
9612,63,2,498,64,562,9514,2021-01-29 12:25:05
9613,910,1,229,29,258,9515,2021-01-29 15:12:46
9614,589,2,659,85,744,9516,2021-01-29 16:15:01
9615,821,3,827,107,934,9517,2021-01-30 22:03:42
9616,677,3,747,97,844,9518,2021-01-31 00:57:17
9617,352,2,898,116,1014,9519,2021-01-30 19:09:36
9618,644,3,997,129,1126,9520,2021-01-30 19:06:52
9619,909,4,996,129,1125,9521,2021-01-31 00:29:45
9620,904,3,1047,136,1183,9522,2021-01-30 19:55:03
9621,523,2,429,55,484,9523,2021-01-30 20:20:20
9622,321,2,598,77,675,9524,2021-01-30 22:19:18
9623,98,5,1525,198,1723,9525,2021-01-30 10:48:23
9624,291,5,1475,191,1666,9526,2021-01-30 15:50:46
9625,247,2,659,85,744,9527,2021-01-30 13:32:36
9626,606,3,528,68,596,9528,2021-01-30 08:03:48
9627,654,2,498,64,562,9529,2021-01-29 23:02:17
9628,998,3,727,94,821,9530,2021-01-30 03:15:15
9629,44,3,797,103,900,9531,2021-01-30 00:32:33
9630,856,3,558,72,630,9532,2021-01-30 07:37:24
9631,785,2,898,116,1014,9533,2021-01-30 16:19:46
9632,953,2,898,116,1014,9534,2021-01-31 01:07:49
9633,45,5,1626,211,1837,9535,2021-01-31 07:08:09
9634,773,5,1126,146,1272,9536,2021-01-30 11:40:51
9635,17,3,897,116,1013,9537,2021-01-30 11:10:48
9636,437,3,897,116,1013,9538,2021-01-31 07:17:58
9637,590,2,659,85,744,9539,2021-01-31 04:04:05
9638,294,2,598,77,675,9540,2021-01-31 06:34:10
9639,196,2,698,90,788,9541,2021-01-31 06:46:42
9640,453,3,727,94,821,9542,2021-01-30 16:33:21
9641,877,3,697,90,787,9543,2021-01-30 15:57:35
9642,514,3,927,120,1047,9544,2021-01-31 00:14:34
9643,568,3,747,97,844,9545,2021-01-31 03:46:18
9644,495,3,1197,155,1352,9546,2021-01-31 08:40:44
9645,555,3,888,115,1003,9547,2021-01-31 02:22:05
9646,828,2,448,58,506,9548,2021-01-31 09:34:35
9647,215,2,498,64,562,9549,2021-01-31 16:43:15
9648,850,3,428,55,483,9550,2021-01-31 01:35:28
9649,776,3,558,72,630,9551,2021-01-30 18:58:38
9650,466,3,1027,133,1160,9552,2021-01-29 15:39:27
9651,306,3,997,129,1126,9553,2021-01-30 06:40:00
9652,780,5,1456,189,1645,9554,2021-01-30 14:24:06
9653,780,5,1456,189,1645,9554,2021-01-30 14:24:06
9654,263,2,628,81,709,9555,2021-01-30 06:33:44
9655,483,3,597,77,674,9556,2021-01-29 20:04:12
9656,66,3,847,110,957,9557,2021-01-29 15:01:21
9657,577,3,528,68,596,9558,2021-01-29 23:07:30
9658,784,3,428,55,483,9559,2021-01-30 02:26:00
9659,474,3,997,129,1126,9560,2021-01-29 23:05:30
9660,474,3,997,129,1126,9560,2021-01-29 23:05:30
9661,333,2,798,103,901,9561,2021-01-29 23:45:29
9662,523,3,608,79,687,9562,2021-01-30 10:21:14
9663,240,2,1098,142,1240,9563,2021-01-30 07:27:30
9664,149,1,699,90,789,9564,2021-01-30 15:55:00
9665,201,6,1854,241,2095,9565,2021-01-30 13:29:54
9666,986,3,888,115,1003,9566,2021-01-30 18:12:45
9667,962,6,1555,202,1757,9567,2021-01-30 06:48:48
9668,95,3,1027,133,1160,9568,2021-01-30 03:49:16
9669,369,3,847,110,957,9569,2021-01-30 06:07:07
9670,116,6,2074,269,2343,9570,2021-01-30 16:27:51
9671,272,3,888,115,1003,9571,2021-01-30 09:44:41
9672,566,2,1098,142,1240,9572,2021-01-30 10:06:45
9673,53,1,229,29,258,9573,2021-01-30 04:17:56
9674,852,2,898,116,1014,9574,2021-01-29 20:09:45
9675,510,2,848,110,958,9575,2021-01-30 05:40:31
9676,520,2,659,85,744,9576,2021-01-30 16:50:35
9677,180,3,827,107,934,9577,2021-01-30 15:37:49
9678,461,3,758,98,856,9578,2021-01-30 06:19:57
9679,292,2,329,42,371,9579,2021-01-30 07:40:39
9680,794,3,658,85,743,9580,2021-01-30 16:08:19
9681,227,3,827,107,934,9581,2021-01-30 18:17:26
9682,602,3,997,129,1126,9582,2021-01-31 00:28:50
9683,4,3,1247,162,1409,9583,2021-01-29 18:03:29
9684,189,2,898,116,1014,9584,2021-01-29 17:31:39
9685,241,3,647,84,731,9585,2021-01-29 08:55:45
9686,958,2,598,77,675,9586,2021-01-29 09:48:29
9687,546,2,598,77,675,9587,2021-01-30 13:32:55
9688,999,3,528,68,596,9588,2021-01-30 12:50:04
9689,589,6,1524,198,1722,9589,2021-01-30 11:35:40
9690,496,3,697,90,787,9590,2021-01-30 11:32:09
9691,919,3,688,89,777,9591,2021-01-30 06:47:33
9692,494,2,598,77,675,9592,2021-01-30 10:47:40
9693,809,3,1047,136,1183,9593,2021-01-29 23:28:23
9694,715,3,1047,136,1183,9594,2021-01-29 10:05:12
9695,154,3,997,129,1126,9595,2021-01-29 04:33:33
9696,225,3,827,107,934,9596,2021-01-29 16:44:38
9697,183,3,747,97,844,9597,2021-01-29 07:42:33
9698,475,2,598,77,675,9598,2021-01-29 11:54:36
9699,779,3,697,90,787,9599,2021-01-29 06:21:29
9700,321,3,1027,133,1160,9600,2021-01-29 04:42:07
9701,457,2,898,116,1014,9601,2021-01-30 01:18:49
9702,94,3,578,75,653,9602,2021-01-29 17:51:49
9703,538,2,1098,142,1240,9603,2021-01-29 11:29:36
9704,960,3,1047,136,1183,9604,2021-01-29 07:35:21
9705,538,2,429,55,484,9605,2021-01-29 21:02:49
9706,959,3,888,115,1003,9606,2021-01-30 03:19:05
9707,772,2,648,84,732,9607,2021-01-30 04:32:38
9708,627,3,1147,149,1296,9608,2021-01-30 15:07:54
9709,129,3,927,120,1047,9609,2021-01-29 21:20:40
9710,49,3,1247,162,1409,9610,2021-01-30 01:16:26
9711,927,3,428,55,483,9611,2021-01-29 10:36:16
9712,927,3,428,55,483,9611,2021-01-29 10:36:16
9713,547,3,1127,146,1273,9612,2021-01-29 04:56:22
9714,462,2,598,77,675,9613,2021-01-29 20:34:35
9715,635,3,888,115,1003,9614,2021-01-29 14:07:57
9716,399,5,1256,163,1419,9615,2021-01-29 16:16:30
9717,767,2,798,103,901,9616,2021-01-29 16:44:56
9718,47,2,598,77,675,9617,2021-01-30 22:43:33
9719,153,6,1575,204,1779,9618,2021-01-31 02:48:09
9720,337,3,478,62,540,9619,2021-01-30 21:53:46
9721,273,3,1027,133,1160,9620,2021-01-30 20:10:40
9722,863,3,658,85,743,9621,2021-01-31 01:45:12
9723,91,2,459,59,518,9622,2021-01-30 21:29:15
9724,162,3,897,116,1013,9623,2021-01-30 22:56:06
9725,162,3,897,116,1013,9623,2021-01-30 22:56:06
9726,62,3,528,68,596,9624,2021-01-31 00:03:23
9727,275,2,698,90,788,9625,2021-01-30 12:18:10
9728,972,3,1197,155,1352,9626,2021-01-30 18:16:08
9729,791,3,558,72,630,9627,2021-01-30 14:11:40
9730,253,3,827,107,934,9628,2021-01-30 08:37:52
9731,828,3,1247,162,1409,9629,2021-01-29 23:13:06
9732,72,4,1257,163,1420,9630,2021-01-30 04:47:41
9733,691,5,1525,198,1723,9631,2021-01-30 00:32:46
9734,648,2,898,116,1014,9632,2021-01-30 10:13:58
9735,597,3,478,62,540,9633,2021-01-30 16:28:04
9736,226,3,428,55,483,9634,2021-01-31 03:07:38
9737,994,6,1854,241,2095,9635,2021-01-31 08:50:51
9738,281,4,1107,143,1250,9636,2021-01-30 13:11:11
9739,932,3,747,97,844,9637,2021-01-30 11:53:36
9740,95,2,598,77,675,9638,2021-01-31 07:48:07
9741,2,3,947,123,1070,9639,2021-01-31 06:46:43
9742,606,3,827,107,934,9640,2021-01-31 08:29:42
9743,105,6,2454,319,2773,9641,2021-01-31 06:57:07
9744,340,2,698,90,788,9642,2021-01-30 17:10:13
9745,99,3,1127,146,1273,9643,2021-01-30 18:12:58
9746,91,1,299,38,337,9644,2021-01-31 01:03:57
9747,988,3,997,129,1126,9645,2021-01-31 05:34:00
9748,119,2,828,107,935,9646,2021-01-31 10:08:56
9749,388,5,1126,146,1272,9647,2021-01-31 03:52:45
9750,40,2,498,64,562,9648,2021-01-31 09:44:24
9751,979,2,898,116,1014,9649,2021-01-31 18:19:21
9752,974,1,149,19,168,9650,2021-01-31 02:12:01
9753,558,2,848,110,958,9651,2021-01-30 20:01:55
9754,970,3,758,98,856,9652,2021-01-29 16:47:27
9755,576,3,997,129,1126,9653,2021-01-30 07:38:30
9756,329,1,149,19,168,9654,2021-01-30 14:59:53
9757,748,3,1027,133,1160,9655,2021-01-30 15:49:17
9758,821,3,927,120,1047,9656,2021-01-30 09:15:00
9759,436,3,847,110,957,9657,2021-01-29 21:54:06
9760,700,3,827,107,934,9658,2021-01-29 15:50:13
9761,428,3,747,97,844,9659,2021-01-30 01:45:09
9762,573,5,1706,221,1927,9660,2021-01-30 03:47:48
9763,181,6,2394,311,2705,9661,2021-01-29 23:16:13
9764,942,2,329,42,371,9662,2021-01-29 23:54:12
9765,974,5,1945,252,2197,9663,2021-01-30 02:24:12
9766,652,2,659,85,744,9664,2021-01-30 12:04:59
9767,342,4,1287,167,1454,9665,2021-01-30 08:40:23
9768,233,3,478,62,540,9666,2021-01-30 15:58:00
9769,949,2,898,116,1014,9667,2021-01-30 13:37:01
9770,464,3,847,110,957,9668,2021-01-30 18:50:15
9771,930,2,329,42,371,9669,2021-01-30 08:35:10
9772,189,2,1098,142,1240,9670,2021-01-30 04:52:13
9773,382,3,797,103,900,9671,2021-01-30 08:23:59
9774,482,3,558,72,630,9672,2021-01-30 18:24:47
9775,305,3,847,110,957,9673,2021-01-30 10:53:11
9776,685,2,659,85,744,9674,2021-01-30 12:30:54
9777,846,3,558,72,630,9675,2021-01-30 06:15:45
9778,834,3,827,107,934,9676,2021-01-29 21:40:59
9779,933,4,1387,180,1567,9677,2021-01-30 07:41:02
9780,912,3,747,97,844,9678,2021-01-30 19:19:28
9781,60,1,149,19,168,9679,2021-01-30 16:41:43
9782,431,2,598,77,675,9680,2021-01-30 07:45:49
9783,439,2,698,90,788,9681,2021-01-30 07:51:09
9784,13,3,827,107,934,9682,2021-01-30 17:49:50
9785,409,3,1047,136,1183,9683,2021-01-30 20:27:14
9786,138,5,1256,163,1419,9684,2021-01-31 01:42:03
9787,52,3,808,105,913,9685,2021-01-29 18:07:59
9788,197,3,558,72,630,9686,2021-01-29 18:42:22
9789,91,3,808,105,913,9687,2021-01-29 11:27:14
9790,380,2,1098,142,1240,9688,2021-01-29 09:58:23
9791,597,5,1845,239,2084,9689,2021-01-30 13:49:30
9792,717,2,498,64,562,9690,2021-01-30 14:00:53
9793,551,2,1098,142,1240,9691,2021-01-30 12:14:27
9794,926,1,499,64,563,9692,2021-01-30 12:26:56
9795,74,3,478,62,540,9693,2021-01-30 07:35:48
9796,120,3,478,62,540,9694,2021-01-30 12:00:43
9797,348,2,898,116,1014,9695,2021-01-30 01:28:40
9798,194,3,747,97,844,9696,2021-01-29 11:37:15
9799,575,3,1197,155,1352,9697,2021-01-29 07:01:22
9800,447,2,598,77,675,9698,2021-01-29 17:40:13
9801,314,6,1266,164,1430,9699,2021-01-29 08:41:12
9802,158,2,698,90,788,9700,2021-01-29 13:52:44
9803,84,2,798,103,901,9701,2021-01-29 08:21:09
9804,683,3,697,90,787,9702,2021-01-29 05:49:11
9805,667,3,558,72,630,9703,2021-01-30 02:38:52
9806,506,4,1387,180,1567,9704,2021-01-29 18:07:51
9807,209,2,798,103,901,9705,2021-01-29 13:52:54
9808,269,4,1196,155,1351,9706,2021-01-29 10:08:41
9809,178,3,827,107,934,9707,2021-01-29 22:40:54
9810,6,2,498,64,562,9708,2021-01-30 05:33:13
9811,354,2,598,77,675,9709,2021-01-30 07:01:09
9812,529,3,747,97,844,9710,2021-01-30 17:51:07
9813,112,3,647,84,731,9711,2021-01-29 23:40:08
9814,187,3,997,129,1126,9712,2021-01-30 01:25:02
9815,778,5,907,117,1024,9713,2021-01-29 12:15:17
9816,790,3,847,110,957,9714,2021-01-29 12:16:31
9817,674,5,1706,221,1927,9715,2021-01-29 05:48:43
9818,609,3,1047,136,1183,9716,2021-01-29 23:02:53
9819,226,3,528,68,596,9717,2021-01-29 16:19:37
9820,361,3,888,115,1003,9718,2021-01-29 18:33:52
9821,7,6,1366,177,1543,9719,2021-01-29 18:03:40
9822,993,3,897,116,1013,9720,2021-01-31 00:11:17
9823,754,3,997,129,1126,9721,2021-01-31 04:38:04
9824,209,3,747,97,844,9722,2021-01-30 23:33:31
9825,468,3,1197,155,1352,9723,2021-01-30 22:51:44
9826,717,3,808,105,913,9724,2021-01-31 02:58:03
9827,383,3,1047,136,1183,9725,2021-01-30 23:56:56
9828,17,3,827,107,934,9726,2021-01-31 00:28:22
9829,583,6,1485,193,1678,9727,2021-01-30 23:17:39
9830,476,5,1306,169,1475,9728,2021-01-31 02:11:41
9831,606,2,1098,142,1240,9729,2021-01-30 15:00:39
9832,510,4,1146,148,1294,9730,2021-01-30 20:53:16
9833,505,2,1098,142,1240,9731,2021-01-30 14:56:27
9834,121,5,1406,182,1588,9732,2021-01-30 08:51:56
9835,886,3,528,68,596,9733,2021-01-29 23:56:16
9836,224,3,1197,155,1352,9734,2021-01-30 06:36:50
9837,825,5,1656,215,1871,9735,2021-01-30 01:23:56
9838,811,3,847,110,957,9736,2021-01-30 12:56:10
9839,363,3,647,84,731,9737,2021-01-30 17:13:29
9840,121,3,1127,146,1273,9738,2021-01-31 05:12:33
9841,172,5,1556,202,1758,9739,2021-01-31 10:40:29
9842,498,5,1725,224,1949,9740,2021-01-30 13:16:58
9843,426,3,647,84,731,9741,2021-01-30 13:55:30
9844,538,1,99,12,111,9742,2021-01-31 10:04:08
9845,47,2,828,107,935,9743,2021-01-31 08:47:17
9846,575,3,997,129,1126,9744,2021-01-31 10:51:25
9847,446,3,747,97,844,9745,2021-01-31 07:38:26
9848,808,3,697,90,787,9746,2021-01-30 17:35:46
9849,650,1,99,12,111,9747,2021-01-30 18:57:56
9850,246,3,688,89,777,9748,2021-01-31 01:37:44
9851,639,3,647,84,731,9749,2021-01-31 07:52:18
9852,8,5,1126,146,1272,9750,2021-01-31 11:52:13
9853,458,3,647,84,731,9751,2021-01-31 06:26:26
9854,316,1,499,64,563,9752,2021-01-31 12:27:41
9855,423,2,1098,142,1240,9753,2021-01-31 19:44:28
9856,547,3,897,116,1013,9754,2021-01-31 03:53:34
9857,994,2,628,81,709,9755,2021-01-30 20:04:09
9858,753,4,1296,168,1464,9756,2021-01-29 19:06:14
9859,264,3,658,85,743,9757,2021-01-30 08:32:38
9860,39,3,997,129,1126,9758,2021-01-30 15:23:49
9861,171,2,1098,142,1240,9759,2021-01-30 18:22:18
9862,207,3,647,84,731,9760,2021-01-30 11:24:06
9863,683,3,578,75,653,9761,2021-01-29 22:54:02
9864,366,1,99,12,111,9762,2021-01-29 18:04:30
9865,843,3,578,75,653,9763,2021-01-30 02:45:39
9866,972,2,798,103,901,9764,2021-01-30 06:26:24
9867,179,2,429,55,484,9765,2021-01-30 02:01:44
9868,409,2,429,55,484,9766,2021-01-30 00:07:54
9869,150,2,898,116,1014,9767,2021-01-30 04:21:56
9870,535,3,827,107,934,9768,2021-01-30 14:26:26
9871,804,3,1047,136,1183,9769,2021-01-30 11:14:53
9872,400,3,827,107,934,9770,2021-01-30 17:46:08
9873,158,3,897,116,1013,9771,2021-01-30 15:12:07
9874,795,3,597,77,674,9772,2021-01-30 19:21:37
9875,6,1,149,19,168,9773,2021-01-30 10:03:41
9876,6,1,149,19,168,9773,2021-01-30 10:03:41
9877,297,2,498,64,562,9774,2021-01-30 06:09:54
9878,601,2,698,90,788,9775,2021-01-30 09:28:28
9879,192,4,1227,159,1386,9776,2021-01-30 20:30:38
9880,568,2,1098,142,1240,9777,2021-01-30 12:33:06
9881,783,3,428,55,483,9778,2021-01-30 14:07:32
9882,645,2,848,110,958,9779,2021-01-30 06:31:26
9883,536,3,428,55,483,9780,2021-01-29 22:08:18
9884,722,5,1545,200,1745,9781,2021-01-30 10:26:02
9885,964,2,898,116,1014,9782,2021-01-30 19:51:03
9886,732,2,798,103,901,9783,2021-01-30 17:42:43
9887,434,2,528,68,596,9784,2021-01-30 09:58:57
9888,507,4,807,104,911,9785,2021-01-30 08:16:26
9889,753,3,797,103,900,9786,2021-01-30 20:01:53
9890,655,3,558,72,630,9787,2021-01-30 20:29:27
9891,721,2,398,51,449,9788,2021-01-31 04:27:37
9892,742,3,1047,136,1183,9789,2021-01-29 18:19:28
9893,665,2,698,90,788,9790,2021-01-29 20:56:17
9894,498,3,1247,162,1409,9791,2021-01-29 12:27:45
9895,573,3,1127,146,1273,9792,2021-01-29 11:58:23
9896,283,2,659,85,744,9793,2021-01-30 14:32:50
9897,921,2,598,77,675,9794,2021-01-30 15:03:32
9898,692,4,1127,146,1273,9795,2021-01-30 12:20:35
9899,533,2,659,85,744,9796,2021-01-30 13:17:26
9900,378,3,827,107,934,9797,2021-01-30 09:31:27
9901,708,3,428,55,483,9798,2021-01-30 12:07:06
9902,936,3,608,79,687,9799,2021-01-30 02:42:56
9903,827,2,459,59,518,9800,2021-01-29 13:29:09
9904,608,6,1505,195,1700,9801,2021-01-29 08:22:35
9905,734,3,1027,133,1160,9802,2021-01-29 19:42:40
9906,265,2,459,59,518,9803,2021-01-29 09:40:32
9907,193,3,1047,136,1183,9804,2021-01-29 16:19:10
9908,928,3,758,98,856,9805,2021-01-29 08:41:22
9909,40,3,1327,172,1499,9806,2021-01-29 06:57:10
9910,932,3,1327,172,1499,9807,2021-01-30 03:05:33
9911,54,3,747,97,844,9808,2021-01-29 18:59:14
9912,892,3,478,62,540,9809,2021-01-29 15:53:13
9913,866,3,888,115,1003,9810,2021-01-29 11:31:26
9914,670,5,1556,202,1758,9811,2021-01-30 00:50:12
9915,972,6,1785,232,2017,9812,2021-01-30 05:53:50
9916,260,3,758,98,856,9813,2021-01-30 09:35:37
9917,47,3,747,97,844,9814,2021-01-30 19:38:22
9918,945,3,558,72,630,9815,2021-01-30 00:57:54
9919,424,2,598,77,675,9816,2021-01-30 04:02:48
9920,873,2,698,90,788,9817,2021-01-29 13:31:30
9921,421,3,528,68,596,9818,2021-01-29 12:58:34
9922,969,2,598,77,675,9819,2021-01-29 06:05:35
9923,631,2,329,42,371,9820,2021-01-30 01:20:27
9924,629,3,558,72,630,9821,2021-01-29 17:05:33
9925,629,3,558,72,630,9821,2021-01-29 17:05:33
9926,144,1,499,64,563,9822,2021-01-29 20:01:28
9927,709,2,659,85,744,9823,2021-01-29 18:42:58
9928,828,5,1017,132,1149,9824,2021-01-31 01:49:52
9929,17,2,798,103,901,9825,2021-01-31 07:11:23
9930,61,3,558,72,630,9826,2021-01-31 01:15:22
9931,119,6,1685,219,1904,9827,2021-01-31 00:58:32
9932,548,6,1774,230,2004,9828,2021-01-31 04:45:55
9933,902,3,528,68,596,9829,2021-01-31 00:47:40
9934,295,2,698,90,788,9830,2021-01-31 02:33:07
9935,936,3,947,123,1070,9831,2021-01-31 00:37:58
9936,806,3,997,129,1126,9832,2021-01-31 03:54:27
9937,806,3,997,129,1126,9832,2021-01-31 03:54:27
9938,740,2,598,77,675,9833,2021-01-30 15:12:55
9939,421,2,498,64,562,9834,2021-01-30 22:38:06
9940,785,3,747,97,844,9835,2021-01-30 15:59:44
9941,502,3,478,62,540,9836,2021-01-30 08:55:12
9942,401,1,399,51,450,9837,2021-01-30 00:56:45
9943,695,3,1127,146,1273,9838,2021-01-30 08:46:44
9944,547,3,997,129,1126,9839,2021-01-30 03:32:14
9945,839,3,747,97,844,9840,2021-01-30 13:03:41
9946,745,3,747,97,844,9841,2021-01-30 18:45:36
9947,105,3,888,115,1003,9842,2021-01-31 07:06:37
9948,171,2,898,116,1014,9843,2021-01-31 10:45:36
9949,10,2,659,85,744,9844,2021-01-30 13:40:29
9950,352,3,558,72,630,9845,2021-01-30 14:11:35
9951,25,2,659,85,744,9846,2021-01-31 10:27:41
9952,100,2,798,103,901,9847,2021-01-31 09:03:28
9953,881,2,698,90,788,9848,2021-01-31 12:04:52
9954,735,3,827,107,934,9849,2021-01-31 09:54:41
9955,604,3,1097,142,1239,9850,2021-01-30 19:42:08
9956,434,4,1226,159,1385,9851,2021-01-30 21:11:48
9957,166,3,597,77,674,9852,2021-01-31 02:23:39
9958,691,2,798,103,901,9853,2021-01-31 10:22:24
9959,205,2,628,81,709,9854,2021-01-31 13:58:05
9960,173,3,647,84,731,9855,2021-01-31 07:11:29
9961,356,3,888,115,1003,9856,2021-01-31 13:08:46
9962,113,3,927,120,1047,9857,2021-01-31 21:45:24
9963,301,5,1195,155,1350,9858,2021-01-31 04:10:12
9964,137,5,1695,220,1915,9859,2021-01-30 20:18:22
9965,928,2,828,107,935,9860,2021-01-29 21:00:30
9966,297,3,997,129,1126,9861,2021-01-30 09:30:40
9967,220,6,2215,287,2502,9862,2021-01-30 18:06:12
9968,389,3,797,103,900,9863,2021-01-30 18:40:20
9969,670,3,1127,146,1273,9864,2021-01-30 14:08:36
9970,542,5,2225,289,2514,9865,2021-01-30 00:21:11
9971,715,3,1127,146,1273,9866,2021-01-29 19:21:15
9972,82,5,1345,174,1519,9867,2021-01-30 05:21:18
9973,608,6,1785,232,2017,9868,2021-01-30 08:40:52
9974,632,2,659,85,744,9869,2021-01-30 02:59:04
9975,85,2,598,77,675,9870,2021-01-30 02:27:24
9976,782,2,659,85,744,9871,2021-01-30 04:49:08
9977,83,3,1027,133,1160,9872,2021-01-30 14:56:45
9978,322,2,498,64,562,9873,2021-01-30 11:48:15
9979,191,5,1395,181,1576,9874,2021-01-30 19:17:29
9980,942,5,1286,167,1453,9875,2021-01-30 15:52:16
9981,283,3,1247,162,1409,9876,2021-01-30 20:43:42
9982,128,2,528,68,596,9877,2021-01-30 10:21:46
9983,691,5,1245,161,1406,9878,2021-01-30 11:26:40
9984,546,3,688,89,777,9879,2021-01-30 06:36:39
9985,586,3,1247,162,1409,9880,2021-01-30 11:32:11
9986,287,3,747,97,844,9881,2021-01-30 21:07:22
9987,378,3,608,79,687,9882,2021-01-30 15:08:31
9988,201,3,697,90,787,9883,2021-01-30 15:10:11
9989,438,2,698,90,788,9884,2021-01-30 06:51:02
9990,947,3,558,72,630,9885,2021-01-29 22:27:34
9991,165,3,1327,172,1499,9886,2021-01-30 11:32:54
9992,406,3,428,55,483,9887,2021-01-30 22:11:02
9993,629,3,478,62,540,9888,2021-01-30 19:44:59
9994,402,5,1675,217,1892,9889,2021-01-30 12:35:29
9995,385,3,758,98,856,9890,2021-01-30 09:49:46
9996,68,3,1327,172,1499,9891,2021-01-30 22:08:56
9997,900,2,598,77,675,9892,2021-01-30 21:02:41
9998,600,2,498,64,562,9893,2021-01-31 05:08:44
9999,183,3,927,120,1047,9894,2021-01-29 19:49:52
10000,174,3,1197,155,1352,9895,2021-01-29 23:27:03
10001,479,1,699,90,789,9896,2021-01-29 14:26:46
10002,289,6,1705,221,1926,9897,2021-01-29 13:30:04
10003,908,5,1445,187,1632,9898,2021-01-30 15:08:41
10004,135,3,558,72,630,9899,2021-01-30 17:46:36
10005,313,3,897,116,1013,9900,2021-01-30 13:49:00
10006,813,2,598,77,675,9901,2021-01-30 15:42:34
10007,292,3,927,120,1047,9902,2021-01-30 11:16:30
10008,26,3,827,107,934,9903,2021-01-30 12:12:32
10009,329,3,658,85,743,9904,2021-01-30 05:25:38
10010,411,2,698,90,788,9905,2021-01-29 15:35:39
10011,248,3,747,97,844,9906,2021-01-29 08:44:00
10012,855,3,558,72,630,9907,2021-01-29 21:54:23
10013,557,3,1247,162,1409,9908,2021-01-29 09:47:01
10014,609,2,429,55,484,9909,2021-01-29 16:22:24
10015,888,3,428,55,483,9910,2021-01-29 08:57:45
10016,165,3,888,115,1003,9911,2021-01-29 08:16:04
10017,627,2,848,110,958,9912,2021-01-30 05:18:12
10018,699,2,459,59,518,9913,2021-01-29 19:01:13
10019,197,3,558,72,630,9914,2021-01-29 18:16:36
10020,413,3,1258,163,1421,9915,2021-01-29 13:23:42
10021,561,3,478,62,540,9916,2021-01-30 02:59:16
10022,641,2,598,77,675,9917,2021-01-30 08:36:04
10023,762,2,659,85,744,9918,2021-01-30 10:20:24
10024,788,3,847,110,957,9919,2021-01-30 21:56:09
10025,55,3,1247,162,1409,9920,2021-01-30 01:57:25
10026,818,2,598,77,675,9921,2021-01-30 06:39:31
10027,377,2,898,116,1014,9922,2021-01-29 13:42:25
10028,625,2,429,55,484,9923,2021-01-29 15:32:15
10029,163,2,498,64,562,9924,2021-01-29 06:59:51
10030,891,3,797,103,900,9925,2021-01-30 03:26:19
10031,372,3,558,72,630,9926,2021-01-29 17:32:10
10032,297,3,1027,133,1160,9927,2021-01-29 19:49:13
10033,569,3,747,97,844,9928,2021-01-29 22:13:10
10034,709,3,997,129,1126,9929,2021-01-29 19:03:28
10035,524,3,808,105,913,9930,2021-01-31 02:13:16
10036,302,3,578,75,653,9931,2021-01-31 09:53:31
10037,340,3,578,75,653,9932,2021-01-31 03:35:32
10038,712,3,597,77,674,9933,2021-01-31 03:17:36
10039,873,3,597,77,674,9934,2021-01-31 07:05:53
10040,812,3,747,97,844,9935,2021-01-31 02:40:56
10041,139,3,897,116,1013,9936,2021-01-31 04:46:06
10042,277,3,808,105,913,9937,2021-01-31 01:17:17
10043,696,3,747,97,844,9938,2021-01-31 05:02:12
10044,212,3,847,110,957,9939,2021-01-31 05:43:16
10045,452,3,997,129,1126,9940,2021-01-30 15:42:56
10046,354,3,688,89,777,9941,2021-01-31 00:59:12
10047,3,3,1127,146,1273,9942,2021-01-30 17:33:24
10048,212,2,898,116,1014,9943,2021-01-30 11:31:40
10049,581,5,1017,132,1149,9944,2021-01-30 01:25:16
10050,651,3,1047,136,1183,9945,2021-01-30 09:40:57
10051,513,3,647,84,731,9946,2021-01-30 04:54:07
10052,185,3,997,129,1126,9947,2021-01-30 14:13:27
10053,180,3,1327,172,1499,9948,2021-01-30 21:13:05
10054,636,2,898,116,1014,9949,2021-01-31 08:42:57
10055,224,3,1127,146,1273,9950,2021-01-31 11:52:35
10056,140,3,727,94,821,9951,2021-01-30 15:29:07
10057,655,3,1047,136,1183,9952,2021-01-30 16:39:48
10058,59,2,429,55,484,9953,2021-01-31 11:10:33
10059,94,3,827,107,934,9954,2021-01-31 10:51:08
10060,792,3,758,98,856,9955,2021-01-31 12:12:33
10061,570,3,758,98,856,9956,2021-01-31 11:37:22
10062,233,3,1027,133,1160,9957,2021-01-30 20:55:43
10063,321,3,578,75,653,9958,2021-01-30 23:16:46
10064,107,3,578,75,653,9959,2021-01-31 02:35:35
10065,488,3,1327,172,1499,9960,2021-01-31 11:00:55
10066,145,2,498,64,562,9961,2021-01-31 15:53:54
10067,956,2,798,103,901,9962,2021-01-31 09:19:09
10068,787,2,528,68,596,9963,2021-01-31 14:11:10
10069,494,3,1047,136,1183,9964,2021-02-01 00:15:23
10070,213,3,1047,136,1183,9965,2021-01-31 06:31:56
10071,109,3,658,85,743,9966,2021-01-30 21:07:52
10072,562,3,558,72,630,9967,2021-01-29 21:35:20
10073,652,3,578,75,653,9968,2021-01-30 10:11:44
10074,465,3,947,123,1070,9969,2021-01-30 19:56:46
10075,343,3,688,89,777,9970,2021-01-30 19:57:44
10076,436,6,1774,230,2004,9971,2021-01-30 14:23:37
10077,825,3,697,90,787,9972,2021-01-30 01:16:25
10078,815,1,599,77,676,9973,2021-01-29 20:22:49
10079,778,2,548,71,619,9974,2021-01-30 07:02:57
10080,273,3,947,123,1070,9975,2021-01-30 09:53:17
10081,782,3,558,72,630,9976,2021-01-30 03:27:42
10082,711,3,1127,146,1273,9977,2021-01-30 04:42:07
10083,322,5,1606,208,1814,9978,2021-01-30 07:27:03
10084,679,3,827,107,934,9979,2021-01-30 14:59:54
10085,767,3,808,105,913,9980,2021-01-30 14:17:27
10086,719,6,1325,172,1497,9981,2021-01-30 21:29:58
10087,639,3,797,103,900,9982,2021-01-30 16:52:43
10088,33,3,697,90,787,9983,2021-01-30 23:03:09
10089,245,2,1098,142,1240,9984,2021-01-30 12:15:04
10090,3,3,827,107,934,9985,2021-01-30 12:08:44
10091,68,3,997,129,1126,9986,2021-01-30 08:15:56
10092,786,3,797,103,900,9987,2021-01-30 13:03:21
10093,386,1,399,51,450,9988,2021-01-30 23:22:20
10094,234,3,428,55,483,9989,2021-01-30 17:52:07
10095,428,3,888,115,1003,9990,2021-01-30 16:21:11
10096,561,3,827,107,934,9991,2021-01-30 07:58:11
10097,50,4,1626,211,1837,9992,2021-01-29 23:29:57
10098,736,2,429,55,484,9993,2021-01-30 12:59:32
10099,558,2,648,84,732,9994,2021-01-31 00:52:08
10100,753,2,598,77,675,9995,2021-01-30 20:33:20
10101,905,5,1795,233,2028,9996,2021-01-30 14:02:14
10102,505,3,478,62,540,9997,2021-01-30 11:16:54
10103,91,2,659,85,744,9998,2021-01-30 22:12:29
10104,255,3,428,55,483,9999,2021-01-30 21:58:27
10105,895,3,927,120,1047,10000,2021-01-31 05:19:56
