,customer_id,quantity,subtotal,tax,total,order_id,created_at
0,82,3,1027,133,1160,1,2021-01-01 02:26:11
1,817,3,1027,133,1160,2,2021-01-01 04:28:46
2,678,6,1874,243,2117,3,2021-01-01 04:52:05
3,449,3,827,107,934,4,2021-01-01 07:29:29
4,418,3,688,89,777,5,2021-01-01 08:16:44
5,963,3,558,72,630,6,2021-01-01 10:11:22
6,918,2,448,58,506,7,2021-01-01 12:37:31
7,241,5,1845,239,2084,8,2021-01-01 12:40:55
8,688,3,847,110,957,9,2021-01-01 12:48:50
9,688,3,847,110,957,9,2021-01-01 12:48:50
10,970,2,498,64,562,10,2021-01-01 14:21:51
11,666,5,1326,172,1498,11,2021-01-01 15:00:11
12,894,5,1355,176,1531,12,2021-01-01 16:54:36
13,546,2,429,55,484,13,2021-01-01 15:52:31
14,248,2,498,64,562,14,2021-01-01 18:17:24
15,629,2,429,55,484,15,2021-01-01 17:55:59
16,321,3,1127,146,1273,16,2021-01-01 19:05:16
17,265,3,808,105,913,17,2021-01-01 19:35:01
18,751,2,498,64,562,18,2021-01-01 20:00:58
19,342,3,1047,136,1183,19,2021-01-01 22:04:33
20,907,5,1456,189,1645,20,2021-01-01 22:12:54
21,548,3,697,90,787,21,2021-01-02 00:41:14
22,389,3,1047,136,1183,22,2021-01-02 00:02:29
23,864,5,1925,250,2175,23,2021-01-02 02:05:49
24,560,3,697,90,787,24,2021-01-02 02:46:40
25,562,3,608,79,687,25,2021-01-02 04:30:06
26,156,2,698,90,788,26,2021-01-02 03:19:41
27,292,1,599,77,676,27,2021-01-02 06:59:39
28,491,2,598,77,675,28,2021-01-02 05:20:26
29,486,2,459,59,518,29,2021-01-02 07:18:56
30,493,3,688,89,777,30,2021-01-02 06:32:21
31,575,3,808,105,913,31,2021-01-02 08:20:44
32,562,6,1424,185,1609,32,2021-01-02 08:36:40
33,160,3,827,107,934,33,2021-01-02 09:41:44
34,201,2,898,116,1014,34,2021-01-02 10:38:17
35,904,2,898,116,1014,35,2021-01-02 10:24:42
36,267,3,1127,146,1273,36,2021-01-02 11:20:37
37,579,3,658,85,743,37,2021-01-02 12:52:17
38,43,3,847,110,957,38,2021-01-02 11:27:37
39,241,4,1227,159,1386,39,2021-01-02 14:11:36
40,812,2,329,42,371,40,2021-01-02 11:57:43
41,632,1,149,19,168,41,2021-01-02 16:40:27
42,64,2,1098,142,1240,42,2021-01-02 13:38:38
43,303,2,898,116,1014,43,2021-01-02 18:14:16
44,523,2,748,97,845,44,2021-01-02 14:14:29
45,523,2,748,97,845,44,2021-01-02 14:14:29
46,895,5,1795,233,2028,45,2021-01-02 18:41:28
47,305,5,1625,211,1836,46,2021-01-02 16:48:22
48,427,2,898,116,1014,47,2021-01-02 14:51:50
49,535,2,498,64,562,48,2021-01-02 20:10:34
50,126,1,499,64,563,49,2021-01-02 17:06:01
51,342,3,727,94,821,50,2021-01-02 17:04:46
52,322,3,747,97,844,51,2021-01-02 21:22:25
53,88,4,1396,181,1577,52,2021-01-02 17:13:32
54,525,3,1047,136,1183,53,2021-01-02 17:24:40
55,415,1,399,51,450,54,2021-01-02 22:49:41
56,445,6,1405,182,1587,55,2021-01-02 18:39:23
57,692,3,1027,133,1160,56,2021-01-02 20:06:04
58,577,3,1247,162,1409,57,2021-01-03 00:17:08
59,931,3,528,68,596,58,2021-01-02 21:07:18
60,859,3,1047,136,1183,59,2021-01-02 20:17:00
61,729,2,429,55,484,60,2021-01-03 01:12:55
62,117,3,528,68,596,61,2021-01-02 21:29:06
63,613,2,798,103,901,62,2021-01-02 22:15:36
64,975,3,558,72,630,63,2021-01-03 02:36:46
65,689,4,1396,181,1577,64,2021-01-02 21:33:36
66,350,3,888,115,1003,65,2021-01-03 00:52:24
67,900,2,748,97,845,66,2021-01-03 03:36:18
68,854,2,429,55,484,67,2021-01-02 23:27:40
69,674,3,1127,146,1273,68,2021-01-03 00:55:07
70,284,5,1225,159,1384,69,2021-01-03 05:22:45
71,804,1,229,29,258,70,2021-01-03 01:56:09
72,372,5,1525,198,1723,71,2021-01-03 03:36:49
73,563,3,1027,133,1160,72,2021-01-03 06:55:49
74,726,5,1436,186,1622,73,2021-01-03 02:39:30
75,936,2,898,116,1014,74,2021-01-03 06:16:04
76,759,3,528,68,596,75,2021-01-03 09:30:34
77,252,3,1247,162,1409,76,2021-01-03 04:48:35
78,218,3,827,107,934,77,2021-01-03 07:11:56
79,225,3,897,116,1013,78,2021-01-03 10:17:28
80,807,1,229,29,258,79,2021-01-03 06:44:09
81,751,5,2025,263,2288,80,2021-01-03 09:24:45
82,860,2,329,42,371,81,2021-01-03 12:14:32
83,678,6,1355,176,1531,82,2021-01-03 09:04:32
84,402,2,429,55,484,83,2021-01-03 09:43:19
85,982,3,608,79,687,84,2021-01-03 13:45:05
86,575,2,498,64,562,85,2021-01-03 10:07:55
87,941,2,459,59,518,86,2021-01-03 11:38:21
88,141,1,499,64,563,87,2021-01-03 13:45:32
89,614,5,1725,224,1949,88,2021-01-03 10:28:51
90,370,3,528,68,596,89,2021-01-03 13:53:23
91,53,2,1098,142,1240,90,2021-01-03 15:50:26
92,710,3,558,72,630,91,2021-01-03 10:30:19
93,633,2,798,103,901,92,2021-01-03 15:25:50
94,673,2,698,90,788,93,2021-01-03 15:51:39
95,469,3,428,55,483,94,2021-01-03 11:58:00
96,47,4,917,119,1036,95,2021-01-03 15:49:01
97,50,3,897,116,1013,96,2021-01-03 17:42:31
98,131,2,659,85,744,97,2021-01-03 14:15:29
99,793,3,597,77,674,98,2021-01-03 16:53:48
100,846,3,947,123,1070,99,2021-01-03 17:46:20
101,240,2,429,55,484,100,2021-01-03 14:19:14
102,202,3,1047,136,1183,101,2021-01-03 17:11:06
103,585,3,1027,133,1160,102,2021-01-03 17:52:15
104,982,3,1047,136,1183,103,2021-01-03 15:49:25
105,930,1,499,64,563,104,2021-01-03 17:52:13
106,90,3,647,84,731,105,2021-01-03 18:09:33
107,269,2,828,107,935,106,2021-01-03 17:42:41
108,23,3,1047,136,1183,107,2021-01-03 19:49:45
109,946,3,727,94,821,108,2021-01-03 20:30:40
110,44,3,428,55,483,109,2021-01-03 20:20:36
111,645,3,747,97,844,110,2021-01-03 21:39:06
112,823,2,798,103,901,111,2021-01-03 21:14:26
113,184,3,1327,172,1499,112,2021-01-03 22:15:53
114,613,2,698,90,788,113,2021-01-03 21:49:55
115,957,3,528,68,596,114,2021-01-03 21:59:35
116,28,2,659,85,744,115,2021-01-03 23:04:09
117,41,3,478,62,540,116,2021-01-03 22:45:18
118,331,2,798,103,901,117,2021-01-03 22:48:11
119,636,2,798,103,901,118,2021-01-04 00:10:20
120,378,3,578,75,653,119,2021-01-04 00:44:24
121,40,1,599,77,676,120,2021-01-03 23:15:17
122,4,3,597,77,674,121,2021-01-04 00:43:15
123,35,1,149,19,168,122,2021-01-04 02:36:48
124,427,3,847,110,957,123,2021-01-04 00:17:07
125,409,1,99,12,111,124,2021-01-04 03:14:05
126,591,2,398,51,449,125,2021-01-04 04:24:37
127,855,2,898,116,1014,126,2021-01-04 01:09:22
128,241,3,1047,136,1183,127,2021-01-04 03:27:20
129,184,3,827,107,934,128,2021-01-04 05:08:27
130,328,3,658,85,743,129,2021-01-04 02:53:25
131,370,3,947,123,1070,130,2021-01-04 03:32:36
132,731,3,528,68,596,131,2021-01-04 06:06:43
133,541,3,558,72,630,132,2021-01-04 04:18:22
134,766,3,1027,133,1160,133,2021-01-04 05:35:14
135,433,2,648,84,732,134,2021-01-04 08:08:06
136,971,2,459,59,518,135,2021-01-04 05:50:54
137,569,4,1507,195,1702,136,2021-01-04 06:45:11
138,639,2,448,58,506,137,2021-01-04 09:27:02
139,853,3,558,72,630,138,2021-01-04 08:29:08
140,255,3,1127,146,1273,139,2021-01-04 07:09:56
141,429,3,1027,133,1160,140,2021-01-04 10:23:37
142,778,3,1047,136,1183,141,2021-01-04 09:19:55
143,61,3,827,107,934,142,2021-01-04 08:13:45
144,23,3,797,103,900,143,2021-01-04 13:05:30
145,836,2,598,77,675,144,2021-01-04 11:33:23
146,280,2,648,84,732,145,2021-01-04 09:09:45
147,490,3,827,107,934,146,2021-01-04 15:49:21
148,7,3,1247,162,1409,147,2021-01-04 11:56:42
149,634,2,429,55,484,148,2021-01-04 10:53:23
150,766,3,647,84,731,149,2021-01-04 17:55:30
151,737,3,808,105,913,150,2021-01-04 14:36:30
152,502,3,608,79,687,151,2021-01-04 13:34:14
153,405,2,798,103,901,152,2021-01-04 18:22:44
154,774,3,927,120,1047,153,2021-01-04 16:31:08
155,801,4,1587,206,1793,154,2021-01-04 13:38:09
156,467,3,847,110,957,155,2021-01-04 18:52:02
157,352,2,598,77,675,156,2021-01-04 19:00:48
158,874,3,947,123,1070,157,2021-01-04 15:27:11
159,806,3,478,62,540,158,2021-01-04 20:43:41
160,20,2,598,77,675,159,2021-01-04 19:41:03
161,223,3,608,79,687,160,2021-01-04 16:05:45
162,202,2,329,42,371,161,2021-01-04 23:13:19
163,126,3,1047,136,1183,162,2021-01-04 21:02:28
164,945,5,1267,164,1431,163,2021-01-04 17:34:37
165,692,3,847,110,957,164,2021-01-05 01:55:56
166,78,3,558,72,630,165,2021-01-04 22:56:51
167,311,2,429,55,484,166,2021-01-04 19:30:54
168,470,3,997,129,1126,167,2021-01-05 03:04:25
169,947,3,758,98,856,168,2021-01-05 00:39:10
170,225,3,1327,172,1499,169,2021-01-04 19:54:37
171,303,3,428,55,483,170,2021-01-05 03:50:21
172,608,3,597,77,674,171,2021-01-05 01:30:04
173,302,3,1047,136,1183,172,2021-01-04 21:47:16
174,663,4,1146,148,1294,173,2021-01-05 06:28:15
175,979,2,598,77,675,174,2021-01-05 03:50:49
176,624,3,997,129,1126,175,2021-01-04 23:33:02
177,928,3,747,97,844,176,2021-01-05 08:20:47
178,0,3,1197,155,1352,177,2021-01-05 04:32:35
179,518,4,1496,194,1690,178,2021-01-05 00:45:41
180,655,3,947,123,1070,179,2021-01-05 08:28:28
181,899,2,498,64,562,180,2021-01-05 04:34:08
182,449,3,697,90,787,181,2021-01-05 01:08:07
183,467,2,1098,142,1240,182,2021-01-05 08:37:31
184,819,2,659,85,744,183,2021-01-05 05:01:01
185,288,5,1226,159,1385,184,2021-01-05 03:14:49
186,69,3,888,115,1003,185,2021-01-05 08:40:07
187,475,5,1845,239,2084,186,2021-01-05 05:21:11
188,553,2,329,42,371,187,2021-01-05 04:30:35
189,327,3,647,84,731,188,2021-01-05 11:21:16
190,297,3,1197,155,1352,189,2021-01-05 07:57:44
191,473,4,877,114,991,190,2021-01-05 06:34:21
192,324,2,329,42,371,191,2021-01-05 13:48:06
193,599,3,758,98,856,192,2021-01-05 09:40:56
194,502,5,1575,204,1779,193,2021-01-05 07:49:26
195,394,3,1247,162,1409,194,2021-01-05 13:54:24
196,770,3,1127,146,1273,195,2021-01-05 11:30:41
197,796,2,698,90,788,196,2021-01-05 08:51:16
198,571,3,578,75,653,197,2021-01-05 14:28:40
199,982,2,598,77,675,198,2021-01-05 13:26:48
200,934,3,758,98,856,199,2021-01-05 09:34:40
201,284,2,828,107,935,200,2021-01-05 15:48:16
202,378,1,99,12,111,201,2021-01-05 15:37:28
203,659,2,598,77,675,202,2021-01-05 10:04:28
204,761,3,808,105,913,203,2021-01-05 16:44:56
205,857,3,947,123,1070,204,2021-01-05 17:56:20
206,389,3,558,72,630,205,2021-01-05 11:06:00
207,789,2,429,55,484,206,2021-01-05 18:03:35
208,798,3,688,89,777,207,2021-01-05 20:38:45
209,985,2,429,55,484,208,2021-01-05 13:37:24
210,551,3,647,84,731,209,2021-01-05 19:59:34
211,156,2,598,77,675,210,2021-01-05 21:48:53
212,354,1,99,12,111,211,2021-01-05 15:43:50
213,487,3,947,123,1070,212,2021-01-05 21:09:02
214,671,2,429,55,484,213,2021-01-05 21:57:05
215,799,5,1895,246,2141,214,2021-01-05 17:52:16
216,878,3,1197,155,1352,215,2021-01-05 21:34:00
217,701,2,598,77,675,216,2021-01-05 23:55:01
218,814,3,827,107,934,217,2021-01-05 19:15:01
219,137,5,1325,172,1497,218,2021-01-05 22:49:25
220,362,4,1826,237,2063,219,2021-01-06 02:40:02
221,838,3,827,107,934,220,2021-01-05 19:54:25
222,378,3,1047,136,1183,221,2021-01-06 01:27:50
223,238,2,898,116,1014,222,2021-01-06 04:45:14
224,84,5,2045,265,2310,223,2021-01-05 21:09:20
225,416,2,659,85,744,224,2021-01-06 01:37:14
226,253,2,698,90,788,225,2021-01-06 07:05:56
227,770,4,677,88,765,226,2021-01-05 22:59:35
228,923,2,798,103,901,227,2021-01-06 02:58:01
229,455,6,1585,206,1791,228,2021-01-06 08:25:59
230,319,2,459,59,518,229,2021-01-05 23:37:08
231,482,3,827,107,934,230,2021-01-06 05:23:38
232,410,3,827,107,934,231,2021-01-06 10:21:37
233,627,3,927,120,1047,232,2021-01-05 23:39:09
234,659,5,1325,172,1497,233,2021-01-06 05:44:02
235,714,3,1027,133,1160,234,2021-01-06 10:35:56
236,191,3,727,94,821,235,2021-01-06 00:30:10
237,316,3,888,115,1003,236,2021-01-06 06:01:29
238,16,3,528,68,596,237,2021-01-06 11:52:27
239,758,5,1026,133,1159,238,2021-01-06 02:05:32
240,216,5,1756,228,1984,239,2021-01-06 06:07:03
241,597,3,578,75,653,240,2021-01-06 13:23:54
242,666,3,758,98,856,241,2021-01-06 02:12:57
243,195,3,608,79,687,242,2021-01-06 07:29:59
244,195,3,608,79,687,242,2021-01-06 07:29:59
245,980,3,1197,155,1352,243,2021-01-06 14:33:33
246,505,3,747,97,844,244,2021-01-06 03:10:48
247,248,3,1327,172,1499,245,2021-01-06 07:45:00
248,265,2,659,85,744,246,2021-01-06 09:12:51
249,103,3,727,94,821,247,2021-01-06 15:58:35
250,726,2,448,58,506,248,2021-01-06 04:59:08
251,13,2,898,116,1014,249,2021-01-06 09:43:22
252,504,3,727,94,821,250,2021-01-06 09:33:45
253,278,2,798,103,901,251,2021-01-06 16:08:46
254,734,2,448,58,506,252,2021-01-06 06:30:02
255,538,3,1047,136,1183,253,2021-01-06 10:39:26
256,94,3,578,75,653,254,2021-01-06 09:37:33
257,455,5,1525,198,1723,255,2021-01-06 16:26:08
258,674,3,528,68,596,256,2021-01-06 06:58:22
259,795,2,848,110,958,257,2021-01-06 11:12:03
260,116,6,1555,202,1757,258,2021-01-06 10:27:51
261,380,2,898,116,1014,259,2021-01-06 18:20:15
262,16,3,947,123,1070,260,2021-01-06 08:05:58
263,413,1,599,77,676,261,2021-01-06 11:46:39
264,545,3,847,110,957,262,2021-01-06 12:31:28
265,822,3,697,90,787,263,2021-01-06 18:33:34
266,157,3,927,120,1047,264,2021-01-06 10:13:04
267,69,2,548,71,619,265,2021-01-06 13:30:33
268,728,2,598,77,675,266,2021-01-06 13:08:06
269,317,3,1127,146,1273,267,2021-01-06 18:47:10
270,713,3,997,129,1126,268,2021-01-06 10:14:17
271,306,3,888,115,1003,269,2021-01-06 15:24:40
272,823,5,1026,133,1159,270,2021-01-06 14:30:57
273,858,2,329,42,371,271,2021-01-06 20:36:22
274,231,3,847,110,957,272,2021-01-06 12:11:59
275,555,3,608,79,687,273,2021-01-06 17:55:25
276,732,3,1197,155,1352,274,2021-01-06 15:23:25
277,218,3,827,107,934,275,2021-01-06 22:48:47
278,600,3,647,84,731,276,2021-01-06 12:43:24
279,960,3,1047,136,1183,277,2021-01-06 20:03:56
280,209,3,597,77,674,278,2021-01-06 17:02:44
281,821,3,897,116,1013,279,2021-01-06 23:00:22
282,808,3,578,75,653,280,2021-01-06 14:58:56
283,993,3,808,105,913,281,2021-01-06 21:10:04
284,989,2,598,77,675,282,2021-01-06 18:15:17
285,892,3,797,103,900,283,2021-01-07 00:56:28
286,530,2,798,103,901,284,2021-01-06 15:51:37
287,205,5,2045,265,2310,285,2021-01-06 22:12:20
288,398,2,698,90,788,286,2021-01-06 20:53:09
289,227,3,927,120,1047,287,2021-01-07 03:18:35
290,635,3,558,72,630,288,2021-01-06 16:41:33
291,948,3,1047,136,1183,289,2021-01-07 00:16:00
292,42,3,658,85,743,290,2021-01-06 21:32:01
293,876,1,149,19,168,291,2021-01-07 05:40:33
294,518,2,498,64,562,292,2021-01-06 17:06:34
295,282,3,797,103,900,293,2021-01-07 01:20:15
296,447,3,558,72,630,294,2021-01-06 23:42:56
297,877,3,558,72,630,295,2021-01-07 07:37:30
298,142,2,1098,142,1240,296,2021-01-06 19:35:00
299,179,2,598,77,675,297,2021-01-07 03:40:02
300,8,3,558,72,630,298,2021-01-07 01:08:44
301,236,3,847,110,957,299,2021-01-07 09:53:25
302,542,1,229,29,258,300,2021-01-06 20:30:19
303,542,1,229,29,258,300,2021-01-06 20:30:19
304,182,3,947,123,1070,301,2021-01-07 06:22:08
305,144,3,697,90,787,302,2021-01-07 02:58:34
306,947,5,1456,189,1645,303,2021-01-07 10:58:37
307,198,4,1396,181,1577,304,2021-01-06 22:53:42
308,977,3,647,84,731,305,2021-01-06 20:54:27
309,678,2,898,116,1014,306,2021-01-07 08:40:53
310,830,3,1127,146,1273,307,2021-01-07 04:03:17
311,979,2,698,90,788,308,2021-01-07 12:07:38
312,449,3,827,107,934,309,2021-01-07 00:50:16
313,205,3,827,107,934,310,2021-01-06 21:44:55
314,270,3,997,129,1126,311,2021-01-07 09:25:55
315,110,3,727,94,821,312,2021-01-07 05:17:33
316,456,3,947,123,1070,313,2021-01-07 13:30:26
317,953,3,1247,162,1409,314,2021-01-07 03:34:57
318,766,3,697,90,787,315,2021-01-06 21:52:09
319,253,3,1127,146,1273,316,2021-01-07 11:07:08
320,453,3,827,107,934,317,2021-01-07 06:50:04
321,664,1,149,19,168,318,2021-01-07 14:31:35
322,664,1,149,19,168,318,2021-01-07 14:31:35
323,532,3,558,72,630,319,2021-01-07 05:27:49
324,667,2,698,90,788,320,2021-01-06 23:35:05
325,316,1,599,77,676,321,2021-01-07 11:19:27
326,382,3,747,97,844,322,2021-01-07 08:06:47
327,95,2,498,64,562,323,2021-01-07 17:08:39
328,88,3,947,123,1070,324,2021-01-07 14:45:14
329,112,2,548,71,619,325,2021-01-07 05:37:50
330,500,2,459,59,518,326,2021-01-07 01:58:33
331,273,3,1327,172,1499,327,2021-01-07 13:02:03
332,391,2,429,55,484,328,2021-01-07 08:16:52
333,759,3,747,97,844,329,2021-01-07 18:31:13
334,680,5,1625,211,1836,330,2021-01-07 15:07:32
335,288,2,548,71,619,331,2021-01-07 07:20:02
336,972,3,997,129,1126,332,2021-01-07 03:27:34
337,50,2,659,85,744,333,2021-01-07 13:15:12
338,735,2,898,116,1014,334,2021-01-07 09:25:47
339,889,2,548,71,619,335,2021-01-07 20:00:19
340,29,2,698,90,788,336,2021-01-07 16:07:15
341,457,3,1027,133,1160,337,2021-01-07 09:07:23
342,457,3,1027,133,1160,337,2021-01-07 09:07:23
343,379,3,847,110,957,338,2021-01-07 04:33:34
344,39,3,697,90,787,339,2021-01-07 15:31:10
345,965,1,149,19,168,340,2021-01-07 12:04:41
346,939,3,1047,136,1183,341,2021-01-07 20:52:08
347,939,3,1047,136,1183,341,2021-01-07 20:52:08
348,463,2,459,59,518,342,2021-01-07 16:35:58
349,504,2,329,42,371,343,2021-01-07 10:49:50
350,62,1,149,19,168,344,2021-01-07 10:55:37
351,137,6,1444,187,1631,345,2021-01-07 06:09:39
352,965,5,1295,168,1463,346,2021-01-07 15:59:20
353,429,5,1475,191,1666,347,2021-01-07 12:39:33
354,319,2,429,55,484,348,2021-01-07 21:42:45
355,346,2,898,116,1014,349,2021-01-07 20:57:35
356,821,2,898,116,1014,350,2021-01-07 17:05:23
357,819,5,1395,181,1576,351,2021-01-07 11:42:50
358,313,3,558,72,630,352,2021-01-07 12:47:08
359,254,2,429,55,484,353,2021-01-07 06:58:26
360,437,1,229,29,258,354,2021-01-07 16:23:44
361,61,3,897,116,1013,355,2021-01-07 13:22:56
362,530,3,797,103,900,356,2021-01-07 22:04:28
363,794,3,1327,172,1499,357,2021-01-07 21:19:29
364,458,3,758,98,856,358,2021-01-07 17:59:52
365,76,3,578,75,653,359,2021-01-07 14:01:07
366,288,2,598,77,675,360,2021-01-07 13:19:59
367,92,3,558,72,630,361,2021-01-07 09:38:51
368,340,3,608,79,687,362,2021-01-07 16:45:37
369,686,2,1098,142,1240,363,2021-01-07 15:05:35
370,123,4,1196,155,1351,364,2021-01-08 00:04:51
371,333,5,1326,172,1498,365,2021-01-07 21:35:06
372,178,2,1098,142,1240,366,2021-01-07 18:17:27
373,341,3,1047,136,1183,367,2021-01-07 16:26:27
374,346,3,927,120,1047,368,2021-01-07 13:51:16
375,374,4,957,124,1081,369,2021-01-07 12:07:34
376,374,4,957,124,1081,369,2021-01-07 12:07:34
377,303,2,798,103,901,370,2021-01-07 17:09:44
378,368,3,528,68,596,371,2021-01-07 16:44:23
379,106,3,827,107,934,372,2021-01-08 00:14:06
380,478,2,798,103,901,373,2021-01-07 23:06:30
381,79,3,697,90,787,374,2021-01-07 18:41:22
382,278,2,628,81,709,375,2021-01-07 19:11:30
383,691,3,897,116,1013,376,2021-01-07 16:25:19
384,312,3,1047,136,1183,377,2021-01-07 12:10:39
385,560,3,578,75,653,378,2021-01-07 13:43:54
386,818,3,808,105,913,379,2021-01-07 17:36:29
387,678,6,1724,224,1948,380,2021-01-07 17:15:43
388,882,6,2244,291,2535,381,2021-01-08 00:34:20
389,441,2,798,103,901,382,2021-01-08 01:49:39
390,488,3,997,129,1126,383,2021-01-07 21:03:27
391,243,3,947,123,1070,384,2021-01-07 21:17:24
392,515,2,898,116,1014,385,2021-01-07 17:07:56
393,449,3,1047,136,1183,386,2021-01-07 12:34:23
394,241,2,429,55,484,387,2021-01-07 14:55:58
395,528,3,647,84,731,388,2021-01-07 17:50:59
396,136,3,997,129,1126,389,2021-01-07 18:54:56
397,19,3,1127,146,1273,390,2021-01-08 01:25:42
398,479,3,1247,162,1409,391,2021-01-08 03:43:52
399,327,3,947,123,1070,392,2021-01-07 22:37:26
400,786,3,758,98,856,393,2021-01-07 22:07:45
401,816,3,428,55,483,394,2021-01-07 18:15:50
402,816,3,428,55,483,394,2021-01-07 18:15:50
403,709,5,1456,189,1645,395,2021-01-07 14:15:37
404,401,3,558,72,630,396,2021-01-07 16:30:39
405,313,3,658,85,743,397,2021-01-07 18:53:37
406,512,3,888,115,1003,398,2021-01-07 20:40:42
407,63,3,647,84,731,399,2021-01-08 02:41:17
408,330,3,528,68,596,400,2021-01-08 06:18:07
409,801,2,498,64,562,401,2021-01-08 00:54:43
410,627,3,847,110,957,402,2021-01-08 00:42:36
411,137,5,1395,181,1576,403,2021-01-07 20:29:18
412,650,2,598,77,675,404,2021-01-07 18:46:59
413,740,3,1097,142,1239,405,2021-01-07 16:45:49
414,733,3,997,129,1126,406,2021-01-07 19:00:49
415,703,2,459,59,518,407,2021-01-07 19:11:30
416,37,3,1247,162,1409,408,2021-01-07 21:48:28
417,971,3,1047,136,1183,409,2021-01-08 05:01:47
418,914,3,528,68,596,410,2021-01-08 08:14:03
419,783,3,1027,133,1160,411,2021-01-08 03:11:23
420,909,2,459,59,518,412,2021-01-08 01:09:11
421,619,2,448,58,506,413,2021-01-07 21:42:40
422,787,2,429,55,484,414,2021-01-07 19:36:41
423,392,3,1047,136,1183,415,2021-01-07 17:08:44
424,870,3,1127,146,1273,416,2021-01-07 19:30:16
425,818,3,927,120,1047,417,2021-01-07 21:08:22
426,68,2,598,77,675,418,2021-01-07 23:56:16
427,528,2,498,64,562,419,2021-01-08 06:41:23
428,528,2,498,64,562,419,2021-01-08 06:41:23
429,24,5,1386,180,1566,420,2021-01-08 10:33:45
430,783,2,698,90,788,421,2021-01-08 04:17:29
431,370,5,1586,206,1792,422,2021-01-08 01:42:07
432,477,3,827,107,934,423,2021-01-07 21:50:38
433,3,1,149,19,168,424,2021-01-07 20:11:56
434,501,3,827,107,934,425,2021-01-07 19:11:57
435,980,5,1225,159,1384,426,2021-01-07 21:44:17
436,284,2,598,77,675,427,2021-01-07 22:16:14
437,686,3,847,110,957,428,2021-01-08 00:53:40
438,590,3,478,62,540,429,2021-01-08 07:29:29
439,127,4,1257,163,1420,430,2021-01-08 07:41:36
440,401,3,1047,136,1183,431,2021-01-08 11:05:26
441,879,2,598,77,675,432,2021-01-08 06:47:49
442,244,3,697,90,787,433,2021-01-08 01:42:14
443,144,3,528,68,596,434,2021-01-07 23:27:07
444,359,3,997,129,1126,435,2021-01-07 22:41:14
445,95,5,1676,217,1893,436,2021-01-07 20:22:26
446,549,3,578,75,653,437,2021-01-07 23:47:18
447,539,3,827,107,934,438,2021-01-07 22:59:36
448,173,3,1047,136,1183,439,2021-01-08 02:35:12
449,101,3,1047,136,1183,440,2021-01-08 09:36:04
450,857,2,1098,142,1240,441,2021-01-08 07:55:29
451,612,5,1945,252,2197,442,2021-01-08 12:12:15
452,31,2,498,64,562,443,2021-01-08 07:03:58
453,909,3,578,75,653,444,2021-01-08 04:06:23
454,241,3,827,107,934,445,2021-01-08 01:43:53
455,942,3,747,97,844,446,2021-01-08 00:09:01
456,890,3,747,97,844,447,2021-01-07 22:24:10
457,163,5,1145,148,1293,448,2021-01-08 01:50:11
458,334,3,997,129,1126,449,2021-01-07 23:39:45
459,247,3,897,116,1013,450,2021-01-08 02:47:04
460,65,5,1486,193,1679,451,2021-01-08 11:35:37
461,353,3,597,77,674,452,2021-01-08 08:56:30
462,851,3,1127,146,1273,453,2021-01-08 12:47:14
463,595,5,2425,315,2740,454,2021-01-08 08:44:54
464,960,2,898,116,1014,455,2021-01-08 04:13:35
465,904,3,1127,146,1273,456,2021-01-08 03:59:13
466,84,3,1247,162,1409,457,2021-01-08 01:35:36
467,84,3,1247,162,1409,457,2021-01-08 01:35:36
468,41,3,428,55,483,458,2021-01-08 00:11:42
469,327,3,597,77,674,459,2021-01-08 02:22:35
470,842,3,578,75,653,460,2021-01-08 00:42:18
471,478,2,628,81,709,461,2021-01-08 03:09:41
472,910,2,498,64,562,462,2021-01-08 13:08:32
473,729,1,499,64,563,463,2021-01-08 09:24:47
474,194,3,1127,146,1273,464,2021-01-08 14:28:18
475,739,3,428,55,483,465,2021-01-08 08:59:50
476,72,1,599,77,676,466,2021-01-08 06:46:52
477,881,2,848,110,958,467,2021-01-08 06:44:29
478,647,3,808,105,913,468,2021-01-08 01:38:58
479,94,3,658,85,743,469,2021-01-08 04:01:21
480,903,2,598,77,675,470,2021-01-08 00:19:31
481,878,3,647,84,731,471,2021-01-08 02:52:16
482,219,1,99,12,111,472,2021-01-08 02:40:20
483,245,3,797,103,900,473,2021-01-08 03:12:44
484,749,6,1624,211,1835,474,2021-01-08 13:42:20
485,979,2,498,64,562,475,2021-01-08 11:36:52
486,210,3,808,105,913,476,2021-01-08 16:39:29
487,232,3,927,120,1047,477,2021-01-08 10:07:23
488,379,3,478,62,540,478,2021-01-08 07:43:41
489,588,2,698,90,788,479,2021-01-08 07:32:53
490,858,2,898,116,1014,480,2021-01-08 04:17:56
491,759,3,578,75,653,481,2021-01-08 06:29:14
492,910,3,997,129,1126,482,2021-01-08 02:48:50
493,461,3,808,105,913,483,2021-01-08 04:31:25
494,290,2,898,116,1014,484,2021-01-08 03:00:47
495,134,2,898,116,1014,485,2021-01-08 04:05:31
496,884,3,847,110,957,486,2021-01-08 14:17:31
497,837,2,598,77,675,487,2021-01-08 12:29:38
498,265,2,329,42,371,488,2021-01-08 18:44:23
499,910,2,798,103,901,489,2021-01-08 10:23:59
500,842,2,798,103,901,490,2021-01-08 09:40:47
501,957,5,2175,282,2457,491,2021-01-08 10:16:10
502,314,3,747,97,844,492,2021-01-08 05:12:15
503,154,1,599,77,676,493,2021-01-08 09:07:01
504,311,3,597,77,674,494,2021-01-08 03:49:15
505,37,3,697,90,787,495,2021-01-08 05:54:20
506,627,2,459,59,518,496,2021-01-08 03:04:03
507,51,3,697,90,787,497,2021-01-08 04:56:30
508,783,2,698,90,788,498,2021-01-08 14:27:20
509,743,3,1047,136,1183,499,2021-01-08 13:28:24
510,961,6,1305,169,1474,500,2021-01-08 20:42:47
511,285,3,688,89,777,501,2021-01-08 11:01:11
512,160,3,758,98,856,502,2021-01-08 10:13:34
513,809,2,598,77,675,503,2021-01-08 11:21:49
514,999,5,2025,263,2288,504,2021-01-08 05:40:45
515,352,2,1098,142,1240,505,2021-01-08 10:23:44
516,846,5,1126,146,1272,506,2021-01-08 05:53:04
517,745,3,647,84,731,507,2021-01-08 06:37:40
518,798,3,888,115,1003,508,2021-01-08 03:07:51
519,219,3,428,55,483,509,2021-01-08 06:50:01
520,671,2,1098,142,1240,510,2021-01-08 14:47:04
521,568,3,428,55,483,511,2021-01-08 15:08:59
522,568,3,428,55,483,511,2021-01-08 15:08:59
523,359,3,847,110,957,512,2021-01-08 22:40:34
524,950,3,997,129,1126,513,2021-01-08 13:27:23
525,105,3,558,72,630,514,2021-01-08 12:58:12
526,830,2,329,42,371,515,2021-01-08 11:55:19
527,487,3,827,107,934,516,2021-01-08 07:59:19
528,915,2,598,77,675,517,2021-01-08 12:40:42
529,302,3,697,90,787,518,2021-01-08 07:22:46
530,781,3,697,90,787,519,2021-01-08 06:56:36
531,997,2,659,85,744,520,2021-01-08 05:04:58
532,144,3,897,116,1013,521,2021-01-08 09:00:17
533,135,3,608,79,687,522,2021-01-08 14:49:46
534,587,1,499,64,563,523,2021-01-08 16:57:13
535,773,3,847,110,957,524,2021-01-08 15:34:44
536,968,3,528,68,596,525,2021-01-08 23:31:20
537,265,2,698,90,788,526,2021-01-08 15:40:10
538,704,5,1087,141,1228,527,2021-01-08 13:58:47
539,682,3,997,129,1126,528,2021-01-08 14:05:47
540,650,3,1127,146,1273,529,2021-01-08 08:29:43
541,447,5,1695,220,1915,530,2021-01-08 14:44:54
542,343,3,997,129,1126,531,2021-01-08 10:00:27
543,183,2,459,59,518,532,2021-01-08 09:03:12
544,676,3,658,85,743,533,2021-01-08 07:50:17
545,284,2,698,90,788,534,2021-01-08 10:53:28
546,66,1,399,51,450,535,2021-01-08 16:54:34
547,184,2,329,42,371,536,2021-01-08 19:34:26
548,983,3,808,105,913,537,2021-01-08 17:23:47
549,814,6,1944,252,2196,538,2021-01-09 01:30:13
550,194,3,688,89,777,539,2021-01-08 18:00:01
551,34,3,478,62,540,540,2021-01-08 16:04:14
552,764,2,598,77,675,541,2021-01-08 16:31:44
553,803,2,459,59,518,542,2021-01-08 10:20:06
554,199,3,808,105,913,543,2021-01-08 16:02:21
555,614,2,898,116,1014,544,2021-01-08 10:03:08
556,971,3,597,77,674,545,2021-01-08 09:50:56
557,36,3,688,89,777,546,2021-01-08 09:18:48
558,403,3,1197,155,1352,547,2021-01-08 12:03:32
559,157,5,1226,159,1385,548,2021-01-08 17:23:39
560,926,3,428,55,483,549,2021-01-08 19:42:17
561,800,3,1047,136,1183,550,2021-01-08 19:36:25
562,771,3,997,129,1126,551,2021-01-09 01:42:47
563,281,4,996,129,1125,552,2021-01-08 20:15:08
564,846,3,1047,136,1183,553,2021-01-08 17:31:01
565,150,2,598,77,675,554,2021-01-08 17:32:24
566,750,3,658,85,743,555,2021-01-08 11:13:11
567,375,3,1127,146,1273,556,2021-01-08 16:31:39
568,885,3,428,55,483,557,2021-01-08 10:12:44
569,656,2,628,81,709,558,2021-01-08 12:35:42
570,845,5,1725,224,1949,559,2021-01-08 10:08:52
571,910,5,1795,233,2028,560,2021-01-08 12:27:13
572,934,4,1426,185,1611,561,2021-01-08 18:35:22
573,2,3,1127,146,1273,562,2021-01-08 22:14:28
574,106,2,698,90,788,563,2021-01-08 19:54:26
575,98,2,329,42,371,564,2021-01-09 04:18:31
576,970,2,659,85,744,565,2021-01-08 20:28:08
577,318,3,997,129,1126,566,2021-01-08 19:47:41
578,917,4,1396,181,1577,567,2021-01-08 17:43:23
579,55,3,997,129,1126,568,2021-01-08 11:20:42
580,354,5,1456,189,1645,569,2021-01-08 18:17:30
581,621,3,827,107,934,570,2021-01-08 12:55:16
582,882,6,2024,263,2287,571,2021-01-08 14:52:58
583,763,3,747,97,844,572,2021-01-08 12:49:08
584,577,3,597,77,674,573,2021-01-08 12:39:21
585,819,3,597,77,674,574,2021-01-08 19:45:46
586,702,5,1017,132,1149,575,2021-01-08 22:55:15
587,55,3,597,77,674,576,2021-01-08 21:12:18
588,146,3,688,89,777,577,2021-01-09 06:18:14
589,762,5,1706,221,1927,578,2021-01-08 21:55:19
590,702,3,1247,162,1409,579,2021-01-08 19:56:42
591,164,2,498,64,562,580,2021-01-08 19:23:16
592,448,3,578,75,653,581,2021-01-08 12:09:18
593,733,3,797,103,900,582,2021-01-08 20:54:01
594,973,2,598,77,675,583,2021-01-08 13:03:01
595,174,3,1047,136,1183,584,2021-01-08 15:46:46
596,80,3,797,103,900,585,2021-01-08 14:07:51
597,345,3,1047,136,1183,586,2021-01-08 15:07:55
598,480,3,478,62,540,587,2021-01-08 20:15:28
599,480,3,478,62,540,587,2021-01-08 20:15:28
600,819,4,957,124,1081,588,2021-01-08 23:04:04
601,499,3,697,90,787,589,2021-01-08 22:04:54
602,230,3,428,55,483,590,2021-01-09 06:46:54
603,467,4,1446,187,1633,591,2021-01-09 00:29:21
604,75,3,697,90,787,592,2021-01-08 21:21:03
605,520,3,827,107,934,593,2021-01-08 20:59:08
606,135,1,599,77,676,594,2021-01-08 13:19:15
607,879,2,598,77,675,595,2021-01-08 22:01:50
608,930,3,827,107,934,596,2021-01-08 14:22:55
609,652,3,1127,146,1273,597,2021-01-08 18:15:48
610,451,3,747,97,844,598,2021-01-08 14:14:25
611,166,3,578,75,653,599,2021-01-08 15:21:18
612,99,5,1186,154,1340,600,2021-01-08 21:35:46
613,221,2,898,116,1014,601,2021-01-08 20:18:18
614,254,3,658,85,743,602,2021-01-09 01:48:25
615,575,3,1047,136,1183,603,2021-01-08 22:40:47
616,13,5,1267,164,1431,604,2021-01-09 08:41:13
617,49,4,1207,156,1363,605,2021-01-09 02:18:45
618,520,6,1874,243,2117,606,2021-01-08 22:44:32
619,636,3,578,75,653,607,2021-01-08 23:30:29
620,546,2,329,42,371,608,2021-01-08 13:22:34
621,809,2,329,42,371,609,2021-01-08 23:34:09
622,787,3,758,98,856,610,2021-01-08 16:10:28
623,890,1,99,12,111,611,2021-01-08 18:28:19
624,622,2,598,77,675,612,2021-01-08 16:36:15
625,997,2,498,64,562,613,2021-01-08 15:28:16
626,964,5,937,121,1058,614,2021-01-08 23:51:52
627,713,3,727,94,821,615,2021-01-08 21:34:26
628,68,3,1197,155,1352,616,2021-01-09 04:31:57
629,308,3,478,62,540,617,2021-01-09 00:15:50
630,39,3,847,110,957,618,2021-01-09 10:52:52
631,82,3,927,120,1047,619,2021-01-09 03:39:05
632,813,4,1357,176,1533,620,2021-01-09 00:11:32
633,547,2,848,110,958,621,2021-01-09 00:29:26
634,425,5,1456,189,1645,622,2021-01-08 14:15:02
635,58,1,299,38,337,623,2021-01-09 01:05:32
636,139,3,727,94,821,624,2021-01-08 16:37:14
637,640,3,1127,146,1273,625,2021-01-08 21:14:41
638,566,2,898,116,1014,626,2021-01-08 18:03:14
639,875,2,659,85,744,627,2021-01-08 15:36:58
640,870,3,747,97,844,628,2021-01-09 01:08:03
641,120,6,1705,221,1926,629,2021-01-08 23:22:31
642,621,2,598,77,675,630,2021-01-09 05:25:51
643,743,1,499,64,563,631,2021-01-09 01:18:01
644,922,2,329,42,371,632,2021-01-09 12:49:53
645,103,3,1327,172,1499,633,2021-01-09 04:17:59
646,829,2,848,110,958,634,2021-01-09 02:15:13
647,829,2,848,110,958,634,2021-01-09 02:15:13
648,972,2,459,59,518,635,2021-01-09 02:11:41
649,784,3,558,72,630,636,2021-01-08 16:20:50
650,911,3,808,105,913,637,2021-01-09 02:23:37
651,911,3,808,105,913,637,2021-01-09 02:23:37
652,442,3,947,123,1070,638,2021-01-08 18:28:08
653,683,3,428,55,483,639,2021-01-08 22:58:08
654,286,3,428,55,483,640,2021-01-08 18:23:53
655,224,3,997,129,1126,641,2021-01-08 18:20:40
656,769,5,1675,217,1892,642,2021-01-09 02:49:55
657,456,2,898,116,1014,643,2021-01-09 00:11:07
658,877,2,898,116,1014,644,2021-01-09 07:21:51
659,845,5,1356,176,1532,645,2021-01-09 01:50:23
660,434,3,827,107,934,646,2021-01-09 15:15:52
661,817,3,697,90,787,647,2021-01-09 05:15:40
662,817,3,697,90,787,647,2021-01-09 05:15:40
663,6,2,1098,142,1240,648,2021-01-09 02:29:47
664,841,3,927,120,1047,649,2021-01-09 02:15:54
665,190,2,598,77,675,650,2021-01-09 04:07:08
666,578,2,598,77,675,651,2021-01-08 16:49:45
667,601,5,1656,215,1871,652,2021-01-09 02:44:12
668,831,2,728,94,822,653,2021-01-09 05:04:05
669,298,2,598,77,675,654,2021-01-08 19:59:17
670,250,3,1047,136,1183,655,2021-01-09 01:09:24
671,32,1,399,51,450,656,2021-01-08 20:23:11
672,881,3,558,72,630,657,2021-01-08 19:53:11
673,724,3,897,116,1013,658,2021-01-09 03:04:38
674,669,4,1526,198,1724,659,2021-01-09 01:23:09
675,552,3,478,62,540,660,2021-01-09 09:20:14
676,849,2,598,77,675,661,2021-01-09 03:02:21
677,511,6,2274,295,2569,662,2021-01-09 15:50:59
678,112,3,1197,155,1352,663,2021-01-09 06:30:13
679,796,6,1405,182,1587,664,2021-01-09 05:26:41
680,880,3,727,94,821,665,2021-01-09 05:02:01
681,663,3,647,84,731,666,2021-01-09 04:09:29
682,196,3,797,103,900,667,2021-01-09 04:27:19
683,96,3,827,107,934,668,2021-01-08 19:30:05
684,848,3,697,90,787,669,2021-01-09 04:24:33
685,434,3,647,84,731,670,2021-01-09 07:03:15
686,176,4,957,124,1081,671,2021-01-08 21:48:52
687,542,2,698,90,788,672,2021-01-09 02:13:23
688,658,3,947,123,1070,673,2021-01-08 22:55:49
689,642,5,1626,211,1837,674,2021-01-08 21:58:43
690,44,3,1047,136,1183,675,2021-01-09 03:36:21
691,317,3,1247,162,1409,676,2021-01-09 02:42:15
692,369,3,747,97,844,677,2021-01-09 10:10:16
693,688,1,99,12,111,678,2021-01-09 04:15:27
694,240,3,947,123,1070,679,2021-01-09 18:09:56
695,751,1,229,29,258,680,2021-01-09 08:10:19
696,658,4,946,122,1068,681,2021-01-09 07:24:20
697,936,4,1446,187,1633,682,2021-01-09 07:48:04
698,477,3,558,72,630,683,2021-01-09 05:15:34
699,76,3,688,89,777,684,2021-01-09 06:57:42
700,585,3,758,98,856,685,2021-01-08 21:22:41
701,213,2,659,85,744,686,2021-01-09 06:32:51
702,739,2,329,42,371,687,2021-01-09 08:16:11
703,956,5,1076,139,1215,688,2021-01-08 23:16:03
704,773,6,1725,224,1949,689,2021-01-09 02:17:26
705,37,2,598,77,675,690,2021-01-08 23:41:34
706,803,3,1327,172,1499,691,2021-01-09 00:22:46
707,613,3,478,62,540,692,2021-01-09 04:20:37
708,232,2,659,85,744,693,2021-01-09 03:08:39
709,137,3,997,129,1126,694,2021-01-09 12:17:47
710,419,2,798,103,901,695,2021-01-09 06:04:35
711,404,2,798,103,901,696,2021-01-09 20:16:37
712,832,3,747,97,844,697,2021-01-09 09:42:44
713,320,2,1098,142,1240,698,2021-01-09 08:40:01
714,247,3,897,116,1013,699,2021-01-09 09:21:17
715,121,2,429,55,484,700,2021-01-09 07:31:47
716,228,1,399,51,450,701,2021-01-09 07:11:01
717,357,3,827,107,934,702,2021-01-08 23:48:15
718,782,3,888,115,1003,703,2021-01-09 08:13:40
719,197,3,897,116,1013,704,2021-01-09 10:21:57
720,521,6,1694,220,1914,705,2021-01-08 23:51:09
721,705,3,758,98,856,706,2021-01-09 03:50:44
722,618,3,1047,136,1183,707,2021-01-09 00:03:26
723,92,6,1705,221,1926,708,2021-01-09 02:04:46
724,924,3,997,129,1126,709,2021-01-09 06:22:46
725,406,3,808,105,913,710,2021-01-09 04:07:41
726,114,3,827,107,934,711,2021-01-09 13:03:27
727,796,2,698,90,788,712,2021-01-09 06:43:44
728,536,2,329,42,371,713,2021-01-09 22:59:50
729,16,3,697,90,787,714,2021-01-09 11:08:58
730,172,3,608,79,687,715,2021-01-09 08:42:08
731,594,4,1557,202,1759,716,2021-01-09 09:36:07
732,401,5,1495,194,1689,717,2021-01-09 08:40:53
733,450,1,99,12,111,718,2021-01-09 09:01:56
734,958,4,1096,142,1238,719,2021-01-09 00:30:56
735,515,3,528,68,596,720,2021-01-09 10:46:09
736,927,3,997,129,1126,721,2021-01-09 12:05:29
737,757,2,598,77,675,722,2021-01-08 23:54:40
738,660,5,857,111,968,723,2021-01-09 06:14:46
739,187,3,1127,146,1273,724,2021-01-09 01:03:56
740,418,5,1326,172,1498,725,2021-01-09 04:49:46
741,545,3,897,116,1013,726,2021-01-09 07:47:48
742,614,3,1127,146,1273,727,2021-01-09 04:46:11
743,457,2,429,55,484,728,2021-01-09 14:50:26
744,549,2,1098,142,1240,729,2021-01-09 09:16:24
745,175,3,428,55,483,730,2021-01-10 00:39:36
746,989,2,498,64,562,731,2021-01-09 12:20:20
747,946,3,758,98,856,732,2021-01-09 11:01:43
748,514,3,1247,162,1409,733,2021-01-09 11:30:41
749,829,4,1096,142,1238,734,2021-01-09 11:04:07
750,771,2,528,68,596,735,2021-01-09 10:12:35
751,328,3,528,68,596,736,2021-01-09 01:29:12
752,453,3,1247,162,1409,737,2021-01-09 12:38:29
753,898,2,698,90,788,738,2021-01-09 14:44:45
754,86,3,1247,162,1409,739,2021-01-09 02:21:39
755,438,2,329,42,371,740,2021-01-09 07:47:38
756,260,2,329,42,371,741,2021-01-09 03:10:40
757,44,5,1656,215,1871,742,2021-01-09 06:25:39
758,664,2,598,77,675,743,2021-01-09 07:53:52
759,455,3,1247,162,1409,744,2021-01-09 07:16:40
760,392,3,727,94,821,745,2021-01-09 16:23:26
761,850,1,149,19,168,746,2021-01-09 11:05:20
762,434,2,798,103,901,747,2021-01-10 03:03:01
763,261,2,798,103,901,748,2021-01-09 12:26:56
764,580,2,898,116,1014,749,2021-01-09 12:54:38
765,75,5,1276,165,1441,750,2021-01-09 12:28:55
766,774,6,1255,163,1418,751,2021-01-09 13:47:24
767,72,5,1955,254,2209,752,2021-01-09 12:48:11
768,170,2,429,55,484,753,2021-01-09 02:05:37
769,475,2,898,116,1014,754,2021-01-09 13:10:25
770,419,2,748,97,845,755,2021-01-09 14:52:21
771,230,5,887,115,1002,756,2021-01-09 03:17:24
772,261,3,1327,172,1499,757,2021-01-09 08:48:52
773,571,2,648,84,732,758,2021-01-09 04:09:28
774,456,3,1247,162,1409,759,2021-01-09 08:24:03
775,903,3,897,116,1013,760,2021-01-09 10:33:48
776,505,3,827,107,934,761,2021-01-09 07:52:27
777,405,3,747,97,844,762,2021-01-09 17:07:53
778,226,1,599,77,676,763,2021-01-09 11:23:20
779,163,3,578,75,653,764,2021-01-10 03:25:17
780,35,3,847,110,957,765,2021-01-09 14:57:06
781,353,3,1027,133,1160,766,2021-01-09 14:29:05
782,743,2,598,77,675,767,2021-01-09 13:51:15
783,543,3,897,116,1013,768,2021-01-09 14:37:13
784,655,3,1127,146,1273,769,2021-01-09 14:39:16
785,544,3,747,97,844,770,2021-01-09 02:52:07
786,84,3,997,129,1126,771,2021-01-09 13:52:32
787,74,3,727,94,821,772,2021-01-09 17:01:41
788,742,2,898,116,1014,773,2021-01-09 04:07:01
789,311,3,827,107,934,774,2021-01-09 10:27:31
790,188,2,598,77,675,775,2021-01-09 05:23:41
791,578,2,459,59,518,776,2021-01-09 08:43:45
792,29,3,1327,172,1499,777,2021-01-09 11:11:20
793,910,2,498,64,562,778,2021-01-09 09:03:27
794,980,3,697,90,787,779,2021-01-09 18:51:39
795,633,3,578,75,653,780,2021-01-09 12:56:40
796,267,2,698,90,788,781,2021-01-10 06:03:19
797,48,2,598,77,675,782,2021-01-09 17:13:59
798,62,6,1724,224,1948,783,2021-01-09 15:16:30
799,62,6,1724,224,1948,783,2021-01-09 15:16:30
800,178,3,808,105,913,784,2021-01-09 16:30:44
801,231,2,698,90,788,785,2021-01-09 17:01:30
802,50,3,578,75,653,786,2021-01-09 16:12:52
803,720,3,947,123,1070,787,2021-01-09 03:47:50
804,264,4,896,116,1012,788,2021-01-09 15:56:54
805,959,4,1296,168,1464,789,2021-01-09 17:13:28
806,850,5,1406,182,1588,790,2021-01-09 06:44:04
807,845,3,478,62,540,791,2021-01-09 12:49:37
808,845,3,478,62,540,791,2021-01-09 12:49:37
809,77,3,578,75,653,792,2021-01-09 06:24:22
810,496,3,808,105,913,793,2021-01-09 10:35:15
811,790,3,808,105,913,794,2021-01-09 13:51:24
812,790,3,808,105,913,794,2021-01-09 13:51:24
813,769,2,498,64,562,795,2021-01-09 09:32:06
814,271,2,598,77,675,796,2021-01-09 21:25:51
815,421,3,747,97,844,797,2021-01-09 14:26:17
816,811,3,658,85,743,798,2021-01-10 07:53:56
817,950,3,1247,162,1409,799,2021-01-09 18:41:35
818,835,3,758,98,856,800,2021-01-09 17:52:42
819,325,3,827,107,934,801,2021-01-09 17:34:50
820,717,2,628,81,709,802,2021-01-09 18:05:35
821,381,5,1076,139,1215,803,2021-01-09 18:44:39
822,747,2,698,90,788,804,2021-01-09 18:22:29
823,650,3,1127,146,1273,805,2021-01-09 05:49:42
824,873,3,688,89,777,806,2021-01-09 16:13:48
825,213,2,598,77,675,807,2021-01-09 18:07:42
826,349,3,1047,136,1183,808,2021-01-09 09:17:12
827,925,1,299,38,337,809,2021-01-09 14:08:43
828,323,2,898,116,1014,810,2021-01-09 15:13:20
829,584,4,1277,166,1443,811,2021-01-09 06:29:55
830,232,2,898,116,1014,812,2021-01-09 13:07:12
831,822,3,1247,162,1409,813,2021-01-09 14:09:05
832,622,5,1625,211,1836,814,2021-01-09 14:31:34
833,982,2,528,68,596,815,2021-01-09 10:21:08
834,227,3,827,107,934,816,2021-01-09 22:23:42
835,808,3,558,72,630,817,2021-01-09 14:34:24
836,737,3,558,72,630,818,2021-01-10 08:36:58
837,94,3,747,97,844,819,2021-01-09 20:39:19
838,636,2,648,84,732,820,2021-01-09 19:17:56
839,902,3,897,116,1013,821,2021-01-09 19:14:27
840,922,3,528,68,596,822,2021-01-09 19:42:50
841,680,2,429,55,484,823,2021-01-09 19:56:51
842,221,2,828,107,935,824,2021-01-09 18:51:08
843,149,3,758,98,856,825,2021-01-09 08:27:15
844,860,3,827,107,934,826,2021-01-09 17:12:59
845,436,3,428,55,483,827,2021-01-09 20:28:16
846,436,3,428,55,483,827,2021-01-09 20:28:16
847,833,2,429,55,484,828,2021-01-09 11:45:26
848,151,3,1127,146,1273,829,2021-01-09 14:20:49
849,835,2,598,77,675,830,2021-01-09 15:33:50
850,45,3,597,77,674,831,2021-01-09 07:09:50
851,161,3,727,94,821,832,2021-01-09 13:45:12
852,368,2,798,103,901,833,2021-01-09 16:41:31
853,148,1,699,90,789,834,2021-01-09 15:37:57
854,268,3,827,107,934,835,2021-01-09 11:40:19
855,992,2,628,81,709,836,2021-01-10 00:25:48
856,816,2,598,77,675,837,2021-01-09 15:20:23
857,595,5,1545,200,1745,838,2021-01-10 09:55:46
858,921,3,558,72,630,839,2021-01-09 21:00:00
859,542,2,1098,142,1240,840,2021-01-09 20:08:45
860,633,3,897,116,1013,841,2021-01-09 20:31:48
861,753,5,1456,189,1645,842,2021-01-09 20:34:07
862,65,2,598,77,675,843,2021-01-09 21:53:35
863,465,3,947,123,1070,844,2021-01-09 21:05:39
864,329,3,1027,133,1160,845,2021-01-09 10:52:46
865,6,5,1425,185,1610,846,2021-01-09 19:11:29
866,301,6,1994,259,2253,847,2021-01-09 21:47:26
867,270,4,1246,161,1407,848,2021-01-09 22:19:41
868,25,6,2124,276,2400,849,2021-01-09 13:27:08
869,441,6,1255,163,1418,850,2021-01-09 15:24:22
870,353,4,1287,167,1454,851,2021-01-09 16:36:54
871,337,3,1127,146,1273,852,2021-01-09 08:30:54
872,915,2,698,90,788,853,2021-01-09 14:40:35
873,665,3,927,120,1047,854,2021-01-09 17:22:57
874,460,3,1197,155,1352,855,2021-01-09 16:12:13
875,461,1,699,90,789,856,2021-01-09 12:50:18
876,580,4,1526,198,1724,857,2021-01-10 00:26:38
877,183,5,1656,215,1871,858,2021-01-09 16:01:58
878,118,2,659,85,744,859,2021-01-10 10:15:38
879,539,3,1047,136,1183,860,2021-01-09 23:19:29
880,388,3,1047,136,1183,861,2021-01-09 21:10:55
881,235,1,499,64,563,862,2021-01-09 21:19:04
882,190,2,659,85,744,863,2021-01-09 21:14:44
883,332,2,898,116,1014,864,2021-01-09 23:23:34
884,334,4,1088,141,1229,865,2021-01-09 21:17:58
885,477,3,578,75,653,866,2021-01-09 13:29:34
886,832,3,688,89,777,867,2021-01-09 21:46:40
887,189,3,1327,172,1499,868,2021-01-09 23:06:49
888,179,3,1027,133,1160,869,2021-01-10 00:33:14
889,18,3,827,107,934,870,2021-01-09 14:35:54
890,237,3,927,120,1047,871,2021-01-09 16:32:35
891,195,3,997,129,1126,872,2021-01-09 18:56:43
892,469,3,697,90,787,873,2021-01-09 08:41:33
893,131,3,597,77,674,874,2021-01-09 17:21:44
894,804,2,698,90,788,875,2021-01-09 19:16:45
895,212,2,498,64,562,876,2021-01-09 18:48:05
896,15,3,697,90,787,877,2021-01-09 15:34:07
897,532,3,927,120,1047,878,2021-01-10 00:33:23
898,522,3,478,62,540,879,2021-01-09 18:03:12
899,378,3,797,103,900,880,2021-01-10 10:33:10
900,564,3,827,107,934,881,2021-01-10 01:42:44
901,389,5,1525,198,1723,882,2021-01-09 23:50:54
902,686,5,2045,265,2310,883,2021-01-09 22:17:39
903,5,3,827,107,934,884,2021-01-09 22:43:20
904,51,1,99,12,111,885,2021-01-10 01:16:34
905,976,3,747,97,844,886,2021-01-09 23:36:10
906,447,3,597,77,674,887,2021-01-09 15:45:03
907,266,3,1197,155,1352,888,2021-01-10 00:20:35
908,320,2,429,55,484,889,2021-01-09 23:29:51
909,595,2,798,103,901,890,2021-01-10 02:33:43
910,139,3,758,98,856,891,2021-01-09 16:11:01
911,550,3,1127,146,1273,892,2021-01-09 18:34:47
912,286,3,927,120,1047,893,2021-01-09 19:22:58
913,332,3,478,62,540,894,2021-01-09 10:24:27
914,131,3,1047,136,1183,895,2021-01-09 18:43:04
915,318,3,1327,172,1499,896,2021-01-09 21:45:31
916,256,2,659,85,744,897,2021-01-09 20:20:13
917,246,3,1047,136,1183,898,2021-01-09 16:15:06
918,365,3,608,79,687,899,2021-01-10 02:55:13
919,169,4,1446,187,1633,900,2021-01-09 19:19:44
920,368,2,498,64,562,901,2021-01-10 12:21:40
921,74,3,1027,133,1160,902,2021-01-10 02:47:09
922,380,2,798,103,901,903,2021-01-10 01:56:33
923,750,3,1127,146,1273,904,2021-01-09 23:02:54
924,462,2,429,55,484,905,2021-01-10 00:03:09
925,995,3,558,72,630,906,2021-01-10 03:26:06
926,882,3,727,94,821,907,2021-01-10 00:34:58
927,339,3,888,115,1003,908,2021-01-09 16:43:53
928,27,4,876,113,989,909,2021-01-10 01:23:54
929,606,3,1047,136,1183,910,2021-01-09 23:45:21
930,457,3,1127,146,1273,911,2021-01-10 05:10:17
931,273,3,1127,146,1273,912,2021-01-09 16:58:09
932,438,3,947,123,1070,913,2021-01-09 20:50:59
933,76,3,727,94,821,914,2021-01-09 20:15:37
934,695,3,747,97,844,915,2021-01-09 12:29:04
935,775,5,1226,159,1385,916,2021-01-09 20:45:34
936,305,3,608,79,687,917,2021-01-09 23:39:37
937,291,3,428,55,483,918,2021-01-09 22:27:55
938,23,3,897,116,1013,919,2021-01-09 16:45:17
939,640,3,747,97,844,920,2021-01-10 05:08:59
940,5,3,927,120,1047,921,2021-01-09 19:20:17
941,697,3,1027,133,1160,922,2021-01-10 12:56:45
942,497,3,608,79,687,923,2021-01-10 04:48:58
943,10,3,697,90,787,924,2021-01-10 04:18:21
944,115,2,429,55,484,925,2021-01-10 01:36:27
945,212,3,658,85,743,926,2021-01-10 01:36:22
946,903,5,907,117,1024,927,2021-01-10 04:29:10
947,365,3,997,129,1126,928,2021-01-10 01:47:41
948,554,5,1406,182,1588,929,2021-01-09 19:24:12
949,89,2,598,77,675,930,2021-01-10 02:53:59
950,156,2,698,90,788,931,2021-01-10 02:12:33
951,14,3,808,105,913,932,2021-01-10 05:59:12
952,276,5,1076,139,1215,933,2021-01-09 18:58:58
953,583,2,528,68,596,934,2021-01-09 21:46:13
954,12,3,947,123,1070,935,2021-01-09 22:08:09
955,479,2,898,116,1014,936,2021-01-09 14:35:40
956,680,2,798,103,901,937,2021-01-09 23:21:52
957,334,3,827,107,934,938,2021-01-10 00:43:24
958,158,2,898,116,1014,939,2021-01-10 00:22:28
959,921,3,1047,136,1183,940,2021-01-09 17:36:28
960,491,5,2095,272,2367,941,2021-01-10 06:17:05
961,175,2,628,81,709,942,2021-01-09 20:23:25
962,467,2,698,90,788,943,2021-01-10 15:36:06
963,811,2,798,103,901,944,2021-01-10 06:11:13
964,326,2,598,77,675,945,2021-01-10 05:18:01
965,67,4,1226,159,1385,946,2021-01-10 01:48:03
966,879,2,898,116,1014,947,2021-01-10 02:42:54
967,446,2,798,103,901,948,2021-01-10 05:24:25
968,419,3,658,85,743,949,2021-01-10 02:27:20
969,334,3,578,75,653,950,2021-01-09 20:03:48
970,294,3,797,103,900,951,2021-01-10 04:04:23
971,113,3,727,94,821,952,2021-01-10 02:38:38
972,519,4,1026,133,1159,953,2021-01-10 06:31:08
973,881,2,448,58,506,954,2021-01-09 21:03:12
974,906,3,1127,146,1273,955,2021-01-09 22:25:33
975,562,2,698,90,788,956,2021-01-09 22:43:34
976,845,5,1356,176,1532,957,2021-01-09 15:31:07
977,423,2,598,77,675,958,2021-01-09 23:53:02
978,384,3,558,72,630,959,2021-01-10 00:55:13
979,897,3,1127,146,1273,960,2021-01-10 00:45:14
980,961,3,658,85,743,961,2021-01-09 20:14:35
981,363,3,428,55,483,962,2021-01-10 08:30:43
982,316,2,329,42,371,963,2021-01-09 20:47:25
983,760,3,578,75,653,964,2021-01-10 16:20:45
984,122,5,1426,185,1611,965,2021-01-10 08:46:22
985,173,3,808,105,913,966,2021-01-10 06:07:52
986,134,2,598,77,675,967,2021-01-10 02:53:36
987,808,2,498,64,562,968,2021-01-10 05:08:53
988,195,3,658,85,743,969,2021-01-10 07:18:46
989,201,3,758,98,856,970,2021-01-10 04:02:25
990,990,3,428,55,483,971,2021-01-09 21:10:46
991,112,1,149,19,168,972,2021-01-10 06:08:42
992,261,2,459,59,518,973,2021-01-10 04:47:36
993,70,2,459,59,518,974,2021-01-10 08:59:36
994,452,3,597,77,674,975,2021-01-09 23:49:40
995,239,3,578,75,653,976,2021-01-09 23:48:53
996,821,2,798,103,901,977,2021-01-09 22:55:36
997,13,3,1127,146,1273,978,2021-01-09 16:04:09
998,621,3,647,84,731,979,2021-01-10 00:26:31
999,175,2,429,55,484,980,2021-01-10 01:50:46
1000,524,3,758,98,856,981,2021-01-10 02:50:21
1001,423,3,697,90,787,982,2021-01-09 20:45:40
1002,70,3,997,129,1126,983,2021-01-10 08:55:40
1003,950,2,659,85,744,984,2021-01-09 23:28:34
1004,138,2,728,94,822,985,2021-01-10 18:16:28
1005,893,3,827,107,934,986,2021-01-10 11:30:38
1006,759,3,1247,162,1409,987,2021-01-10 07:26:19
1007,213,2,429,55,484,988,2021-01-10 05:01:27
1008,316,3,727,94,821,989,2021-01-10 06:09:34
1009,202,3,827,107,934,990,2021-01-10 09:04:55
1010,563,5,1156,150,1306,991,2021-01-10 06:33:50
1011,563,5,1156,150,1306,991,2021-01-10 06:33:50
1012,179,3,658,85,743,992,2021-01-09 23:23:21
1013,123,3,747,97,844,993,2021-01-10 07:37:04
1014,145,3,997,129,1126,994,2021-01-10 05:07:57
1015,311,3,558,72,630,995,2021-01-10 09:55:46
1016,591,2,1098,142,1240,996,2021-01-10 02:02:10
1017,791,3,797,103,900,997,2021-01-10 02:25:30
1018,77,2,698,90,788,998,2021-01-10 00:04:01
1019,767,2,898,116,1014,999,2021-01-09 17:35:35
1020,818,1,399,51,450,1000,2021-01-10 00:42:30
1021,939,3,1127,146,1273,1001,2021-01-10 02:09:49
1022,501,3,647,84,731,1002,2021-01-10 05:16:07
1023,167,3,797,103,900,1003,2021-01-09 21:50:55
1024,952,2,748,97,845,1004,2021-01-10 09:18:49
1025,635,5,1217,158,1375,1005,2021-01-09 23:40:36
1026,690,2,659,85,744,1006,2021-01-10 18:58:36
1027,848,3,697,90,787,1007,2021-01-10 13:40:01
1028,664,3,808,105,913,1008,2021-01-10 07:54:20
1029,197,5,1576,204,1780,1009,2021-01-10 07:36:24
1030,185,2,329,42,371,1010,2021-01-10 07:12:41
1031,996,3,1127,146,1273,1011,2021-01-10 09:47:44
1032,73,2,798,103,901,1012,2021-01-10 08:14:41
1033,618,3,697,90,787,1013,2021-01-10 08:33:41
1034,270,2,798,103,901,1014,2021-01-10 01:08:20
1035,228,3,428,55,483,1015,2021-01-10 09:27:07
1036,775,2,898,116,1014,1016,2021-01-10 06:21:19
1037,350,5,1295,168,1463,1017,2021-01-10 12:06:30
1038,72,4,1146,148,1294,1018,2021-01-10 03:30:08
1039,701,3,808,105,913,1019,2021-01-10 03:41:11
1040,27,1,399,51,450,1020,2021-01-10 00:17:31
1041,302,4,1326,172,1498,1021,2021-01-09 18:27:12
1042,286,3,1047,136,1183,1022,2021-01-10 01:05:39
1043,895,3,558,72,630,1023,2021-01-10 03:16:51
1044,651,2,548,71,619,1024,2021-01-10 05:58:35
1045,932,3,888,115,1003,1025,2021-01-10 00:25:26
1046,474,2,659,85,744,1026,2021-01-10 11:18:43
1047,937,2,659,85,744,1027,2021-01-10 02:21:02
1048,872,2,459,59,518,1028,2021-01-10 19:11:25
1049,514,1,99,12,111,1029,2021-01-10 14:03:49
1050,253,2,898,116,1014,1030,2021-01-10 09:14:12
1051,696,3,997,129,1126,1031,2021-01-10 08:04:05
1052,696,3,997,129,1126,1031,2021-01-10 08:04:05
1053,645,4,1096,142,1238,1032,2021-01-10 09:16:34
1054,773,3,1197,155,1352,1033,2021-01-10 11:02:13
1055,923,2,628,81,709,1034,2021-01-10 08:33:40
1056,669,3,697,90,787,1035,2021-01-10 10:33:47
1057,990,1,229,29,258,1036,2021-01-10 02:50:07
1058,819,3,1327,172,1499,1037,2021-01-10 10:57:37
1059,148,3,727,94,821,1038,2021-01-10 08:02:07
1060,382,3,847,110,957,1039,2021-01-10 13:29:53
1061,593,2,498,64,562,1040,2021-01-10 03:59:03
1062,205,2,698,90,788,1041,2021-01-10 04:05:55
1063,303,3,1247,162,1409,1042,2021-01-10 01:26:38
1064,21,2,698,90,788,1043,2021-01-09 20:24:50
1065,219,3,758,98,856,1044,2021-01-10 01:13:20
1066,822,3,747,97,844,1045,2021-01-10 05:13:39
1067,146,4,996,129,1125,1046,2021-01-10 07:00:11
1068,456,3,1027,133,1160,1047,2021-01-10 02:27:14
1069,39,2,598,77,675,1048,2021-01-10 12:15:55
1070,382,3,1127,146,1273,1049,2021-01-10 02:22:30
1071,247,5,1217,158,1375,1050,2021-01-10 19:46:20
1072,654,2,429,55,484,1051,2021-01-10 14:28:06
1073,587,3,1247,162,1409,1052,2021-01-10 10:14:53
1074,127,3,747,97,844,1053,2021-01-10 08:34:24
1075,28,3,727,94,821,1054,2021-01-10 10:14:46
1076,267,2,898,116,1014,1055,2021-01-10 11:30:18
1077,714,5,1245,161,1406,1056,2021-01-10 12:58:00
1078,939,2,898,116,1014,1057,2021-01-10 09:08:10
1079,476,1,99,12,111,1058,2021-01-10 13:10:14
1080,635,2,398,51,449,1059,2021-01-10 03:09:51
1081,589,2,498,64,562,1060,2021-01-10 13:31:54
1082,450,3,597,77,674,1061,2021-01-10 09:10:56
1083,193,6,1625,211,1836,1062,2021-01-10 15:20:38
1084,381,5,1725,224,1949,1063,2021-01-10 05:38:30
1085,989,5,1745,226,1971,1064,2021-01-10 06:20:37
1086,916,3,647,84,731,1065,2021-01-10 01:35:00
1087,653,3,727,94,821,1066,2021-01-09 22:21:00
1088,602,5,1126,146,1272,1067,2021-01-10 03:47:51
1089,629,3,697,90,787,1068,2021-01-10 07:39:09
1090,832,3,697,90,787,1069,2021-01-10 09:41:15
1091,324,3,1197,155,1352,1070,2021-01-10 02:55:42
1092,210,3,747,97,844,1071,2021-01-10 13:18:20
1093,464,3,997,129,1126,1072,2021-01-10 04:38:14
1094,268,3,847,110,957,1073,2021-01-10 22:26:19
1095,607,3,997,129,1126,1074,2021-01-10 16:34:05
1096,870,2,798,103,901,1075,2021-01-10 10:56:49
1097,838,2,798,103,901,1076,2021-01-10 10:10:31
1098,598,2,1098,142,1240,1077,2021-01-10 12:06:28
1099,593,6,1616,210,1826,1078,2021-01-10 13:36:47
1100,989,3,1047,136,1183,1079,2021-01-10 14:09:19
1101,15,3,888,115,1003,1080,2021-01-10 09:30:19
1102,560,3,947,123,1070,1081,2021-01-10 13:53:10
1103,168,6,1225,159,1384,1082,2021-01-10 04:05:39
1104,149,3,897,116,1013,1083,2021-01-10 15:58:19
1105,243,2,598,77,675,1084,2021-01-10 11:12:23
1106,449,3,747,97,844,1085,2021-01-10 16:05:13
1107,572,3,947,123,1070,1086,2021-01-10 06:04:25
1108,773,4,1077,140,1217,1087,2021-01-10 08:01:45
1109,533,4,926,120,1046,1088,2021-01-10 02:55:28
1110,598,1,229,29,258,1089,2021-01-09 23:55:33
1111,441,5,1286,167,1453,1090,2021-01-10 04:37:46
1112,473,4,1226,159,1385,1091,2021-01-10 08:55:19
1113,366,1,229,29,258,1092,2021-01-10 11:52:34
1114,430,2,659,85,744,1093,2021-01-10 04:15:22
1115,964,3,578,75,653,1094,2021-01-10 14:09:45
1116,256,2,498,64,562,1095,2021-01-10 05:48:48
1117,673,1,149,19,168,1096,2021-01-11 00:29:42
1118,810,3,1047,136,1183,1097,2021-01-10 19:00:18
1119,554,2,698,90,788,1098,2021-01-10 13:37:45
1120,258,3,597,77,674,1099,2021-01-10 10:27:01
1121,509,3,558,72,630,1100,2021-01-10 14:27:08
1122,14,3,578,75,653,1101,2021-01-10 16:20:04
1123,692,6,1336,173,1509,1102,2021-01-10 16:25:27
1124,163,3,428,55,483,1103,2021-01-10 11:27:39
1125,184,3,688,89,777,1104,2021-01-10 14:01:50
1126,823,2,498,64,562,1105,2021-01-10 05:00:45
1127,357,3,1047,136,1183,1106,2021-01-10 17:26:04
1128,41,3,1027,133,1160,1107,2021-01-10 12:01:38
1129,91,2,459,59,518,1108,2021-01-10 17:04:46
1130,602,4,1446,187,1633,1109,2021-01-10 08:21:31
1131,476,2,748,97,845,1110,2021-01-10 10:00:58
1132,762,3,1247,162,1409,1111,2021-01-10 04:23:56
1133,758,3,697,90,787,1112,2021-01-10 00:32:46
1134,840,3,847,110,957,1113,2021-01-10 07:23:21
1135,860,1,599,77,676,1114,2021-01-10 11:39:47
1136,219,3,758,98,856,1115,2021-01-10 12:18:58
1137,490,3,528,68,596,1116,2021-01-10 05:32:19
1138,490,3,528,68,596,1116,2021-01-10 05:32:19
1139,420,2,598,77,675,1117,2021-01-10 16:17:06
1140,568,2,798,103,901,1118,2021-01-10 06:32:18
1141,398,3,1127,146,1273,1119,2021-01-11 01:12:03
1142,994,3,1027,133,1160,1120,2021-01-10 21:10:47
1143,88,3,747,97,844,1121,2021-01-10 14:52:39
1144,283,2,698,90,788,1122,2021-01-10 12:44:56
1145,425,2,1098,142,1240,1123,2021-01-10 15:45:21
1146,304,6,1775,230,2005,1124,2021-01-10 17:41:54
1147,242,5,1137,147,1284,1125,2021-01-10 17:49:20
1148,999,3,647,84,731,1126,2021-01-10 13:52:25
1149,240,3,727,94,821,1127,2021-01-10 14:55:52
1150,521,1,699,90,789,1128,2021-01-10 05:33:07
1151,354,2,659,85,744,1129,2021-01-10 18:44:33
1152,569,2,898,116,1014,1130,2021-01-10 14:15:38
1153,840,3,827,107,934,1131,2021-01-10 17:12:47
1154,721,6,1575,204,1779,1132,2021-01-10 10:46:47
1155,660,3,897,116,1013,1133,2021-01-10 10:14:08
1156,440,3,927,120,1047,1134,2021-01-10 06:52:18
1157,617,3,758,98,856,1135,2021-01-10 01:24:09
1158,450,2,429,55,484,1136,2021-01-10 08:59:57
1159,59,4,1096,142,1238,1137,2021-01-10 13:40:59
1160,898,3,558,72,630,1138,2021-01-10 14:29:44
1161,606,3,597,77,674,1139,2021-01-10 05:51:55
1162,628,5,1456,189,1645,1140,2021-01-10 06:22:40
1163,261,2,898,116,1014,1141,2021-01-10 18:18:27
1164,266,6,2024,263,2287,1142,2021-01-10 08:53:30
1165,245,1,229,29,258,1143,2021-01-11 03:57:49
1166,519,2,898,116,1014,1144,2021-01-10 22:23:39
1167,179,3,478,62,540,1145,2021-01-10 15:15:25
1168,38,3,1047,136,1183,1146,2021-01-10 14:59:11
1169,691,2,1098,142,1240,1147,2021-01-10 17:32:33
1170,839,3,1197,155,1352,1148,2021-01-10 19:03:47
1171,505,2,498,64,562,1149,2021-01-10 19:44:30
1172,754,4,1446,187,1633,1150,2021-01-10 15:13:59
1173,915,5,1326,172,1498,1151,2021-01-10 16:55:10
1174,761,2,798,103,901,1152,2021-01-10 07:58:50
1175,998,3,1127,146,1273,1153,2021-01-10 20:05:54
1176,606,2,798,103,901,1154,2021-01-10 16:47:46
1177,424,3,558,72,630,1155,2021-01-10 19:36:51
1178,854,2,429,55,484,1156,2021-01-10 12:18:17
1179,895,3,1047,136,1183,1157,2021-01-10 10:32:17
1180,130,2,598,77,675,1158,2021-01-10 09:38:33
1181,335,3,578,75,653,1159,2021-01-10 02:54:09
1182,524,2,1098,142,1240,1160,2021-01-10 11:17:44
1183,615,2,698,90,788,1161,2021-01-10 16:06:17
1184,615,2,698,90,788,1161,2021-01-10 16:06:17
1185,976,6,1305,169,1474,1162,2021-01-10 15:21:08
1186,948,4,1426,185,1611,1163,2021-01-10 07:43:11
1187,63,3,1047,136,1183,1164,2021-01-10 06:57:58
1188,120,2,429,55,484,1165,2021-01-10 19:31:47
1189,254,2,798,103,901,1166,2021-01-10 10:27:32
1190,488,3,688,89,777,1167,2021-01-11 04:11:44
1191,713,2,429,55,484,1168,2021-01-11 01:02:29
1192,942,3,758,98,856,1169,2021-01-10 16:58:44
1193,803,6,1974,256,2230,1170,2021-01-10 15:21:39
1194,370,3,927,120,1047,1171,2021-01-10 19:41:21
1195,716,2,898,116,1014,1172,2021-01-10 20:52:08
1196,796,4,977,127,1104,1173,2021-01-10 20:29:18
1197,168,5,1495,194,1689,1174,2021-01-10 16:42:49
1198,527,2,898,116,1014,1175,2021-01-10 18:39:26
1199,755,2,898,116,1014,1176,2021-01-10 08:03:07
1200,172,2,498,64,562,1177,2021-01-10 20:19:59
1201,763,3,997,129,1126,1178,2021-01-10 17:54:46
1202,137,2,598,77,675,1179,2021-01-10 21:53:31
1203,614,2,928,120,1048,1180,2021-01-10 15:00:30
1204,35,2,848,110,958,1181,2021-01-10 11:31:15
1205,1,2,628,81,709,1182,2021-01-10 12:02:17
1206,433,3,1027,133,1160,1183,2021-01-10 05:35:39
1207,190,2,898,116,1014,1184,2021-01-10 12:28:03
1208,918,3,897,116,1013,1185,2021-01-10 18:07:51
1209,336,4,1526,198,1724,1186,2021-01-10 16:08:25
1210,113,2,798,103,901,1187,2021-01-10 15:31:53
1211,156,3,1127,146,1273,1188,2021-01-10 08:40:22
1212,920,3,727,94,821,1189,2021-01-10 07:34:56
1213,774,5,1495,194,1689,1190,2021-01-10 20:47:20
1214,737,1,699,90,789,1191,2021-01-10 12:53:59
1215,584,2,448,58,506,1192,2021-01-11 05:04:18
1216,408,3,428,55,483,1193,2021-01-11 02:57:41
1217,527,4,1087,141,1228,1194,2021-01-10 19:23:17
1218,27,3,897,116,1013,1195,2021-01-10 15:26:26
1219,438,3,927,120,1047,1196,2021-01-10 20:54:58
1220,904,3,847,110,957,1197,2021-01-10 23:22:46
1221,766,1,399,51,450,1198,2021-01-10 21:17:16
1222,507,3,578,75,653,1199,2021-01-10 18:53:49
1223,684,3,827,107,934,1200,2021-01-10 20:40:41
1224,563,2,798,103,901,1201,2021-01-10 09:06:33
1225,819,2,498,64,562,1202,2021-01-10 22:51:38
1226,883,1,499,64,563,1203,2021-01-10 18:03:24
1227,677,3,688,89,777,1204,2021-01-10 22:20:13
1228,72,2,898,116,1014,1205,2021-01-10 16:28:22
1229,104,3,478,62,540,1206,2021-01-10 12:06:35
1230,172,3,797,103,900,1207,2021-01-10 12:47:50
1231,847,2,798,103,901,1208,2021-01-10 06:09:45
1232,765,3,827,107,934,1209,2021-01-10 12:36:52
1233,234,2,459,59,518,1210,2021-01-10 20:11:17
1234,306,2,698,90,788,1211,2021-01-10 17:40:38
1235,379,2,648,84,732,1212,2021-01-10 16:26:53
1236,819,3,827,107,934,1213,2021-01-10 09:44:02
1237,985,2,628,81,709,1214,2021-01-10 07:39:50
1238,327,3,697,90,787,1215,2021-01-10 22:57:53
1239,64,3,827,107,934,1216,2021-01-10 14:36:41
1240,118,2,459,59,518,1217,2021-01-11 05:28:30
1241,204,3,847,110,957,1218,2021-01-11 03:02:07
1242,387,2,459,59,518,1219,2021-01-10 22:04:57
1243,720,3,727,94,821,1220,2021-01-10 16:24:55
1244,317,3,927,120,1047,1221,2021-01-10 22:55:19
1245,745,3,997,129,1126,1222,2021-01-11 00:56:54
1246,137,3,578,75,653,1223,2021-01-10 22:46:42
1247,283,5,1395,181,1576,1224,2021-01-10 20:01:56
1248,965,2,659,85,744,1225,2021-01-10 20:57:22
1249,119,2,698,90,788,1226,2021-01-10 09:23:00
1250,353,3,1327,172,1499,1227,2021-01-11 00:42:54
1251,961,4,1446,187,1633,1228,2021-01-10 19:47:09
1252,196,5,926,120,1046,1229,2021-01-10 22:53:22
1253,665,3,997,129,1126,1230,2021-01-10 18:58:13
1254,582,1,149,19,168,1231,2021-01-10 12:48:39
1255,282,6,1805,234,2039,1232,2021-01-10 15:33:37
1256,955,3,528,68,596,1233,2021-01-10 06:31:34
1257,844,2,1098,142,1240,1234,2021-01-10 15:19:11
1258,906,3,578,75,653,1235,2021-01-10 21:12:37
1259,381,3,747,97,844,1236,2021-01-10 18:54:56
1260,769,2,329,42,371,1237,2021-01-10 17:15:28
1261,545,5,1425,185,1610,1238,2021-01-10 11:59:14
1262,385,2,898,116,1014,1239,2021-01-10 08:18:11
1263,497,3,697,90,787,1240,2021-01-11 01:14:32
1264,82,4,1426,185,1611,1241,2021-01-10 17:05:19
1265,524,6,1524,198,1722,1242,2021-01-11 06:04:59
1266,76,3,847,110,957,1243,2021-01-11 05:41:24
1267,467,3,578,75,653,1244,2021-01-10 22:25:13
1268,932,3,1327,172,1499,1245,2021-01-10 17:32:33
1269,216,2,329,42,371,1246,2021-01-10 23:42:30
1270,217,2,598,77,675,1247,2021-01-11 03:27:51
1271,327,4,1326,172,1498,1248,2021-01-11 00:04:58
1272,280,2,329,42,371,1249,2021-01-10 22:09:06
1273,313,3,827,107,934,1250,2021-01-10 22:36:58
1274,64,3,727,94,821,1251,2021-01-10 12:04:02
1275,782,5,1256,163,1419,1252,2021-01-11 02:53:40
1276,436,3,888,115,1003,1253,2021-01-10 20:17:10
1277,378,2,1098,142,1240,1254,2021-01-10 23:36:54
1278,555,1,299,38,337,1255,2021-01-10 21:35:47
1279,143,3,927,120,1047,1256,2021-01-10 15:16:07
1280,360,5,1236,160,1396,1257,2021-01-10 18:19:19
1281,359,3,1127,146,1273,1258,2021-01-10 07:22:04
1282,805,2,928,120,1048,1259,2021-01-10 16:20:14
1283,999,2,928,120,1048,1260,2021-01-10 21:23:56
1284,299,1,99,12,111,1261,2021-01-10 19:50:38
1285,622,2,898,116,1014,1262,2021-01-10 18:51:01
1286,450,5,1295,168,1463,1263,2021-01-10 13:16:20
1287,186,3,927,120,1047,1264,2021-01-10 08:59:13
1288,15,3,927,120,1047,1265,2021-01-11 02:53:18
1289,614,2,459,59,518,1266,2021-01-10 18:20:19
1290,842,2,798,103,901,1267,2021-01-11 08:04:55
1291,665,3,597,77,674,1268,2021-01-11 06:42:13
1292,916,3,1197,155,1352,1269,2021-01-11 00:25:32
1293,477,3,747,97,844,1270,2021-01-10 18:25:39
1294,10,1,399,51,450,1271,2021-01-11 00:55:18
1295,880,2,698,90,788,1272,2021-01-11 05:22:57
1296,223,2,698,90,788,1273,2021-01-11 00:13:28
1297,997,5,1925,250,2175,1274,2021-01-11 00:19:22
1298,564,3,428,55,483,1275,2021-01-10 23:23:38
1299,26,3,597,77,674,1276,2021-01-10 14:34:05
1300,414,3,697,90,787,1277,2021-01-11 03:10:54
1301,67,2,1098,142,1240,1278,2021-01-10 21:25:38
1302,94,2,698,90,788,1279,2021-01-11 00:01:43
1303,478,5,1925,250,2175,1280,2021-01-10 23:27:29
1304,164,3,827,107,934,1281,2021-01-10 15:38:46
1305,710,5,1126,146,1272,1282,2021-01-10 19:07:19
1306,309,3,647,84,731,1283,2021-01-10 09:20:08
1307,142,2,429,55,484,1284,2021-01-10 18:27:47
1308,107,3,847,110,957,1285,2021-01-11 00:09:57
1309,709,2,429,55,484,1286,2021-01-10 20:12:30
1310,953,3,727,94,821,1287,2021-01-10 20:57:00
1311,953,3,727,94,821,1287,2021-01-10 20:57:00
1312,307,3,1327,172,1499,1288,2021-01-10 15:03:22
1313,23,3,797,103,900,1289,2021-01-10 10:17:38
1314,986,3,697,90,787,1290,2021-01-11 04:12:59
1315,597,2,698,90,788,1291,2021-01-10 20:09:24
1316,297,3,897,116,1013,1292,2021-01-11 10:16:09
1317,503,3,1047,136,1183,1293,2021-01-11 07:52:58
1318,322,3,747,97,844,1294,2021-01-11 02:55:43
1319,92,3,578,75,653,1295,2021-01-10 18:37:20
1320,710,3,1127,146,1273,1296,2021-01-11 02:08:38
1321,429,3,888,115,1003,1297,2021-01-11 06:31:36
1322,722,2,498,64,562,1298,2021-01-11 02:07:33
1323,462,2,459,59,518,1299,2021-01-11 02:43:24
1324,891,2,898,116,1014,1300,2021-01-11 01:49:46
1325,339,2,329,42,371,1301,2021-01-10 16:13:49
1326,6,3,1027,133,1160,1302,2021-01-11 04:45:49
1327,146,3,1127,146,1273,1303,2021-01-10 22:41:52
1328,40,2,429,55,484,1304,2021-01-11 01:29:18
1329,379,3,727,94,821,1305,2021-01-11 00:03:53
1330,811,2,498,64,562,1306,2021-01-10 17:26:59
1331,900,3,1327,172,1499,1307,2021-01-10 20:10:39
1332,801,2,698,90,788,1308,2021-01-10 11:51:50
1333,952,3,688,89,777,1309,2021-01-10 18:48:45
1334,596,2,659,85,744,1310,2021-01-11 00:30:21
1335,679,3,528,68,596,1311,2021-01-10 21:38:07
1336,160,2,429,55,484,1312,2021-01-10 22:14:33
1337,779,2,898,116,1014,1313,2021-01-10 22:46:56
1338,564,3,1127,146,1273,1314,2021-01-10 15:12:33
1339,792,2,448,58,506,1315,2021-01-10 10:31:44
1340,158,3,697,90,787,1316,2021-01-11 06:43:23
1341,591,3,758,98,856,1317,2021-01-10 20:26:55
1342,25,2,598,77,675,1318,2021-01-11 12:44:00
1343,484,5,1925,250,2175,1319,2021-01-11 09:53:17
1344,236,5,1295,168,1463,1320,2021-01-11 03:16:43
1345,1,3,1027,133,1160,1321,2021-01-10 20:05:42
1346,806,1,399,51,450,1322,2021-01-11 04:49:21
1347,614,3,888,115,1003,1323,2021-01-11 08:29:22
1348,798,6,1744,226,1970,1324,2021-01-11 04:03:23
1349,180,4,827,107,934,1325,2021-01-11 04:25:47
1350,949,2,598,77,675,1326,2021-01-11 04:10:26
1351,848,3,897,116,1013,1327,2021-01-10 17:34:04
1352,36,3,1047,136,1183,1328,2021-01-11 05:36:15
1353,802,5,1186,154,1340,1329,2021-01-10 22:53:13
1354,642,2,898,116,1014,1330,2021-01-11 02:34:38
1355,775,3,647,84,731,1331,2021-01-11 00:23:36
1356,244,6,1355,176,1531,1332,2021-01-10 19:28:28
1357,502,3,688,89,777,1333,2021-01-10 22:47:13
1358,446,3,658,85,743,1334,2021-01-10 13:28:59
1359,569,5,1645,213,1858,1335,2021-01-10 21:33:21
1360,986,1,299,38,337,1336,2021-01-11 02:05:08
1361,803,3,927,120,1047,1337,2021-01-10 23:07:54
1362,401,3,558,72,630,1338,2021-01-10 22:42:45
1363,739,2,1098,142,1240,1339,2021-01-11 00:13:22
1364,739,2,1098,142,1240,1339,2021-01-11 00:13:22
1365,289,2,329,42,371,1340,2021-01-10 16:32:11
1366,56,3,478,62,540,1341,2021-01-10 10:40:46
1367,928,3,558,72,630,1342,2021-01-11 09:12:00
1368,487,2,698,90,788,1343,2021-01-10 21:19:20
1369,977,3,1327,172,1499,1344,2021-01-11 13:25:03
1370,247,3,1027,133,1160,1345,2021-01-11 12:14:40
1371,168,2,698,90,788,1346,2021-01-11 04:56:09
1372,721,5,1386,180,1566,1347,2021-01-10 21:19:16
1373,796,6,1775,230,2005,1348,2021-01-11 07:34:33
1374,350,5,1576,204,1780,1349,2021-01-11 09:54:06
1375,471,4,1207,156,1363,1350,2021-01-11 05:30:01
1376,80,3,727,94,821,1351,2021-01-11 05:39:50
1377,631,6,1255,163,1418,1352,2021-01-11 06:38:35
1378,851,3,478,62,540,1353,2021-01-10 18:27:16
1379,65,2,329,42,371,1354,2021-01-11 05:48:18
1380,870,2,898,116,1014,1355,2021-01-11 00:31:56
1381,476,3,658,85,743,1356,2021-01-11 03:01:52
1382,63,3,528,68,596,1357,2021-01-11 00:38:34
1383,61,3,808,105,913,1358,2021-01-10 20:09:51
1384,73,2,1098,142,1240,1359,2021-01-11 00:57:02
1385,335,3,1027,133,1160,1360,2021-01-10 14:45:44
1386,450,3,747,97,844,1361,2021-01-10 23:19:18
1387,558,4,1096,142,1238,1362,2021-01-11 03:06:52
1388,664,6,1655,215,1870,1363,2021-01-11 00:22:49
1389,310,2,698,90,788,1364,2021-01-11 00:06:02
1390,265,3,647,84,731,1365,2021-01-11 01:16:00
1391,615,3,658,85,743,1366,2021-01-11 02:50:17
1392,219,3,478,62,540,1367,2021-01-10 17:39:18
1393,366,2,459,59,518,1368,2021-01-10 11:52:51
1394,612,3,927,120,1047,1369,2021-01-11 09:30:29
1395,978,3,1047,136,1183,1370,2021-01-10 21:19:43
1396,528,3,1127,146,1273,1371,2021-01-11 14:04:08
1397,929,4,1426,185,1611,1372,2021-01-11 14:09:10
1398,886,5,1745,226,1971,1373,2021-01-11 06:05:53
1399,972,3,758,98,856,1374,2021-01-10 21:24:01
1400,402,3,897,116,1013,1375,2021-01-11 08:31:04
1401,473,2,498,64,562,1376,2021-01-11 12:16:38
1402,879,6,1874,243,2117,1377,2021-01-11 07:11:30
1403,934,3,608,79,687,1378,2021-01-11 07:37:36
1404,765,6,1355,176,1531,1379,2021-01-11 08:02:27
1405,113,3,827,107,934,1380,2021-01-10 20:41:28
1406,167,3,897,116,1013,1381,2021-01-11 05:49:10
1407,858,3,1247,162,1409,1382,2021-01-11 03:17:01
1408,11,3,1197,155,1352,1383,2021-01-11 03:14:02
1409,866,5,1545,200,1745,1384,2021-01-11 01:42:59
1410,954,3,1027,133,1160,1385,2021-01-10 20:33:35
1411,803,2,448,58,506,1386,2021-01-11 01:38:34
1412,239,3,608,79,687,1387,2021-01-10 15:44:42
1413,654,5,2025,263,2288,1388,2021-01-11 00:21:17
1414,822,3,758,98,856,1389,2021-01-11 04:57:36
1415,479,3,827,107,934,1390,2021-01-11 02:38:01
1416,457,2,498,64,562,1391,2021-01-11 01:27:09
1417,68,3,688,89,777,1392,2021-01-11 03:45:32
1418,597,3,797,103,900,1393,2021-01-11 03:20:57
1419,395,5,2025,263,2288,1394,2021-01-10 17:44:41
1420,446,2,548,71,619,1395,2021-01-10 14:05:31
1421,285,5,926,120,1046,1396,2021-01-11 10:51:23
1422,207,3,478,62,540,1397,2021-01-10 23:53:57
1423,105,3,1027,133,1160,1398,2021-01-11 15:36:36
1424,258,3,1247,162,1409,1399,2021-01-11 14:16:30
1425,93,3,478,62,540,1400,2021-01-11 06:45:20
1426,522,6,1924,250,2174,1401,2021-01-11 00:06:23
1427,538,3,947,123,1070,1402,2021-01-11 10:13:50
1428,884,2,659,85,744,1403,2021-01-11 13:10:40
1429,96,2,498,64,562,1404,2021-01-11 09:57:02
1430,807,2,528,68,596,1405,2021-01-11 08:45:00
1431,241,3,747,97,844,1406,2021-01-11 08:53:35
1432,219,2,548,71,619,1407,2021-01-10 22:35:55
1433,899,3,927,120,1047,1408,2021-01-11 07:07:28
1434,597,2,698,90,788,1409,2021-01-11 03:24:16
1435,824,3,558,72,630,1410,2021-01-11 04:22:16
1436,143,5,1856,241,2097,1411,2021-01-11 02:26:38
1437,213,3,897,116,1013,1412,2021-01-10 22:51:01
1438,881,3,727,94,821,1413,2021-01-11 01:50:59
1439,328,2,429,55,484,1414,2021-01-10 16:27:03
1440,197,3,558,72,630,1415,2021-01-11 00:43:43
1441,801,2,459,59,518,1416,2021-01-11 05:56:18
1442,679,2,928,120,1048,1417,2021-01-11 04:32:07
1443,325,2,659,85,744,1418,2021-01-11 03:53:28
1444,449,3,797,103,900,1419,2021-01-11 03:53:20
1445,332,2,498,64,562,1420,2021-01-11 04:50:32
1446,658,2,898,116,1014,1421,2021-01-10 19:25:24
1447,713,2,898,116,1014,1422,2021-01-10 14:07:45
1448,212,3,697,90,787,1423,2021-01-11 13:27:43
1449,744,2,598,77,675,1424,2021-01-11 02:27:01
1450,317,3,578,75,653,1425,2021-01-11 15:37:43
1451,862,2,898,116,1014,1426,2021-01-11 15:21:44
1452,108,5,1895,246,2141,1427,2021-01-11 08:16:50
1453,859,2,698,90,788,1428,2021-01-11 02:32:22
1454,475,3,827,107,934,1429,2021-01-11 12:53:23
1455,242,3,697,90,787,1430,2021-01-11 14:22:06
1456,484,3,797,103,900,1431,2021-01-11 12:27:28
1457,752,2,598,77,675,1432,2021-01-11 11:09:41
1458,967,6,1605,208,1813,1433,2021-01-11 10:42:47
1459,152,2,1098,142,1240,1434,2021-01-10 23:50:38
1460,839,3,1327,172,1499,1435,2021-01-11 09:45:26
1461,453,3,827,107,934,1436,2021-01-11 03:26:28
1462,627,2,498,64,562,1437,2021-01-11 07:08:31
1463,280,3,1247,162,1409,1438,2021-01-11 03:39:12
1464,919,3,1247,162,1409,1439,2021-01-11 01:02:10
1465,245,3,997,129,1126,1440,2021-01-11 04:08:45
1466,842,3,428,55,483,1441,2021-01-10 17:02:54
1467,598,2,498,64,562,1442,2021-01-11 02:10:58
1468,771,3,608,79,687,1443,2021-01-11 08:24:40
1469,198,2,459,59,518,1444,2021-01-11 07:04:21
1470,152,2,459,59,518,1445,2021-01-11 04:36:05
1471,734,5,1595,207,1802,1446,2021-01-11 04:23:58
1472,854,3,597,77,674,1447,2021-01-11 05:13:49
1473,143,3,947,123,1070,1448,2021-01-10 21:45:45
1474,996,3,428,55,483,1449,2021-01-10 15:27:56
1475,750,3,897,116,1013,1450,2021-01-11 13:44:07
1476,432,2,1098,142,1240,1451,2021-01-11 02:52:33
1477,707,3,428,55,483,1452,2021-01-11 18:09:33
1478,31,2,498,64,562,1453,2021-01-11 16:28:03
1479,623,3,1027,133,1160,1454,2021-01-11 10:22:02
1480,682,2,329,42,371,1455,2021-01-11 04:19:25
1481,374,2,659,85,744,1456,2021-01-11 14:19:48
1482,37,3,688,89,777,1457,2021-01-11 16:34:09
1483,740,5,1076,139,1215,1458,2021-01-11 13:58:51
1484,737,3,1027,133,1160,1459,2021-01-11 11:46:01
1485,931,2,598,77,675,1460,2021-01-11 11:50:46
1486,748,6,1646,213,1859,1461,2021-01-11 00:30:11
1487,531,5,1347,175,1522,1462,2021-01-11 11:56:47
1488,814,3,1327,172,1499,1463,2021-01-11 05:10:05
1489,425,5,1586,206,1792,1464,2021-01-11 09:00:44
1490,217,5,1395,181,1576,1465,2021-01-11 06:18:51
1491,679,3,927,120,1047,1466,2021-01-11 01:22:22
1492,942,2,528,68,596,1467,2021-01-11 04:16:25
1493,248,2,1098,142,1240,1468,2021-01-10 19:28:47
1494,155,2,659,85,744,1469,2021-01-11 03:24:04
1495,942,3,558,72,630,1470,2021-01-11 10:55:00
1496,504,3,1047,136,1183,1471,2021-01-11 09:21:46
1497,235,2,598,77,675,1472,2021-01-11 06:21:19
1498,3,5,1326,172,1498,1473,2021-01-11 05:17:09
1499,263,3,1247,162,1409,1474,2021-01-11 05:17:29
1500,221,2,498,64,562,1475,2021-01-10 23:40:31
1501,81,3,827,107,934,1476,2021-01-10 17:29:05
1502,838,3,578,75,653,1477,2021-01-11 14:18:50
1503,732,2,798,103,901,1478,2021-01-11 03:50:02
1504,472,2,459,59,518,1479,2021-01-11 19:29:16
1505,401,2,659,85,744,1480,2021-01-11 16:42:23
1506,907,3,697,90,787,1481,2021-01-11 11:32:28
1507,728,3,528,68,596,1482,2021-01-11 04:20:49
1508,921,2,429,55,484,1483,2021-01-11 16:37:13
1509,230,2,898,116,1014,1484,2021-01-11 18:58:14
1510,810,1,699,90,789,1485,2021-01-11 14:01:03
1511,320,3,658,85,743,1486,2021-01-11 12:12:35
1512,688,5,1725,224,1949,1487,2021-01-11 12:03:45
1513,990,3,647,84,731,1488,2021-01-11 00:32:43
1514,802,2,798,103,901,1489,2021-01-11 13:44:08
1515,142,2,329,42,371,1490,2021-01-11 06:27:34
1516,306,3,747,97,844,1491,2021-01-11 09:50:19
1517,204,3,658,85,743,1492,2021-01-11 07:01:46
1518,479,2,598,77,675,1493,2021-01-11 02:35:36
1519,696,3,1327,172,1499,1494,2021-01-11 04:26:28
1520,635,2,548,71,619,1495,2021-01-10 20:51:43
1521,35,2,429,55,484,1496,2021-01-11 03:25:59
1522,796,2,798,103,901,1497,2021-01-11 10:58:18
1523,921,3,808,105,913,1498,2021-01-11 11:28:07
1524,690,3,697,90,787,1499,2021-01-11 06:33:30
1525,342,5,1645,213,1858,1500,2021-01-11 07:48:06
1526,884,2,628,81,709,1501,2021-01-11 07:54:51
1527,219,3,888,115,1003,1502,2021-01-11 00:38:02
1528,680,5,1395,181,1576,1503,2021-01-10 18:00:19
1529,630,3,608,79,687,1504,2021-01-11 14:33:47
1530,329,3,727,94,821,1505,2021-01-11 05:08:35
1531,521,2,598,77,675,1506,2021-01-11 22:00:40
1532,209,3,808,105,913,1507,2021-01-11 19:20:09
1533,814,1,299,38,337,1508,2021-01-11 11:56:44
1534,574,2,429,55,484,1509,2021-01-11 06:26:25
1535,391,1,99,12,111,1510,2021-01-11 18:38:52
1536,766,6,1885,245,2130,1511,2021-01-11 21:11:20
1537,75,3,827,107,934,1512,2021-01-11 15:44:21
1538,871,2,748,97,845,1513,2021-01-11 13:56:39
1539,315,2,598,77,675,1514,2021-01-11 13:11:30
1540,805,3,808,105,913,1515,2021-01-11 00:36:39
1541,486,4,1356,176,1532,1516,2021-01-11 14:04:24
1542,72,3,997,129,1126,1517,2021-01-11 06:47:00
1543,268,5,1625,211,1836,1518,2021-01-11 10:58:25
1544,969,5,1595,207,1802,1519,2021-01-11 08:45:02
1545,912,3,747,97,844,1520,2021-01-11 02:51:21
1546,505,2,548,71,619,1521,2021-01-11 06:34:47
1547,414,3,528,68,596,1522,2021-01-10 23:23:15
1548,622,3,478,62,540,1523,2021-01-11 05:23:29
1549,461,2,898,116,1014,1524,2021-01-11 11:08:38
1550,748,2,498,64,562,1525,2021-01-11 13:50:50
1551,148,3,1047,136,1183,1526,2021-01-11 08:57:12
1552,770,3,528,68,596,1527,2021-01-11 09:03:38
1553,511,3,827,107,934,1528,2021-01-11 08:55:47
1554,614,3,1247,162,1409,1529,2021-01-11 01:33:24
1555,128,2,1098,142,1240,1530,2021-01-10 18:25:04
1556,139,5,1655,215,1870,1531,2021-01-11 15:06:54
1557,232,2,598,77,675,1532,2021-01-11 06:12:53
1558,263,3,1127,146,1273,1533,2021-01-11 23:00:18
1559,659,3,1327,172,1499,1534,2021-01-11 21:07:30
1560,565,2,459,59,518,1535,2021-01-11 14:15:00
1561,224,4,1896,246,2142,1536,2021-01-11 07:42:40
1562,291,3,578,75,653,1537,2021-01-11 20:10:22
1563,353,3,827,107,934,1538,2021-01-11 23:53:47
1564,771,3,578,75,653,1539,2021-01-11 17:59:36
1565,285,3,608,79,687,1540,2021-01-11 15:55:42
1566,702,3,747,97,844,1541,2021-01-11 15:29:29
1567,857,5,1237,160,1397,1542,2021-01-11 01:54:18
1568,568,2,748,97,845,1543,2021-01-11 16:33:47
1569,751,2,798,103,901,1544,2021-01-11 08:51:11
1570,42,6,1574,204,1778,1545,2021-01-11 12:20:17
1571,613,3,827,107,934,1546,2021-01-11 09:02:17
1572,371,3,888,115,1003,1547,2021-01-11 03:57:38
1573,611,3,897,116,1013,1548,2021-01-11 08:11:30
1574,50,3,827,107,934,1549,2021-01-11 02:02:51
1575,948,1,499,64,563,1550,2021-01-11 07:08:43
1576,787,3,558,72,630,1551,2021-01-11 11:55:09
1577,647,5,1545,200,1745,1552,2021-01-11 16:35:24
1578,555,1,699,90,789,1553,2021-01-11 10:03:00
1579,857,3,1027,133,1160,1554,2021-01-11 10:45:14
1580,687,3,558,72,630,1555,2021-01-11 09:07:31
1581,820,3,947,123,1070,1556,2021-01-11 03:04:01
1582,21,2,498,64,562,1557,2021-01-10 18:32:38
1583,852,5,1245,161,1406,1558,2021-01-11 17:41:39
1584,943,1,599,77,676,1559,2021-01-11 08:38:32
1585,205,3,827,107,934,1560,2021-01-12 01:41:23
1586,883,3,528,68,596,1561,2021-01-11 22:53:27
1587,155,3,888,115,1003,1562,2021-01-11 14:19:15
1588,222,2,898,116,1014,1563,2021-01-11 08:41:28
1589,416,1,149,19,168,1564,2021-01-11 20:51:44
1590,492,3,1127,146,1273,1565,2021-01-12 01:51:33
1591,926,3,997,129,1126,1566,2021-01-11 20:10:31
1592,910,2,698,90,788,1567,2021-01-11 18:29:18
1593,741,2,429,55,484,1568,2021-01-11 17:49:23
1594,415,3,797,103,900,1569,2021-01-11 04:11:00
1595,42,3,697,90,787,1570,2021-01-11 17:55:41
1596,849,3,697,90,787,1571,2021-01-11 10:27:26
1597,679,2,928,120,1048,1572,2021-01-11 13:23:45
1598,122,3,897,116,1013,1573,2021-01-11 09:39:25
1599,97,3,827,107,934,1574,2021-01-11 05:57:57
1600,150,6,1494,194,1688,1575,2021-01-11 08:42:53
1601,563,4,977,127,1104,1576,2021-01-11 04:01:48
1602,606,3,647,84,731,1577,2021-01-11 07:34:57
1603,353,2,498,64,562,1578,2021-01-11 12:19:56
1604,335,2,698,90,788,1579,2021-01-11 17:08:03
1605,765,3,997,129,1126,1580,2021-01-11 11:50:14
1606,567,3,1127,146,1273,1581,2021-01-11 12:05:00
1607,647,3,428,55,483,1582,2021-01-11 11:33:27
1608,73,2,828,107,935,1583,2021-01-11 05:21:52
1609,630,3,697,90,787,1584,2021-01-10 19:44:54
1610,345,2,698,90,788,1585,2021-01-11 19:04:39
1611,631,3,1197,155,1352,1586,2021-01-11 11:23:23
1612,251,2,598,77,675,1587,2021-01-12 03:34:06
1613,640,4,1246,161,1407,1588,2021-01-12 01:07:35
1614,619,3,558,72,630,1589,2021-01-11 16:33:13
1615,179,3,888,115,1003,1590,2021-01-11 10:32:17
1616,61,2,798,103,901,1591,2021-01-11 21:57:55
1617,883,2,498,64,562,1592,2021-01-12 04:17:09
1618,791,3,478,62,540,1593,2021-01-11 21:42:11
1619,296,5,1825,237,2062,1594,2021-01-11 20:45:52
1620,558,2,429,55,484,1595,2021-01-11 18:56:25
1621,616,2,598,77,675,1596,2021-01-11 06:35:15
1622,971,3,608,79,687,1597,2021-01-11 20:35:05
1623,132,2,329,42,371,1598,2021-01-11 12:26:09
1624,91,5,1545,200,1745,1599,2021-01-11 15:34:30
1625,204,2,498,64,562,1600,2021-01-11 10:26:07
1626,161,2,898,116,1014,1601,2021-01-11 07:09:42
1627,11,3,997,129,1126,1602,2021-01-11 09:58:27
1628,632,1,399,51,450,1603,2021-01-11 06:41:56
1629,999,4,977,127,1104,1604,2021-01-11 08:31:50
1630,395,3,1327,172,1499,1605,2021-01-11 12:53:59
1631,544,1,499,64,563,1606,2021-01-11 17:52:09
1632,170,3,558,72,630,1607,2021-01-11 14:16:43
1633,33,6,1644,213,1857,1608,2021-01-11 13:59:24
1634,503,2,429,55,484,1609,2021-01-11 12:10:04
1635,111,3,888,115,1003,1610,2021-01-11 07:07:26
1636,964,3,808,105,913,1611,2021-01-10 20:22:08
1637,668,2,659,85,744,1612,2021-01-11 20:01:06
1638,134,3,827,107,934,1613,2021-01-11 13:37:34
1639,522,1,599,77,676,1614,2021-01-12 05:56:45
1640,968,3,647,84,731,1615,2021-01-12 02:59:42
1641,521,3,1127,146,1273,1616,2021-01-11 17:08:51
1642,735,3,897,116,1013,1617,2021-01-11 12:57:04
1643,430,2,648,84,732,1618,2021-01-11 22:51:42
1644,834,5,1286,167,1453,1619,2021-01-12 04:40:19
1645,203,3,688,89,777,1620,2021-01-11 23:20:44
1646,932,3,688,89,777,1621,2021-01-11 21:48:20
1647,561,2,598,77,675,1622,2021-01-11 20:28:14
1648,207,5,1636,212,1848,1623,2021-01-11 08:43:12
1649,159,3,797,103,900,1624,2021-01-11 20:41:44
1650,146,4,1646,213,1859,1625,2021-01-11 14:49:25
1651,272,2,659,85,744,1626,2021-01-11 16:40:04
1652,809,6,1416,184,1600,1627,2021-01-11 11:26:28
1653,204,2,1098,142,1240,1628,2021-01-11 09:35:42
1654,491,3,1127,146,1273,1629,2021-01-11 11:10:33
1655,938,2,898,116,1014,1630,2021-01-11 09:07:03
1656,205,2,1098,142,1240,1631,2021-01-11 09:54:36
1657,793,3,747,97,844,1632,2021-01-11 15:04:02
1658,728,3,608,79,687,1633,2021-01-11 20:36:26
1659,717,2,698,90,788,1634,2021-01-11 15:55:00
1660,894,5,1256,163,1419,1635,2021-01-11 14:50:28
1661,588,3,947,123,1070,1636,2021-01-11 14:53:52
1662,237,3,528,68,596,1637,2021-01-11 09:11:26
1663,824,3,1027,133,1160,1638,2021-01-10 21:00:05
1664,511,3,608,79,687,1639,2021-01-11 22:11:02
1665,575,3,688,89,777,1640,2021-01-11 15:54:48
1666,887,2,798,103,901,1641,2021-01-12 08:07:06
1667,588,3,1197,155,1352,1642,2021-01-12 05:30:02
1668,956,2,659,85,744,1643,2021-01-11 19:39:21
1669,790,3,658,85,743,1644,2021-01-11 15:18:45
1670,386,6,1655,215,1870,1645,2021-01-12 00:41:47
1671,5,6,1724,224,1948,1646,2021-01-12 05:44:37
1672,921,3,697,90,787,1647,2021-01-12 00:35:27
1673,961,5,1306,169,1475,1648,2021-01-11 23:49:32
1674,187,3,697,90,787,1649,2021-01-11 21:44:30
1675,295,5,1645,213,1858,1650,2021-01-11 10:19:43
1676,295,5,1645,213,1858,1650,2021-01-11 10:19:43
1677,346,2,898,116,1014,1651,2021-01-11 22:05:16
1678,381,3,478,62,540,1652,2021-01-11 15:27:22
1679,666,3,747,97,844,1653,2021-01-11 18:19:29
1680,399,2,748,97,845,1654,2021-01-11 11:56:03
1681,14,3,1197,155,1352,1655,2021-01-11 09:36:51
1682,462,3,947,123,1070,1656,2021-01-11 13:07:17
1683,563,5,1395,181,1576,1657,2021-01-11 09:45:04
1684,948,1,149,19,168,1658,2021-01-11 10:56:12
1685,733,3,528,68,596,1659,2021-01-11 17:07:17
1686,836,4,1526,198,1724,1660,2021-01-11 21:32:46
1687,606,3,897,116,1013,1661,2021-01-11 17:48:44
1688,147,2,698,90,788,1662,2021-01-11 17:28:24
1689,641,2,329,42,371,1663,2021-01-11 17:25:09
1690,85,2,798,103,901,1664,2021-01-11 09:30:53
1691,326,2,698,90,788,1665,2021-01-10 21:00:37
1692,103,2,429,55,484,1666,2021-01-11 22:31:39
1693,99,3,1047,136,1183,1667,2021-01-11 16:37:45
1694,651,3,608,79,687,1668,2021-01-12 09:42:37
1695,540,3,697,90,787,1669,2021-01-12 07:13:40
1696,437,5,1745,226,1971,1670,2021-01-11 21:02:10
1697,536,3,758,98,856,1671,2021-01-11 16:37:38
1698,480,3,997,129,1126,1672,2021-01-12 01:42:51
1699,383,3,747,97,844,1673,2021-01-12 06:22:47
1700,976,2,698,90,788,1674,2021-01-12 01:08:07
1701,601,2,1098,142,1240,1675,2021-01-12 02:25:46
1702,371,5,1117,145,1262,1676,2021-01-11 23:15:28
1703,482,3,658,85,743,1677,2021-01-11 11:16:32
1704,785,3,727,94,821,1678,2021-01-11 10:28:12
1705,623,3,697,90,787,1679,2021-01-12 00:34:37
1706,840,3,727,94,821,1680,2021-01-11 17:24:41
1707,68,2,898,116,1014,1681,2021-01-11 19:55:01
1708,424,3,997,129,1126,1682,2021-01-11 12:46:23
1709,334,3,647,84,731,1683,2021-01-11 10:06:35
1710,590,4,1826,237,2063,1684,2021-01-11 13:24:49
1711,590,4,1826,237,2063,1684,2021-01-11 13:24:49
1712,184,5,1506,195,1701,1685,2021-01-11 09:57:47
1713,870,3,578,75,653,1686,2021-01-11 11:12:10
1714,943,3,808,105,913,1687,2021-01-11 18:12:56
1715,482,1,229,29,258,1688,2021-01-11 23:45:22
1716,220,2,329,42,371,1689,2021-01-11 18:53:58
1717,491,6,1844,239,2083,1690,2021-01-11 19:57:26
1718,599,3,1127,146,1273,1691,2021-01-11 19:34:36
1719,179,3,558,72,630,1692,2021-01-11 10:40:31
1720,61,3,658,85,743,1693,2021-01-10 21:10:00
1721,87,3,827,107,934,1694,2021-01-12 01:07:00
1722,743,5,1945,252,2197,1695,2021-01-11 17:15:34
1723,252,3,1327,172,1499,1696,2021-01-12 12:06:49
1724,382,3,808,105,913,1697,2021-01-12 08:21:55
1725,188,3,478,62,540,1698,2021-01-11 21:52:56
1726,62,3,608,79,687,1699,2021-01-11 16:53:33
1727,948,2,698,90,788,1700,2021-01-12 03:27:57
1728,32,3,827,107,934,1701,2021-01-12 07:45:42
1729,32,3,827,107,934,1701,2021-01-12 07:45:42
1730,670,1,399,51,450,1702,2021-01-12 01:35:39
1731,580,3,608,79,687,1703,2021-01-12 04:03:08
1732,859,3,528,68,596,1704,2021-01-12 00:31:13
1733,347,2,898,116,1014,1705,2021-01-11 13:27:26
1734,117,3,558,72,630,1706,2021-01-11 10:47:56
1735,522,4,846,109,955,1707,2021-01-12 00:44:21
1736,502,2,329,42,371,1708,2021-01-11 18:08:52
1737,483,3,997,129,1126,1709,2021-01-11 20:58:09
1738,160,5,1426,185,1611,1710,2021-01-11 14:26:50
1739,216,3,997,129,1126,1711,2021-01-11 11:46:44
1740,460,3,688,89,777,1712,2021-01-11 15:41:16
1741,592,3,1127,146,1273,1713,2021-01-11 15:46:55
1742,387,3,558,72,630,1714,2021-01-11 10:25:57
1743,268,3,1327,172,1499,1715,2021-01-11 13:23:10
1744,74,2,659,85,744,1716,2021-01-11 18:49:08
1745,518,2,898,116,1014,1717,2021-01-12 01:41:44
1746,124,6,1355,176,1531,1718,2021-01-11 21:31:58
1747,514,3,558,72,630,1719,2021-01-11 20:57:02
1748,84,2,659,85,744,1720,2021-01-11 20:02:24
1749,159,3,1327,172,1499,1721,2021-01-11 12:14:58
1750,854,3,1127,146,1273,1722,2021-01-10 21:32:12
1751,739,4,996,129,1125,1723,2021-01-12 01:10:18
1752,739,4,996,129,1125,1723,2021-01-12 01:10:18
1753,586,3,1327,172,1499,1724,2021-01-11 19:47:03
1754,182,1,299,38,337,1725,2021-01-12 14:17:51
1755,196,3,578,75,653,1726,2021-01-12 09:33:37
1756,783,3,647,84,731,1727,2021-01-11 23:34:47
1757,262,3,758,98,856,1728,2021-01-11 17:42:44
1758,857,3,428,55,483,1729,2021-01-12 04:46:44
1759,88,3,947,123,1070,1730,2021-01-12 08:54:56
1760,983,2,598,77,675,1731,2021-01-12 10:19:22
1761,60,3,1197,155,1352,1732,2021-01-12 01:51:09
1762,330,3,528,68,596,1733,2021-01-12 05:23:50
1763,157,2,748,97,845,1734,2021-01-12 00:40:03
1764,353,2,598,77,675,1735,2021-01-11 15:16:02
1765,220,4,758,98,856,1736,2021-01-11 11:52:18
1766,732,3,927,120,1047,1737,2021-01-12 01:18:49
1767,435,3,647,84,731,1738,2021-01-11 19:02:32
1768,677,3,558,72,630,1739,2021-01-11 22:17:24
1769,349,2,898,116,1014,1740,2021-01-11 16:04:59
1770,229,2,429,55,484,1741,2021-01-11 14:06:15
1771,169,3,1197,155,1352,1742,2021-01-11 16:50:51
1772,396,3,528,68,596,1743,2021-01-11 16:36:47
1773,299,3,558,72,630,1744,2021-01-11 13:04:46
1774,120,3,1047,136,1183,1745,2021-01-11 13:52:11
1775,744,3,1027,133,1160,1746,2021-01-11 19:44:10
1776,487,3,808,105,913,1747,2021-01-12 02:27:03
1777,111,3,647,84,731,1748,2021-01-11 21:58:10
1778,359,2,429,55,484,1749,2021-01-11 22:02:11
1779,93,2,898,116,1014,1750,2021-01-11 21:32:20
1780,609,2,898,116,1014,1751,2021-01-11 14:44:12
1781,484,3,697,90,787,1752,2021-01-11 00:09:42
1782,455,3,1127,146,1273,1753,2021-01-12 02:08:21
1783,412,3,888,115,1003,1754,2021-01-12 03:46:14
1784,232,3,478,62,540,1755,2021-01-11 21:54:14
1785,668,3,727,94,821,1756,2021-01-12 16:03:27
1786,20,3,758,98,856,1757,2021-01-12 11:31:24
1787,815,2,498,64,562,1758,2021-01-12 01:05:50
1788,666,3,888,115,1003,1759,2021-01-11 18:52:00
1789,482,2,398,51,449,1760,2021-01-12 05:31:16
1790,346,5,1845,239,2084,1761,2021-01-12 09:30:59
1791,748,2,329,42,371,1762,2021-01-12 12:57:40
1792,217,2,598,77,675,1763,2021-01-12 01:52:29
1793,981,3,1027,133,1160,1764,2021-01-12 05:50:25
1794,383,3,1127,146,1273,1765,2021-01-12 02:23:22
1795,496,2,498,64,562,1766,2021-01-11 16:00:23
1796,916,5,1795,233,2028,1767,2021-01-11 14:33:33
1797,519,3,1327,172,1499,1768,2021-01-12 02:42:55
1798,376,1,699,90,789,1769,2021-01-11 19:21:10
1799,813,2,598,77,675,1770,2021-01-11 22:24:49
1800,318,3,1127,146,1273,1771,2021-01-11 16:26:42
1801,679,3,797,103,900,1772,2021-01-11 15:24:47
1802,295,1,99,12,111,1773,2021-01-11 18:49:54
1803,511,3,1197,155,1352,1774,2021-01-11 18:40:23
1804,814,3,997,129,1126,1775,2021-01-11 13:20:36
1805,209,5,1756,228,1984,1776,2021-01-11 14:23:34
1806,245,3,1247,162,1409,1777,2021-01-11 22:22:47
1807,43,5,1425,185,1610,1778,2021-01-12 04:12:10
1808,409,3,1047,136,1183,1779,2021-01-12 00:27:18
1809,580,3,658,85,743,1780,2021-01-12 00:17:02
1810,628,2,698,90,788,1781,2021-01-11 21:59:07
1811,452,2,429,55,484,1782,2021-01-11 15:55:04
1812,686,3,747,97,844,1783,2021-01-11 00:45:33
1813,568,3,927,120,1047,1784,2021-01-12 04:04:02
1814,593,3,428,55,483,1785,2021-01-12 06:10:15
1815,842,3,1127,146,1273,1786,2021-01-11 22:40:00
1816,662,3,897,116,1013,1787,2021-01-12 18:25:03
1817,128,3,827,107,934,1788,2021-01-12 13:57:28
1818,128,3,827,107,934,1788,2021-01-12 13:57:28
1819,551,3,1247,162,1409,1789,2021-01-12 01:11:34
1820,720,3,727,94,821,1790,2021-01-11 20:07:47
1821,814,3,847,110,957,1791,2021-01-12 08:09:07
1822,731,1,99,12,111,1792,2021-01-12 12:05:08
1823,558,2,598,77,675,1793,2021-01-12 13:20:58
1824,138,3,797,103,900,1794,2021-01-12 04:33:10
1825,625,3,558,72,630,1795,2021-01-12 06:22:14
1826,733,2,798,103,901,1796,2021-01-12 02:38:13
1827,499,3,1127,146,1273,1797,2021-01-11 18:43:45
1828,458,3,1127,146,1273,1798,2021-01-11 15:31:17
1829,814,1,229,29,258,1799,2021-01-12 03:32:08
1830,237,2,598,77,675,1800,2021-01-11 21:51:17
1831,205,2,698,90,788,1801,2021-01-11 23:44:45
1832,395,3,747,97,844,1802,2021-01-11 16:33:53
1833,969,3,597,77,674,1803,2021-01-11 17:07:16
1834,758,3,597,77,674,1804,2021-01-11 19:41:23
1835,72,1,399,51,450,1805,2021-01-11 19:06:33
1836,507,3,727,94,821,1806,2021-01-11 15:16:31
1837,963,3,758,98,856,1807,2021-01-11 16:53:48
1838,303,3,758,98,856,1808,2021-01-11 22:57:32
1839,747,3,827,107,934,1809,2021-01-12 06:51:14
1840,122,4,877,114,991,1810,2021-01-12 02:36:34
1841,369,3,1247,162,1409,1811,2021-01-12 01:03:39
1842,493,2,898,116,1014,1812,2021-01-11 22:38:13
1843,562,1,149,19,168,1813,2021-01-11 17:08:02
1844,268,3,1247,162,1409,1814,2021-01-11 03:12:30
1845,25,3,927,120,1047,1815,2021-01-12 06:19:56
1846,992,2,659,85,744,1816,2021-01-12 06:54:48
1847,189,2,459,59,518,1817,2021-01-12 00:17:05
1848,84,3,758,98,856,1818,2021-01-12 20:11:27
1849,335,3,997,129,1126,1819,2021-01-12 15:47:14
1850,486,3,827,107,934,1820,2021-01-12 14:04:18
1851,227,2,798,103,901,1821,2021-01-12 01:51:35
1852,744,3,608,79,687,1822,2021-01-11 21:33:26
1853,523,1,499,64,563,1823,2021-01-12 08:42:55
1854,134,5,1317,171,1488,1824,2021-01-12 14:45:34
1855,772,2,329,42,371,1825,2021-01-12 13:45:28
1856,353,3,827,107,934,1826,2021-01-12 06:06:56
1857,555,2,329,42,371,1827,2021-01-12 08:18:04
1858,530,2,429,55,484,1828,2021-01-12 04:22:04
1859,238,4,1296,168,1464,1829,2021-01-11 19:16:10
1860,415,3,808,105,913,1830,2021-01-11 15:47:52
1861,56,2,828,107,935,1831,2021-01-12 05:56:17
1862,243,2,898,116,1014,1832,2021-01-11 22:20:46
1863,521,3,797,103,900,1833,2021-01-12 01:24:20
1864,656,2,498,64,562,1834,2021-01-11 18:03:38
1865,110,2,459,59,518,1835,2021-01-11 17:53:49
1866,223,1,229,29,258,1836,2021-01-11 21:56:15
1867,169,3,1047,136,1183,1837,2021-01-11 21:21:05
1868,35,3,827,107,934,1838,2021-01-11 17:18:50
1869,624,1,99,12,111,1839,2021-01-11 17:45:36
1870,133,3,608,79,687,1840,2021-01-11 23:02:57
1871,647,2,1098,142,1240,1841,2021-01-12 08:06:18
1872,970,3,727,94,821,1842,2021-01-12 03:33:34
1873,195,5,1386,180,1566,1843,2021-01-12 02:54:24
1874,379,1,399,51,450,1844,2021-01-12 00:26:50
1875,615,2,659,85,744,1845,2021-01-11 18:45:02
1876,828,5,1356,176,1532,1846,2021-01-11 03:19:20
1877,391,3,528,68,596,1847,2021-01-12 08:34:29
1878,154,3,658,85,743,1848,2021-01-12 09:37:25
1879,164,3,747,97,844,1849,2021-01-12 01:33:16
1880,96,3,727,94,821,1850,2021-01-12 20:52:32
1881,443,2,429,55,484,1851,2021-01-12 16:35:37
1882,598,5,937,121,1058,1852,2021-01-12 15:04:03
1883,486,2,1098,142,1240,1853,2021-01-12 02:02:36
1884,223,3,1047,136,1183,1854,2021-01-11 21:40:13
1885,558,3,727,94,821,1855,2021-01-12 09:04:54
1886,549,5,2145,278,2423,1856,2021-01-12 16:57:52
1887,880,2,598,77,675,1857,2021-01-12 14:11:53
1888,446,2,698,90,788,1858,2021-01-12 06:21:02
1889,858,1,399,51,450,1859,2021-01-12 10:49:53
1890,117,3,1047,136,1183,1860,2021-01-12 07:07:45
1891,328,3,1197,155,1352,1861,2021-01-11 21:27:16
1892,909,3,478,62,540,1862,2021-01-11 16:36:51
1893,558,3,927,120,1047,1863,2021-01-12 08:34:11
1894,328,2,898,116,1014,1864,2021-01-12 00:36:20
1895,382,5,1495,194,1689,1865,2021-01-12 01:47:02
1896,231,3,428,55,483,1866,2021-01-11 18:07:14
1897,854,3,697,90,787,1867,2021-01-11 20:00:17
1898,85,3,997,129,1126,1868,2021-01-11 23:57:37
1899,580,2,798,103,901,1869,2021-01-11 22:20:07
1900,625,5,1256,163,1419,1870,2021-01-11 19:47:32
1901,473,3,747,97,844,1871,2021-01-11 19:21:29
1902,875,3,428,55,483,1872,2021-01-12 01:48:32
1903,116,4,1596,207,1803,1873,2021-01-12 08:21:37
1904,939,2,598,77,675,1874,2021-01-12 05:58:08
1905,89,5,1825,237,2062,1875,2021-01-12 04:33:18
1906,810,3,847,110,957,1876,2021-01-12 03:08:53
1907,2,3,997,129,1126,1877,2021-01-11 20:30:39
1908,224,3,597,77,674,1878,2021-01-11 05:18:25
1909,383,2,498,64,562,1879,2021-01-12 09:02:34
1910,362,3,528,68,596,1880,2021-01-12 12:02:46
1911,570,2,598,77,675,1881,2021-01-12 03:46:49
1912,218,4,1546,200,1746,1882,2021-01-12 22:50:51
1913,385,3,558,72,630,1883,2021-01-12 18:25:53
1914,533,4,1046,135,1181,1884,2021-01-12 15:48:02
1915,493,2,598,77,675,1885,2021-01-12 02:14:05
1916,394,2,598,77,675,1886,2021-01-11 21:54:15
1917,100,3,847,110,957,1887,2021-01-12 11:29:16
1918,84,3,1247,162,1409,1888,2021-01-12 17:32:45
1919,875,3,747,97,844,1889,2021-01-12 15:29:46
1920,776,3,697,90,787,1890,2021-01-12 06:49:04
1921,478,3,997,129,1126,1891,2021-01-12 13:19:25
1922,584,3,558,72,630,1892,2021-01-12 07:22:39
1923,388,2,698,90,788,1893,2021-01-11 23:54:53
1924,156,2,898,116,1014,1894,2021-01-11 16:48:09
1925,369,5,1556,202,1758,1895,2021-01-12 10:25:59
1926,475,3,1197,155,1352,1896,2021-01-12 01:18:07
1927,164,5,1516,197,1713,1897,2021-01-12 02:11:59
1928,743,6,1894,246,2140,1898,2021-01-11 20:05:30
1929,466,3,688,89,777,1899,2021-01-11 20:15:41
1930,331,3,578,75,653,1900,2021-01-12 02:44:00
1931,515,3,578,75,653,1901,2021-01-11 22:26:43
1932,505,5,1845,239,2084,1902,2021-01-11 19:59:33
1933,98,3,888,115,1003,1903,2021-01-11 19:52:41
1934,936,3,647,84,731,1904,2021-01-12 02:32:12
1935,628,3,897,116,1013,1905,2021-01-12 10:19:29
1936,377,2,498,64,562,1906,2021-01-12 07:14:53
1937,508,3,727,94,821,1907,2021-01-12 07:04:10
1938,225,3,1047,136,1183,1908,2021-01-12 05:19:44
1939,998,3,1247,162,1409,1909,2021-01-11 20:39:50
1940,378,3,428,55,483,1910,2021-01-11 06:41:13
1941,73,2,498,64,562,1911,2021-01-12 10:06:48
1942,683,5,1076,139,1215,1912,2021-01-12 13:14:43
1943,207,2,698,90,788,1913,2021-01-12 04:42:57
1944,31,3,558,72,630,1914,2021-01-13 00:29:12
1945,206,3,1197,155,1352,1915,2021-01-12 19:47:28
1946,128,3,1027,133,1160,1916,2021-01-12 17:16:41
1947,467,3,888,115,1003,1917,2021-01-12 03:07:22
1948,216,3,597,77,674,1918,2021-01-11 23:57:43
1949,10,3,897,116,1013,1919,2021-01-12 13:10:04
1950,675,6,1155,150,1305,1920,2021-01-12 20:01:45
1951,608,3,597,77,674,1921,2021-01-12 15:55:27
1952,784,3,578,75,653,1922,2021-01-12 08:03:01
1953,425,2,698,90,788,1923,2021-01-12 15:29:46
1954,618,1,599,77,676,1924,2021-01-12 09:18:57
1955,600,3,897,116,1013,1925,2021-01-12 01:11:30
1956,610,3,597,77,674,1926,2021-01-11 18:01:56
1957,610,3,597,77,674,1926,2021-01-11 18:01:56
1958,566,2,698,90,788,1927,2021-01-12 12:45:59
1959,402,4,1287,167,1454,1928,2021-01-12 03:33:52
1960,27,6,1725,224,1949,1929,2021-01-12 02:48:14
1961,608,2,598,77,675,1930,2021-01-11 21:30:04
1962,893,1,499,64,563,1931,2021-01-11 21:12:40
1963,22,3,997,129,1126,1932,2021-01-12 03:58:35
1964,196,2,398,51,449,1933,2021-01-11 23:07:38
1965,998,5,1695,220,1915,1934,2021-01-11 20:17:34
1966,342,3,697,90,787,1935,2021-01-11 20:56:46
1967,649,3,758,98,856,1936,2021-01-12 02:54:08
1968,915,2,898,116,1014,1937,2021-01-12 12:07:52
1969,382,2,429,55,484,1938,2021-01-12 09:04:13
1970,770,3,597,77,674,1939,2021-01-12 07:41:55
1971,80,3,888,115,1003,1940,2021-01-12 06:58:38
1972,81,3,647,84,731,1941,2021-01-11 22:27:57
1973,756,3,897,116,1013,1942,2021-01-11 08:17:58
1974,202,3,827,107,934,1943,2021-01-12 10:36:07
1975,326,1,399,51,450,1944,2021-01-12 13:41:12
1976,139,2,898,116,1014,1945,2021-01-12 05:59:31
1977,108,2,429,55,484,1946,2021-01-13 03:12:06
1978,486,2,898,116,1014,1947,2021-01-12 20:26:36
1979,88,3,697,90,787,1948,2021-01-12 17:40:25
1980,866,3,1327,172,1499,1949,2021-01-12 03:15:22
1981,200,2,1098,142,1240,1950,2021-01-12 00:03:47
1982,363,2,798,103,901,1951,2021-01-12 13:45:55
1983,335,3,758,98,856,1952,2021-01-12 21:16:03
1984,490,4,2026,263,2289,1953,2021-01-12 17:56:52
1985,364,2,659,85,744,1954,2021-01-12 09:41:43
1986,367,3,658,85,743,1955,2021-01-12 15:49:12
1987,250,2,329,42,371,1956,2021-01-12 10:36:29
1988,603,3,727,94,821,1957,2021-01-12 02:02:25
1989,348,3,608,79,687,1958,2021-01-11 20:40:35
1990,71,6,1944,252,2196,1959,2021-01-11 18:39:47
1991,313,2,1098,142,1240,1960,2021-01-12 13:19:45
1992,626,2,598,77,675,1961,2021-01-12 05:07:58
1993,735,5,1356,176,1532,1962,2021-01-12 05:00:08
1994,851,3,847,110,957,1963,2021-01-11 21:52:37
1995,658,2,848,110,958,1964,2021-01-11 22:55:54
1996,261,4,1046,135,1181,1965,2021-01-12 05:58:45
1997,461,3,1027,133,1160,1966,2021-01-12 01:42:30
1998,925,3,608,79,687,1967,2021-01-11 20:23:38
1999,758,2,659,85,744,1968,2021-01-11 22:54:50
2000,771,1,299,38,337,1969,2021-01-12 04:50:00
2001,235,3,997,129,1126,1970,2021-01-12 12:22:15
2002,11,3,597,77,674,1971,2021-01-12 09:27:52
2003,618,2,598,77,675,1972,2021-01-12 07:44:33
2004,237,3,747,97,844,1973,2021-01-12 08:18:33
2005,237,3,747,97,844,1973,2021-01-12 08:18:33
2006,137,3,1047,136,1183,1974,2021-01-12 00:04:08
2007,608,3,847,110,957,1975,2021-01-11 09:36:20
2008,308,4,1526,198,1724,1976,2021-01-12 12:01:04
2009,327,2,429,55,484,1977,2021-01-12 16:06:39
2010,488,2,828,107,935,1978,2021-01-12 07:06:36
2011,61,2,398,51,449,1979,2021-01-13 04:32:56
2012,321,3,927,120,1047,1980,2021-01-12 22:42:06
2013,105,3,827,107,934,1981,2021-01-12 19:37:42
2014,947,2,1098,142,1240,1982,2021-01-12 05:20:54
2015,673,5,1245,161,1406,1983,2021-01-12 00:38:10
2016,429,6,2015,261,2276,1984,2021-01-12 15:42:40
2017,798,3,478,62,540,1985,2021-01-12 21:49:47
2018,659,2,498,64,562,1986,2021-01-12 18:56:11
2019,847,5,1595,207,1802,1987,2021-01-12 11:02:33
2020,516,2,698,90,788,1988,2021-01-12 18:10:52
2021,908,2,898,116,1014,1989,2021-01-12 13:17:20
2022,738,2,898,116,1014,1990,2021-01-12 03:02:25
2023,629,3,688,89,777,1991,2021-01-11 21:03:12
2024,194,4,1496,194,1690,1992,2021-01-11 20:17:13
2025,488,5,1426,185,1611,1993,2021-01-12 13:50:10
2026,140,5,1656,215,1871,1994,2021-01-12 07:20:27
2027,207,3,888,115,1003,1995,2021-01-12 05:26:31
2028,652,2,628,81,709,1996,2021-01-12 00:01:53
2029,973,3,558,72,630,1997,2021-01-11 23:04:06
2030,297,4,927,120,1047,1998,2021-01-12 06:10:58
2031,930,2,1098,142,1240,1999,2021-01-12 02:01:08
2032,412,1,399,51,450,2000,2021-01-11 22:21:10
2033,617,3,997,129,1126,2001,2021-01-11 23:40:21
2034,384,3,727,94,821,2002,2021-01-12 07:21:04
2035,990,3,558,72,630,2003,2021-01-12 13:39:09
2036,990,3,558,72,630,2003,2021-01-12 13:39:09
2037,242,2,598,77,675,2004,2021-01-12 12:01:37
2038,54,2,1098,142,1240,2005,2021-01-12 08:36:40
2039,569,3,808,105,913,2006,2021-01-12 09:49:51
2040,386,2,498,64,562,2007,2021-01-12 09:07:27
2041,12,3,1397,181,1578,2008,2021-01-12 02:22:50
2042,632,2,698,90,788,2009,2021-01-11 11:47:12
2043,10,3,758,98,856,2010,2021-01-12 14:37:54
2044,883,3,658,85,743,2011,2021-01-12 16:26:40
2045,397,2,548,71,619,2012,2021-01-12 07:31:50
2046,621,3,797,103,900,2013,2021-01-13 07:08:34
2047,898,2,598,77,675,2014,2021-01-12 22:47:01
2048,482,1,99,12,111,2015,2021-01-12 20:53:09
2049,832,4,1426,185,1611,2016,2021-01-12 05:30:19
2050,366,3,897,116,1013,2017,2021-01-12 02:03:59
2051,289,2,598,77,675,2018,2021-01-12 16:08:53
2052,875,4,877,114,991,2019,2021-01-12 22:53:07
2053,125,2,598,77,675,2020,2021-01-12 19:22:37
2054,921,3,528,68,596,2021,2021-01-12 12:00:15
2055,133,2,598,77,675,2022,2021-01-12 20:51:43
2056,75,3,1197,155,1352,2023,2021-01-12 15:42:58
2057,415,4,846,109,955,2024,2021-01-12 05:21:16
2058,882,6,1815,235,2050,2025,2021-01-11 21:45:58
2059,518,3,808,105,913,2026,2021-01-11 22:59:59
2060,738,3,1027,133,1160,2027,2021-01-12 15:10:33
2061,276,2,459,59,518,2028,2021-01-12 09:52:35
2062,944,3,697,90,787,2029,2021-01-12 07:18:21
2063,774,3,428,55,483,2030,2021-01-12 02:03:52
2064,385,3,747,97,844,2031,2021-01-11 23:37:17
2065,501,2,1098,142,1240,2032,2021-01-12 08:26:49
2066,682,3,1197,155,1352,2033,2021-01-12 02:13:44
2067,78,3,688,89,777,2034,2021-01-11 23:14:44
2068,303,3,1327,172,1499,2035,2021-01-12 01:53:59
2069,954,2,698,90,788,2036,2021-01-12 08:53:25
2070,965,3,1047,136,1183,2037,2021-01-12 15:27:44
2071,176,3,997,129,1126,2038,2021-01-12 15:45:19
2072,231,3,747,97,844,2039,2021-01-12 13:05:36
2073,245,3,758,98,856,2040,2021-01-12 08:44:23
2074,646,3,827,107,934,2041,2021-01-12 10:15:45
2075,146,5,1895,246,2141,2042,2021-01-12 10:25:55
2076,771,3,827,107,934,2043,2021-01-12 04:27:51
2077,552,3,1197,155,1352,2044,2021-01-11 13:23:12
2078,533,3,1047,136,1183,2045,2021-01-12 16:20:00
2079,347,2,798,103,901,2046,2021-01-12 16:36:55
2080,782,2,598,77,675,2047,2021-01-12 09:14:59
2081,828,3,608,79,687,2048,2021-01-13 07:47:37
2082,99,3,808,105,913,2049,2021-01-12 23:24:46
2083,273,6,1705,221,1926,2050,2021-01-12 21:04:11
2084,269,2,448,58,506,2051,2021-01-12 05:59:20
2085,352,3,827,107,934,2052,2021-01-12 04:29:21
2086,358,5,1245,161,1406,2053,2021-01-12 16:40:59
2087,139,2,459,59,518,2054,2021-01-12 23:16:04
2088,527,3,528,68,596,2055,2021-01-12 21:31:54
2089,807,5,1845,239,2084,2056,2021-01-12 14:14:32
2090,306,3,758,98,856,2057,2021-01-12 22:50:20
2091,281,2,898,116,1014,2058,2021-01-12 16:20:30
2092,916,2,698,90,788,2059,2021-01-12 08:07:26
2093,788,3,697,90,787,2060,2021-01-11 23:26:31
2094,228,3,888,115,1003,2061,2021-01-12 01:45:29
2095,246,3,897,116,1013,2062,2021-01-12 15:50:38
2096,995,2,498,64,562,2063,2021-01-12 11:11:56
2097,146,2,429,55,484,2064,2021-01-12 09:59:27
2098,125,2,598,77,675,2065,2021-01-12 03:05:16
2099,138,2,528,68,596,2066,2021-01-12 00:04:03
2100,679,3,747,97,844,2067,2021-01-12 09:19:13
2101,18,3,997,129,1126,2068,2021-01-12 03:52:38
2102,105,3,997,129,1126,2069,2021-01-12 01:51:45
2103,900,2,898,116,1014,2070,2021-01-12 03:45:31
2104,64,5,1795,233,2028,2071,2021-01-12 09:03:11
2105,855,3,558,72,630,2072,2021-01-12 17:24:51
2106,249,5,1925,250,2175,2073,2021-01-12 17:43:52
2107,767,3,578,75,653,2074,2021-01-12 15:11:12
2108,406,2,659,85,744,2075,2021-01-12 11:23:04
2109,925,5,1845,239,2084,2076,2021-01-12 11:14:59
2110,655,2,798,103,901,2077,2021-01-12 13:08:39
2111,14,5,1525,198,1723,2078,2021-01-12 06:46:31
2112,501,2,1098,142,1240,2079,2021-01-11 14:20:03
2113,651,5,1706,221,1927,2080,2021-01-12 17:08:13
2114,787,3,558,72,630,2081,2021-01-12 17:34:19
2115,145,2,598,77,675,2082,2021-01-12 11:17:55
2116,912,3,727,94,821,2083,2021-01-13 10:07:59
2117,952,2,798,103,901,2084,2021-01-13 01:29:23
2118,308,5,1745,226,1971,2085,2021-01-12 23:38:21
2119,546,3,747,97,844,2086,2021-01-12 06:04:30
2120,159,3,827,107,934,2087,2021-01-12 04:49:42
2121,567,3,647,84,731,2088,2021-01-12 18:21:45
2122,604,2,798,103,901,2089,2021-01-13 01:59:17
2123,239,2,628,81,709,2090,2021-01-12 22:46:19
2124,723,2,898,116,1014,2091,2021-01-12 15:27:06
2125,518,3,897,116,1013,2092,2021-01-13 01:06:57
2126,315,2,798,103,901,2093,2021-01-12 18:43:44
2127,789,3,1047,136,1183,2094,2021-01-12 08:30:06
2128,641,3,1127,146,1273,2095,2021-01-12 01:31:44
2129,834,3,558,72,630,2096,2021-01-12 02:14:30
2130,352,5,1426,185,1611,2097,2021-01-12 17:15:46
2131,935,3,697,90,787,2098,2021-01-12 11:27:49
2132,616,3,1047,136,1183,2099,2021-01-12 11:17:38
2133,972,3,558,72,630,2100,2021-01-12 03:40:54
2134,148,2,329,42,371,2101,2021-01-12 00:37:45
2135,815,4,1646,213,1859,2102,2021-01-12 09:59:22
2136,815,4,1646,213,1859,2102,2021-01-12 09:59:22
2137,564,3,897,116,1013,2103,2021-01-12 05:36:19
2138,24,2,898,116,1014,2104,2021-01-12 02:45:14
2139,54,2,1098,142,1240,2105,2021-01-12 06:14:52
2140,546,4,1096,142,1238,2106,2021-01-12 11:19:54
2141,600,3,947,123,1070,2107,2021-01-12 19:05:09
2142,918,3,927,120,1047,2108,2021-01-12 19:11:49
2143,236,3,827,107,934,2109,2021-01-12 15:24:11
2144,113,3,647,84,731,2110,2021-01-12 11:45:15
2145,359,2,598,77,675,2111,2021-01-12 13:04:52
2146,45,3,578,75,653,2112,2021-01-12 14:55:00
2147,720,3,647,84,731,2113,2021-01-12 08:58:07
2148,552,2,698,90,788,2114,2021-01-11 14:21:37
2149,205,5,1275,165,1440,2115,2021-01-12 18:16:54
2150,225,2,398,51,449,2116,2021-01-12 19:44:58
2151,915,3,597,77,674,2117,2021-01-12 13:09:00
2152,421,3,827,107,934,2118,2021-01-13 10:19:58
2153,992,3,558,72,630,2119,2021-01-13 04:04:04
2154,313,3,428,55,483,2120,2021-01-13 00:24:41
2155,557,3,608,79,687,2121,2021-01-12 06:55:45
2156,341,3,1047,136,1183,2122,2021-01-12 04:57:28
2157,568,3,558,72,630,2123,2021-01-12 18:50:35
2158,246,3,747,97,844,2124,2021-01-13 04:42:53
2159,920,3,647,84,731,2125,2021-01-12 22:59:29
2160,814,2,1098,142,1240,2126,2021-01-12 16:07:26
2161,646,2,898,116,1014,2127,2021-01-13 03:38:02
2162,889,3,1327,172,1499,2128,2021-01-12 19:45:54
2163,379,2,898,116,1014,2129,2021-01-12 09:54:35
2164,199,3,688,89,777,2130,2021-01-12 03:28:57
2165,734,2,659,85,744,2131,2021-01-12 03:58:31
2166,208,3,1197,155,1352,2132,2021-01-12 18:37:15
2167,417,3,697,90,787,2133,2021-01-12 14:09:54
2168,128,5,2225,289,2514,2134,2021-01-12 13:37:47
2169,377,3,758,98,856,2135,2021-01-12 04:07:58
2170,878,5,1576,204,1780,2136,2021-01-12 02:17:27
2171,167,3,688,89,777,2137,2021-01-12 12:21:21
2172,516,2,598,77,675,2138,2021-01-12 10:32:33
2173,63,3,808,105,913,2139,2021-01-12 06:24:20
2174,14,3,827,107,934,2140,2021-01-12 03:25:49
2175,397,2,598,77,675,2141,2021-01-12 06:15:58
2176,927,2,598,77,675,2142,2021-01-12 13:48:13
2177,507,3,747,97,844,2143,2021-01-12 21:31:14
2178,182,3,1047,136,1183,2144,2021-01-12 21:28:20
2179,790,3,947,123,1070,2145,2021-01-12 17:01:45
2180,925,2,329,42,371,2146,2021-01-12 13:22:09
2181,626,2,798,103,901,2147,2021-01-12 14:12:53
2182,603,6,1754,228,1982,2148,2021-01-12 17:08:00
2183,976,6,1805,234,2039,2149,2021-01-12 09:19:09
2184,853,2,898,116,1014,2150,2021-01-11 16:17:22
2185,676,2,429,55,484,2151,2021-01-12 18:45:15
2186,846,2,329,42,371,2152,2021-01-12 20:09:06
2187,262,3,947,123,1070,2153,2021-01-12 14:03:53
2188,589,4,1087,141,1228,2154,2021-01-13 12:20:40
2189,770,3,847,110,957,2155,2021-01-13 04:35:12
2190,133,3,747,97,844,2156,2021-01-13 00:55:48
2191,133,3,747,97,844,2156,2021-01-13 00:55:48
2192,486,3,658,85,743,2157,2021-01-12 07:41:24
2193,705,3,827,107,934,2158,2021-01-12 06:32:36
2194,138,3,1047,136,1183,2159,2021-01-12 19:14:31
2195,419,3,758,98,856,2160,2021-01-13 06:48:50
2196,663,2,659,85,744,2161,2021-01-13 01:34:56
2197,615,1,299,38,337,2162,2021-01-12 17:39:35
2198,499,3,727,94,821,2163,2021-01-13 06:05:12
2199,141,3,758,98,856,2164,2021-01-12 20:37:43
2200,475,3,747,97,844,2165,2021-01-12 12:05:37
2201,31,3,847,110,957,2166,2021-01-12 03:50:13
2202,432,3,897,116,1013,2167,2021-01-12 06:16:08
2203,190,3,1027,133,1160,2168,2021-01-12 19:41:22
2204,287,4,876,113,989,2169,2021-01-12 16:14:04
2205,827,4,1507,195,1702,2170,2021-01-12 16:22:14
2206,86,5,1476,191,1667,2171,2021-01-12 05:33:20
2207,164,3,528,68,596,2172,2021-01-12 03:37:38
2208,232,3,947,123,1070,2173,2021-01-12 13:30:45
2209,655,2,898,116,1014,2174,2021-01-12 11:21:32
2210,727,5,1445,187,1632,2175,2021-01-12 06:37:06
2211,908,2,898,116,1014,2176,2021-01-12 03:26:47
2212,886,2,498,64,562,2177,2021-01-12 07:10:39
2213,861,6,1424,185,1609,2178,2021-01-12 15:59:44
2214,50,2,598,77,675,2179,2021-01-12 22:17:48
2215,997,5,1906,247,2153,2180,2021-01-12 21:58:45
2216,995,3,688,89,777,2181,2021-01-12 19:31:13
2217,119,3,758,98,856,2182,2021-01-12 14:42:20
2218,803,2,798,103,901,2183,2021-01-12 15:02:27
2219,791,2,898,116,1014,2184,2021-01-12 18:52:22
2220,735,5,1176,152,1328,2185,2021-01-12 10:43:27
2221,453,3,727,94,821,2186,2021-01-11 16:33:12
2222,336,1,299,38,337,2187,2021-01-12 19:59:25
2223,566,3,997,129,1126,2188,2021-01-12 22:20:20
2224,131,3,847,110,957,2189,2021-01-12 16:20:04
2225,347,3,528,68,596,2190,2021-01-13 13:08:42
2226,214,3,1247,162,1409,2191,2021-01-13 05:10:32
2227,0,2,429,55,484,2192,2021-01-13 00:55:48
2228,835,3,888,115,1003,2193,2021-01-13 03:34:42
2229,926,5,1545,200,1745,2194,2021-01-12 09:31:28
2230,1,1,399,51,450,2195,2021-01-12 08:53:37
2231,521,2,648,84,732,2196,2021-01-12 21:22:50
2232,258,3,1247,162,1409,2197,2021-01-13 08:47:59
2233,197,2,628,81,709,2198,2021-01-13 03:22:37
2234,865,3,1327,172,1499,2199,2021-01-12 20:02:01
2235,356,2,498,64,562,2200,2021-01-13 08:18:38
2236,848,3,558,72,630,2201,2021-01-12 20:48:45
2237,485,3,1027,133,1160,2202,2021-01-12 12:09:20
2238,267,3,528,68,596,2203,2021-01-12 04:57:30
2239,163,5,1725,224,1949,2204,2021-01-12 08:17:03
2240,819,3,808,105,913,2205,2021-01-12 20:01:29
2241,529,2,429,55,484,2206,2021-01-12 18:21:24
2242,270,6,1605,208,1813,2207,2021-01-12 17:39:28
2243,28,2,498,64,562,2208,2021-01-12 06:29:19
2244,496,5,1495,194,1689,2209,2021-01-12 05:24:55
2245,556,3,888,115,1003,2210,2021-01-12 14:53:14
2246,433,3,888,115,1003,2211,2021-01-12 13:36:32
2247,438,2,659,85,744,2212,2021-01-12 08:13:33
2248,1,3,428,55,483,2213,2021-01-12 04:09:44
2249,278,3,688,89,777,2214,2021-01-12 07:47:48
2250,529,2,659,85,744,2215,2021-01-12 16:09:29
2251,812,5,1195,155,1350,2216,2021-01-12 22:57:21
2252,200,3,697,90,787,2217,2021-01-12 22:42:31
2253,851,3,428,55,483,2218,2021-01-12 22:05:38
2254,782,3,528,68,596,2219,2021-01-12 16:19:57
2255,808,2,598,77,675,2220,2021-01-12 16:17:37
2256,64,2,848,110,958,2221,2021-01-12 21:22:42
2257,691,5,1217,158,1375,2222,2021-01-12 11:34:17
2258,285,2,659,85,744,2223,2021-01-11 19:11:51
2259,135,3,697,90,787,2224,2021-01-12 20:49:33
2260,498,2,329,42,371,2225,2021-01-13 00:54:24
2261,323,2,329,42,371,2226,2021-01-12 19:00:58
2262,451,2,598,77,675,2227,2021-01-13 13:40:21
2263,677,3,1047,136,1183,2228,2021-01-13 07:26:05
2264,953,6,1974,256,2230,2229,2021-01-13 01:56:19
2265,689,3,747,97,844,2230,2021-01-13 05:09:45
2266,656,3,1047,136,1183,2231,2021-01-12 11:35:12
2267,658,3,558,72,630,2232,2021-01-12 10:31:20
2268,761,3,578,75,653,2233,2021-01-12 21:24:58
2269,370,3,1127,146,1273,2234,2021-01-13 10:54:57
2270,212,5,1245,161,1406,2235,2021-01-13 06:00:14
2271,287,5,1276,165,1441,2236,2021-01-12 20:13:31
2272,170,2,598,77,675,2237,2021-01-13 10:45:52
2273,58,2,1098,142,1240,2238,2021-01-12 21:49:16
2274,742,4,1346,174,1520,2239,2021-01-12 13:11:20
2275,553,2,598,77,675,2240,2021-01-12 07:02:09
2276,863,5,1545,200,1745,2241,2021-01-12 09:40:14
2277,551,3,647,84,731,2242,2021-01-12 20:22:27
2278,187,2,798,103,901,2243,2021-01-12 20:02:53
2279,516,4,1107,143,1250,2244,2021-01-12 18:00:26
2280,976,3,947,123,1070,2245,2021-01-12 08:50:16
2281,815,4,857,111,968,2246,2021-01-12 05:46:04
2282,223,4,1207,156,1363,2247,2021-01-12 16:25:08
2283,211,1,99,12,111,2248,2021-01-12 16:02:14
2284,246,2,928,120,1048,2249,2021-01-12 10:39:58
2285,623,3,827,107,934,2250,2021-01-12 06:53:43
2286,65,2,659,85,744,2251,2021-01-12 08:07:38
2287,817,3,897,116,1013,2252,2021-01-12 18:29:52
2288,962,3,1047,136,1183,2253,2021-01-13 00:19:03
2289,879,5,1795,233,2028,2254,2021-01-12 23:59:01
2290,874,3,578,75,653,2255,2021-01-12 22:28:23
2291,239,3,997,129,1126,2256,2021-01-12 18:33:18
2292,110,6,1125,146,1271,2257,2021-01-12 16:44:24
2293,967,3,1127,146,1273,2258,2021-01-12 21:56:37
2294,223,2,798,103,901,2259,2021-01-12 14:13:02
2295,329,6,2005,260,2265,2260,2021-01-11 19:19:24
2296,688,4,1157,150,1307,2261,2021-01-12 21:20:20
2297,31,2,928,120,1048,2262,2021-01-13 00:56:41
2298,881,2,659,85,744,2263,2021-01-12 21:24:07
2299,227,3,578,75,653,2264,2021-01-13 15:04:46
2300,759,2,698,90,788,2265,2021-01-13 07:59:20
2301,207,3,1047,136,1183,2266,2021-01-13 03:12:27
2302,430,3,827,107,934,2267,2021-01-13 06:29:53
2303,931,1,229,29,258,2268,2021-01-12 12:41:55
2304,249,1,149,19,168,2269,2021-01-12 11:09:42
2305,397,4,1226,159,1385,2270,2021-01-12 23:05:02
2306,673,3,428,55,483,2271,2021-01-13 13:41:34
2307,255,2,798,103,901,2272,2021-01-13 08:12:15
2308,220,3,888,115,1003,2273,2021-01-12 21:19:13
2309,14,3,747,97,844,2274,2021-01-13 11:16:36
2310,416,5,2145,278,2423,2275,2021-01-12 23:50:15
2311,713,2,459,59,518,2276,2021-01-12 14:02:48
2312,88,3,847,110,957,2277,2021-01-12 07:22:15
2313,390,3,727,94,821,2278,2021-01-12 11:39:28
2314,925,3,888,115,1003,2279,2021-01-12 22:25:11
2315,992,3,608,79,687,2280,2021-01-12 20:25:29
2316,245,3,558,72,630,2281,2021-01-12 18:21:26
2317,453,3,658,85,743,2282,2021-01-12 09:34:54
2318,756,2,548,71,619,2283,2021-01-12 06:24:46
2319,121,2,798,103,901,2284,2021-01-12 17:52:42
2320,643,5,1145,148,1293,2285,2021-01-12 16:22:33
2321,204,3,428,55,483,2286,2021-01-12 10:58:50
2322,272,6,1585,206,1791,2287,2021-01-12 07:24:02
2323,99,2,498,64,562,2288,2021-01-12 09:28:09
2324,99,2,498,64,562,2288,2021-01-12 09:28:09
2325,822,4,1526,198,1724,2289,2021-01-12 20:57:02
2326,67,3,428,55,483,2290,2021-01-13 02:22:23
2327,239,3,758,98,856,2291,2021-01-13 01:36:47
2328,715,2,898,116,1014,2292,2021-01-13 00:33:03
2329,971,3,997,129,1126,2293,2021-01-12 21:12:50
2330,457,3,797,103,900,2294,2021-01-12 19:30:06
2331,228,2,598,77,675,2295,2021-01-13 00:38:32
2332,162,5,1955,254,2209,2296,2021-01-12 14:33:30
2333,46,3,927,120,1047,2297,2021-01-11 19:42:10
2334,141,2,429,55,484,2298,2021-01-13 00:00:21
2335,58,3,847,110,957,2299,2021-01-13 03:21:15
2336,473,5,1495,194,1689,2300,2021-01-12 22:03:41
2337,113,3,888,115,1003,2301,2021-01-13 16:52:38
2338,339,3,658,85,743,2302,2021-01-13 08:14:23
2339,221,3,658,85,743,2303,2021-01-13 05:30:53
2340,879,3,558,72,630,2304,2021-01-13 07:22:38
2341,859,1,99,12,111,2305,2021-01-12 14:17:03
2342,540,2,698,90,788,2306,2021-01-12 13:43:34
2343,956,6,1444,187,1631,2307,2021-01-13 01:51:20
2344,462,3,688,89,777,2308,2021-01-13 14:23:39
2345,880,3,797,103,900,2309,2021-01-13 09:38:57
2346,888,3,1047,136,1183,2310,2021-01-12 21:51:18
2347,374,1,99,12,111,2311,2021-01-13 13:52:34
2348,782,3,947,123,1070,2312,2021-01-13 01:13:07
2349,569,3,997,129,1126,2313,2021-01-12 15:56:16
2350,495,5,1276,165,1441,2314,2021-01-12 09:45:07
2351,829,3,697,90,787,2315,2021-01-12 14:13:04
2352,829,3,697,90,787,2315,2021-01-12 14:13:04
2353,487,3,808,105,913,2316,2021-01-12 22:59:34
2354,950,3,927,120,1047,2317,2021-01-12 22:08:54
2355,970,2,1098,142,1240,2318,2021-01-12 20:53:05
2356,506,6,1824,237,2061,2319,2021-01-12 09:36:16
2357,282,2,598,77,675,2320,2021-01-12 08:43:21
2358,729,3,997,129,1126,2321,2021-01-12 19:50:31
2359,766,2,429,55,484,2322,2021-01-12 18:14:16
2360,796,3,827,107,934,2323,2021-01-12 13:09:39
2361,136,3,697,90,787,2324,2021-01-12 07:25:33
2362,391,1,229,29,258,2325,2021-01-12 11:23:06
2363,906,5,1645,213,1858,2326,2021-01-12 10:59:41
2364,459,2,329,42,371,2327,2021-01-12 22:08:17
2365,422,3,897,116,1013,2328,2021-01-13 04:31:53
2366,290,3,1327,172,1499,2329,2021-01-13 03:49:47
2367,321,3,747,97,844,2330,2021-01-13 00:52:58
2368,738,2,898,116,1014,2331,2021-01-12 23:11:53
2369,344,2,598,77,675,2332,2021-01-12 20:38:03
2370,190,5,1586,206,1792,2333,2021-01-13 02:16:25
2371,486,2,598,77,675,2334,2021-01-12 14:58:56
2372,378,3,1047,136,1183,2335,2021-01-11 21:17:19
2373,239,2,1098,142,1240,2336,2021-01-13 00:19:16
2374,818,3,688,89,777,2337,2021-01-13 05:30:57
2375,896,3,1047,136,1183,2338,2021-01-12 23:43:18
2376,133,2,898,116,1014,2339,2021-01-13 17:14:49
2377,399,3,478,62,540,2340,2021-01-13 09:16:16
2378,355,3,428,55,483,2341,2021-01-13 06:39:56
2379,866,3,1197,155,1352,2342,2021-01-13 09:40:09
2380,546,3,1197,155,1352,2343,2021-01-12 16:05:08
2381,859,5,1895,246,2141,2344,2021-01-12 14:50:35
2382,817,3,897,116,1013,2345,2021-01-13 02:10:54
2383,190,3,478,62,540,2346,2021-01-13 14:43:33
2384,333,3,688,89,777,2347,2021-01-13 10:07:03
2385,908,3,1327,172,1499,2348,2021-01-12 22:54:56
2386,592,3,1247,162,1409,2349,2021-01-13 15:47:30
2387,669,2,459,59,518,2350,2021-01-13 03:27:22
2388,653,1,399,51,450,2351,2021-01-12 16:16:46
2389,776,5,1326,172,1498,2352,2021-01-12 11:21:30
2390,183,2,748,97,845,2353,2021-01-12 16:02:23
2391,847,5,1675,217,1892,2354,2021-01-12 16:22:50
2392,648,2,898,116,1014,2355,2021-01-13 01:45:55
2393,966,3,1127,146,1273,2356,2021-01-13 00:32:17
2394,371,6,1505,195,1700,2357,2021-01-12 23:16:48
2395,173,3,847,110,957,2358,2021-01-12 10:53:34
2396,171,3,927,120,1047,2359,2021-01-12 10:27:32
2397,305,3,747,97,844,2360,2021-01-12 21:23:03
2398,437,4,996,129,1125,2361,2021-01-12 20:03:20
2399,662,2,398,51,449,2362,2021-01-12 13:52:59
2400,162,2,898,116,1014,2363,2021-01-12 09:31:12
2401,120,3,1327,172,1499,2364,2021-01-12 13:57:23
2402,620,2,498,64,562,2365,2021-01-12 12:42:22
2403,819,2,498,64,562,2366,2021-01-13 00:50:03
2404,185,2,598,77,675,2367,2021-01-13 07:16:14
2405,980,6,1166,151,1317,2368,2021-01-13 06:17:57
2406,677,3,578,75,653,2369,2021-01-13 02:25:13
2407,515,3,827,107,934,2370,2021-01-12 23:32:08
2408,837,3,1247,162,1409,2371,2021-01-12 21:07:09
2409,812,3,597,77,674,2372,2021-01-13 02:30:11
2410,674,3,888,115,1003,2373,2021-01-12 16:07:49
2411,559,2,329,42,371,2374,2021-01-11 23:07:22
2412,383,3,947,123,1070,2375,2021-01-13 02:58:44
2413,44,3,1127,146,1273,2376,2021-01-13 08:06:30
2414,655,2,329,42,371,2377,2021-01-13 02:27:58
2415,457,2,459,59,518,2378,2021-01-13 18:27:50
2416,467,3,747,97,844,2379,2021-01-13 10:00:23
2417,730,2,598,77,675,2380,2021-01-13 08:16:17
2418,488,1,499,64,563,2381,2021-01-13 10:42:23
2419,453,2,659,85,744,2382,2021-01-12 16:07:58
2420,642,3,688,89,777,2383,2021-01-12 15:20:33
2421,210,3,597,77,674,2384,2021-01-13 04:11:54
2422,747,3,758,98,856,2385,2021-01-13 16:57:13
2423,498,2,659,85,744,2386,2021-01-13 11:31:08
2424,700,2,798,103,901,2387,2021-01-12 23:05:30
2425,634,3,597,77,674,2388,2021-01-13 17:55:17
2426,886,3,747,97,844,2389,2021-01-13 04:31:02
2427,73,4,1646,213,1859,2390,2021-01-12 17:34:23
2428,674,3,558,72,630,2391,2021-01-12 13:49:18
2429,221,3,1197,155,1352,2392,2021-01-12 17:18:43
2430,418,2,329,42,371,2393,2021-01-12 17:54:56
2431,3,2,798,103,901,2394,2021-01-13 02:47:49
2432,699,1,399,51,450,2395,2021-01-13 01:58:52
2433,652,3,747,97,844,2396,2021-01-13 01:56:15
2434,901,5,1595,207,1802,2397,2021-01-12 11:09:20
2435,255,1,399,51,450,2398,2021-01-12 11:42:07
2436,16,3,747,97,844,2399,2021-01-12 21:32:47
2437,328,6,1724,224,1948,2400,2021-01-12 22:44:27
2438,433,3,1197,155,1352,2401,2021-01-12 15:59:56
2439,475,3,927,120,1047,2402,2021-01-12 11:59:54
2440,584,2,459,59,518,2403,2021-01-12 15:06:42
2441,472,2,498,64,562,2404,2021-01-12 12:55:22
2442,686,5,1256,163,1419,2405,2021-01-13 03:00:07
2443,743,2,659,85,744,2406,2021-01-13 08:37:12
2444,5,3,578,75,653,2407,2021-01-13 07:39:14
2445,897,2,598,77,675,2408,2021-01-13 04:56:08
2446,212,3,797,103,900,2409,2021-01-12 23:32:58
2447,912,2,598,77,675,2410,2021-01-12 22:55:16
2448,250,3,1047,136,1183,2411,2021-01-13 04:37:58
2449,747,3,688,89,777,2412,2021-01-12 17:59:04
2450,323,4,1276,165,1441,2413,2021-01-12 01:16:29
2451,108,2,429,55,484,2414,2021-01-13 03:23:54
2452,441,3,558,72,630,2415,2021-01-13 08:49:11
2453,789,4,1396,181,1577,2416,2021-01-13 03:22:13
2454,440,6,1894,246,2140,2417,2021-01-13 21:05:24
2455,1,4,1427,185,1612,2418,2021-01-13 11:19:04
2456,736,3,688,89,777,2419,2021-01-13 11:01:38
2457,290,3,1027,133,1160,2420,2021-01-13 11:16:05
2458,518,3,688,89,777,2421,2021-01-12 16:23:55
2459,538,2,698,90,788,2422,2021-01-12 15:28:34
2460,362,6,1555,202,1757,2423,2021-01-13 05:16:36
2461,358,3,578,75,653,2424,2021-01-13 17:44:05
2462,994,3,1197,155,1352,2425,2021-01-13 13:18:14
2463,435,2,498,64,562,2426,2021-01-13 01:35:22
2464,863,3,608,79,687,2427,2021-01-13 20:17:30
2465,76,2,659,85,744,2428,2021-01-13 05:20:06
2466,512,2,659,85,744,2429,2021-01-12 19:28:14
2467,712,3,1047,136,1183,2430,2021-01-12 14:14:54
2468,834,3,647,84,731,2431,2021-01-12 19:56:18
2469,119,3,888,115,1003,2432,2021-01-12 19:56:58
2470,56,3,747,97,844,2433,2021-01-13 03:01:10
2471,439,3,697,90,787,2434,2021-01-13 02:54:57
2472,569,5,1495,194,1689,2435,2021-01-13 02:44:41
2473,725,3,647,84,731,2436,2021-01-12 11:29:27
2474,133,3,697,90,787,2437,2021-01-12 14:01:14
2475,78,3,997,129,1126,2438,2021-01-12 22:46:57
2476,539,4,1127,146,1273,2439,2021-01-12 23:04:44
2477,315,3,997,129,1126,2440,2021-01-12 18:34:39
2478,315,3,997,129,1126,2440,2021-01-12 18:34:39
2479,304,2,429,55,484,2441,2021-01-12 13:38:18
2480,713,2,448,58,506,2442,2021-01-12 17:47:32
2481,494,5,1525,198,1723,2443,2021-01-12 15:26:28
2482,656,3,827,107,934,2444,2021-01-13 03:25:23
2483,831,5,1645,213,1858,2445,2021-01-13 10:49:08
2484,779,1,99,12,111,2446,2021-01-13 09:03:18
2485,895,2,798,103,901,2447,2021-01-13 05:15:41
2486,285,3,1247,162,1409,2448,2021-01-12 23:37:11
2487,282,6,1954,254,2208,2449,2021-01-13 00:05:35
2488,96,3,608,79,687,2450,2021-01-13 05:30:09
2489,362,2,798,103,901,2451,2021-01-12 19:21:36
2490,692,5,1226,159,1385,2452,2021-01-12 01:34:54
2491,489,3,697,90,787,2453,2021-01-13 05:07:29
2492,352,2,798,103,901,2454,2021-01-13 08:56:03
2493,600,3,747,97,844,2455,2021-01-13 04:17:34
2494,263,2,1098,142,1240,2456,2021-01-13 21:29:40
2495,77,3,1197,155,1352,2457,2021-01-13 11:28:18
2496,95,3,647,84,731,2458,2021-01-13 13:08:04
2497,542,2,898,116,1014,2459,2021-01-13 12:39:35
2498,811,2,598,77,675,2460,2021-01-12 18:39:28
2499,974,2,698,90,788,2461,2021-01-12 18:08:47
2500,715,3,1027,133,1160,2462,2021-01-13 07:19:29
2501,506,2,459,59,518,2463,2021-01-13 18:20:05
2502,108,3,1127,146,1273,2464,2021-01-13 14:29:36
2503,795,2,798,103,901,2465,2021-01-13 04:11:40
2504,804,6,1355,176,1531,2466,2021-01-13 21:38:44
2505,934,6,1644,213,1857,2467,2021-01-13 06:33:20
2506,387,2,329,42,371,2468,2021-01-12 21:51:25
2507,550,3,428,55,483,2469,2021-01-12 16:55:23
2508,820,3,578,75,653,2470,2021-01-12 22:39:28
2509,395,5,1395,181,1576,2471,2021-01-12 20:48:31
2510,147,3,827,107,934,2472,2021-01-13 03:39:08
2511,645,3,688,89,777,2473,2021-01-13 02:59:58
2512,475,6,1255,163,1418,2474,2021-01-13 04:44:59
2513,768,3,1047,136,1183,2475,2021-01-12 13:41:36
2514,524,3,1327,172,1499,2476,2021-01-12 16:14:08
2515,346,3,658,85,743,2477,2021-01-13 00:13:16
2516,802,3,1197,155,1352,2478,2021-01-13 01:32:35
2517,111,5,1516,197,1713,2479,2021-01-12 18:54:38
2518,585,1,299,38,337,2480,2021-01-12 21:17:27
2519,637,6,1444,187,1631,2481,2021-01-12 14:42:45
2520,322,2,898,116,1014,2482,2021-01-12 19:59:01
2521,243,3,947,123,1070,2483,2021-01-12 18:09:21
2522,168,5,1095,142,1237,2484,2021-01-13 05:48:57
2523,380,5,1595,207,1802,2485,2021-01-13 10:54:37
2524,479,3,1327,172,1499,2486,2021-01-13 10:39:13
2525,364,6,1554,202,1756,2487,2021-01-13 07:46:07
2526,327,3,827,107,934,2488,2021-01-13 00:41:35
2527,28,4,1596,207,1803,2489,2021-01-13 00:20:05
2528,979,3,727,94,821,2490,2021-01-13 07:31:28
2529,310,2,1098,142,1240,2491,2021-01-12 20:58:25
2530,604,3,758,98,856,2492,2021-01-12 02:16:15
2531,83,3,727,94,821,2493,2021-01-13 05:41:41
2532,794,1,699,90,789,2494,2021-01-13 11:30:58
2533,695,1,149,19,168,2495,2021-01-13 06:46:41
2534,307,6,1924,250,2174,2496,2021-01-14 00:15:10
2535,255,3,747,97,844,2497,2021-01-13 12:57:06
2536,291,3,1327,172,1499,2498,2021-01-13 14:21:43
2537,39,2,798,103,901,2499,2021-01-13 13:23:38
2538,783,3,797,103,900,2500,2021-01-12 19:05:18
2539,553,3,697,90,787,2501,2021-01-12 19:22:47
2540,763,1,149,19,168,2502,2021-01-13 07:25:46
2541,364,2,698,90,788,2503,2021-01-13 18:20:23
2542,643,3,1247,162,1409,2504,2021-01-13 15:30:16
2543,875,2,598,77,675,2505,2021-01-13 04:11:50
2544,895,5,1656,215,1871,2506,2021-01-13 23:49:11
2545,29,3,997,129,1126,2507,2021-01-13 06:33:42
2546,415,3,747,97,844,2508,2021-01-12 23:02:50
2547,230,3,1197,155,1352,2509,2021-01-12 17:00:15
2548,701,2,798,103,901,2510,2021-01-12 23:58:09
2549,65,2,598,77,675,2511,2021-01-12 21:02:03
2550,171,3,558,72,630,2512,2021-01-13 04:44:28
2551,178,2,598,77,675,2513,2021-01-13 05:31:33
2552,508,2,898,116,1014,2514,2021-01-13 05:16:55
2553,699,2,598,77,675,2515,2021-01-12 14:07:28
2554,36,3,608,79,687,2516,2021-01-12 18:00:43
2555,855,2,459,59,518,2517,2021-01-13 00:52:23
2556,877,5,1325,172,1497,2518,2021-01-13 01:58:37
2557,468,3,1127,146,1273,2519,2021-01-12 20:28:36
2558,856,3,428,55,483,2520,2021-01-12 22:01:01
2559,313,3,847,110,957,2521,2021-01-12 17:15:35
2560,713,3,758,98,856,2522,2021-01-12 20:39:10
2561,432,3,888,115,1003,2523,2021-01-12 18:36:03
2562,587,6,2144,278,2422,2524,2021-01-13 06:52:08
2563,638,5,1156,150,1306,2525,2021-01-13 11:15:35
2564,70,3,827,107,934,2526,2021-01-13 13:11:42
2565,525,3,558,72,630,2527,2021-01-13 09:30:52
2566,381,3,658,85,743,2528,2021-01-13 01:27:30
2567,395,3,1247,162,1409,2529,2021-01-13 01:24:06
2568,387,3,1327,172,1499,2530,2021-01-13 07:41:46
2569,963,3,1127,146,1273,2531,2021-01-12 22:01:06
2570,760,6,2135,277,2412,2532,2021-01-12 02:35:09
2571,5,2,648,84,732,2533,2021-01-13 05:56:17
2572,958,3,758,98,856,2534,2021-01-13 12:03:13
2573,714,4,1287,167,1454,2535,2021-01-13 08:22:48
2574,671,2,598,77,675,2536,2021-01-14 01:23:26
2575,733,4,1196,155,1351,2537,2021-01-13 13:34:25
2576,922,3,827,107,934,2538,2021-01-13 16:48:40
2577,256,2,798,103,901,2539,2021-01-13 14:47:47
2578,517,4,1246,161,1407,2540,2021-01-12 19:08:38
2579,952,2,798,103,901,2541,2021-01-12 19:41:46
2580,536,3,1127,146,1273,2542,2021-01-13 09:49:43
2581,888,3,847,110,957,2543,2021-01-13 20:26:44
2582,886,3,827,107,934,2544,2021-01-13 15:41:05
2583,248,2,898,116,1014,2545,2021-01-13 04:42:08
2584,533,3,847,110,957,2546,2021-01-14 01:09:15
2585,338,3,597,77,674,2547,2021-01-13 09:18:41
2586,845,3,997,129,1126,2548,2021-01-12 23:33:32
2587,23,2,429,55,484,2549,2021-01-12 17:05:07
2588,764,2,848,110,958,2550,2021-01-13 02:29:05
2589,408,3,1197,155,1352,2551,2021-01-12 21:13:08
2590,934,2,528,68,596,2552,2021-01-13 06:11:50
2591,473,2,329,42,371,2553,2021-01-13 06:53:12
2592,288,3,1327,172,1499,2554,2021-01-13 07:58:56
2593,81,3,797,103,900,2555,2021-01-12 14:38:54
2594,296,4,1426,185,1611,2556,2021-01-12 18:12:29
2595,659,3,827,107,934,2557,2021-01-13 01:09:29
2596,477,3,428,55,483,2558,2021-01-13 03:08:28
2597,312,3,578,75,653,2559,2021-01-12 21:43:56
2598,451,3,1047,136,1183,2560,2021-01-12 23:21:41
2599,292,4,1946,252,2198,2561,2021-01-12 17:36:18
2600,515,3,747,97,844,2562,2021-01-12 20:46:28
2601,247,3,827,107,934,2563,2021-01-12 19:14:17
2602,702,3,927,120,1047,2564,2021-01-13 09:07:27
2603,463,2,548,71,619,2565,2021-01-13 12:27:03
2604,403,3,727,94,821,2566,2021-01-13 15:42:21
2605,705,3,727,94,821,2567,2021-01-13 10:11:03
2606,461,2,329,42,371,2568,2021-01-13 02:20:57
2607,568,2,329,42,371,2569,2021-01-13 04:04:38
2608,426,3,558,72,630,2570,2021-01-13 09:35:34
2609,716,2,698,90,788,2571,2021-01-12 23:17:13
2610,928,2,528,68,596,2572,2021-01-12 03:35:02
2611,552,6,1794,233,2027,2573,2021-01-13 08:36:36
2612,94,3,697,90,787,2574,2021-01-13 14:10:05
2613,94,3,697,90,787,2574,2021-01-13 14:10:05
2614,127,3,997,129,1126,2575,2021-01-13 09:28:53
2615,849,3,697,90,787,2576,2021-01-14 01:46:15
2616,813,2,598,77,675,2577,2021-01-13 14:59:34
2617,288,3,647,84,731,2578,2021-01-13 18:04:45
2618,733,3,997,129,1126,2579,2021-01-13 15:17:25
2619,619,3,827,107,934,2580,2021-01-12 19:16:19
2620,441,3,997,129,1126,2581,2021-01-12 21:08:46
2621,321,5,1295,168,1463,2582,2021-01-13 10:22:34
2622,652,3,1047,136,1183,2583,2021-01-13 21:53:11
2623,379,2,1098,142,1240,2584,2021-01-13 17:46:24
2624,193,3,997,129,1126,2585,2021-01-13 05:49:31
2625,984,5,1725,224,1949,2586,2021-01-14 01:23:36
2626,348,3,608,79,687,2587,2021-01-13 12:00:15
2627,175,2,329,42,371,2588,2021-01-13 00:08:43
2628,987,2,698,90,788,2589,2021-01-12 17:55:28
2629,618,3,808,105,913,2590,2021-01-13 03:29:11
2630,594,3,947,123,1070,2591,2021-01-12 23:34:33
2631,848,3,997,129,1126,2592,2021-01-13 07:26:11
2632,620,2,698,90,788,2593,2021-01-13 07:14:37
2633,350,3,947,123,1070,2594,2021-01-13 09:16:03
2634,449,3,658,85,743,2595,2021-01-12 15:13:12
2635,198,2,498,64,562,2596,2021-01-12 19:56:25
2636,154,4,1496,194,1690,2597,2021-01-13 01:28:15
2637,869,3,727,94,821,2598,2021-01-13 03:48:14
2638,108,2,848,110,958,2599,2021-01-12 22:11:11
2639,149,3,888,115,1003,2600,2021-01-13 00:16:23
2640,264,2,548,71,619,2601,2021-01-12 18:13:35
2641,770,3,827,107,934,2602,2021-01-12 20:48:53
2642,287,3,647,84,731,2603,2021-01-12 19:54:39
2643,728,2,898,116,1014,2604,2021-01-13 10:44:57
2644,283,3,797,103,900,2605,2021-01-13 14:52:36
2645,355,2,429,55,484,2606,2021-01-13 16:15:19
2646,428,3,1197,155,1352,2607,2021-01-13 10:45:48
2647,783,4,1426,185,1611,2608,2021-01-13 05:07:00
2648,13,3,747,97,844,2609,2021-01-13 04:47:52
2649,78,3,528,68,596,2610,2021-01-13 10:24:45
2650,937,3,747,97,844,2611,2021-01-13 00:41:06
2651,427,2,398,51,449,2612,2021-01-12 04:44:12
2652,574,3,1047,136,1183,2613,2021-01-13 09:43:15
2653,201,3,578,75,653,2614,2021-01-13 16:29:49
2654,870,3,478,62,540,2615,2021-01-13 16:07:11
2655,73,2,648,84,732,2616,2021-01-13 11:02:28
2656,962,3,808,105,913,2617,2021-01-14 02:52:00
2657,496,3,697,90,787,2618,2021-01-13 15:19:01
2658,645,5,1286,167,1453,2619,2021-01-13 18:27:22
2659,119,2,798,103,901,2620,2021-01-13 15:24:26
2660,443,3,947,123,1070,2621,2021-01-12 19:40:41
2661,171,3,608,79,687,2622,2021-01-12 22:21:07
2662,530,2,329,42,371,2623,2021-01-13 13:00:56
2663,71,3,997,129,1126,2624,2021-01-13 23:03:07
2664,203,2,1098,142,1240,2625,2021-01-13 19:25:33
2665,522,2,898,116,1014,2626,2021-01-13 07:30:15
2666,142,3,697,90,787,2627,2021-01-14 02:09:12
2667,735,2,798,103,901,2628,2021-01-13 12:07:12
2668,311,2,598,77,675,2629,2021-01-13 01:25:23
2669,928,5,1456,189,1645,2630,2021-01-12 18:06:28
2670,660,3,1027,133,1160,2631,2021-01-13 05:10:31
2671,660,3,1027,133,1160,2631,2021-01-13 05:10:31
2672,350,4,1496,194,1690,2632,2021-01-13 01:07:33
2673,648,3,947,123,1070,2633,2021-01-13 09:13:24
2674,35,3,428,55,483,2634,2021-01-13 09:53:17
2675,289,2,528,68,596,2635,2021-01-13 10:58:12
2676,750,2,598,77,675,2636,2021-01-12 17:03:22
2677,624,2,698,90,788,2637,2021-01-12 20:40:13
2678,537,3,608,79,687,2638,2021-01-13 01:59:02
2679,879,2,598,77,675,2639,2021-01-13 04:59:28
2680,499,2,628,81,709,2640,2021-01-12 22:50:25
2681,485,5,1356,176,1532,2641,2021-01-13 02:41:50
2682,597,5,1156,150,1306,2642,2021-01-12 20:56:28
2683,580,2,1098,142,1240,2643,2021-01-12 23:30:58
2684,756,1,399,51,450,2644,2021-01-12 21:07:46
2685,869,1,149,19,168,2645,2021-01-13 13:07:32
2686,96,2,1098,142,1240,2646,2021-01-13 16:08:23
2687,995,2,659,85,744,2647,2021-01-13 17:09:18
2688,676,1,599,77,676,2648,2021-01-13 13:25:52
2689,177,5,1375,178,1553,2649,2021-01-13 07:48:20
2690,712,3,688,89,777,2650,2021-01-13 06:50:29
2691,314,3,888,115,1003,2651,2021-01-13 12:02:49
2692,564,4,1346,174,1520,2652,2021-01-13 00:56:50
2693,655,2,598,77,675,2653,2021-01-12 05:43:30
2694,62,3,658,85,743,2654,2021-01-13 10:25:42
2695,493,3,1127,146,1273,2655,2021-01-13 17:18:20
2696,754,6,1524,198,1722,2656,2021-01-13 17:47:52
2697,741,6,1654,215,1869,2657,2021-01-13 13:18:17
2698,682,4,1357,176,1533,2658,2021-01-14 03:29:58
2699,871,4,1426,185,1611,2659,2021-01-13 16:36:49
2700,195,3,1047,136,1183,2660,2021-01-13 19:41:18
2701,891,3,1327,172,1499,2661,2021-01-13 17:48:46
2702,811,5,1245,161,1406,2662,2021-01-12 21:53:12
2703,131,3,428,55,483,2663,2021-01-12 23:50:02
2704,539,2,1098,142,1240,2664,2021-01-13 13:37:39
2705,822,1,99,12,111,2665,2021-01-14 00:02:47
2706,422,2,828,107,935,2666,2021-01-13 21:21:31
2707,751,2,548,71,619,2667,2021-01-13 08:51:40
2708,879,3,1247,162,1409,2668,2021-01-14 04:03:33
2709,791,2,698,90,788,2669,2021-01-13 13:26:53
2710,443,3,697,90,787,2670,2021-01-13 02:00:32
2711,672,3,1247,162,1409,2671,2021-01-12 19:00:41
2712,487,3,1047,136,1183,2672,2021-01-13 05:31:04
2713,175,2,429,55,484,2673,2021-01-13 05:15:41
2714,226,3,697,90,787,2674,2021-01-13 01:44:32
2715,958,2,798,103,901,2675,2021-01-13 11:10:19
2716,823,3,688,89,777,2676,2021-01-13 10:00:02
2717,250,5,1355,176,1531,2677,2021-01-13 11:56:35
2718,853,3,658,85,743,2678,2021-01-12 18:00:26
2719,63,3,808,105,913,2679,2021-01-12 22:52:39
2720,533,2,1098,142,1240,2680,2021-01-13 02:12:42
2721,766,2,329,42,371,2681,2021-01-13 07:06:25
2722,151,1,699,90,789,2682,2021-01-12 23:55:17
2723,509,2,598,77,675,2683,2021-01-13 03:59:43
2724,583,2,498,64,562,2684,2021-01-12 22:02:13
2725,405,4,1426,185,1611,2685,2021-01-13 01:43:48
2726,523,3,1127,146,1273,2686,2021-01-12 22:51:21
2727,423,2,798,103,901,2687,2021-01-13 14:19:47
2728,250,6,1944,252,2196,2688,2021-01-13 17:51:53
2729,392,2,659,85,744,2689,2021-01-13 19:34:08
2730,258,3,1197,155,1352,2690,2021-01-13 15:48:54
2731,697,3,1127,146,1273,2691,2021-01-13 09:39:30
2732,783,2,459,59,518,2692,2021-01-13 07:16:15
2733,516,2,498,64,562,2693,2021-01-13 12:13:25
2734,591,3,1247,162,1409,2694,2021-01-13 01:22:21
2735,679,2,898,116,1014,2695,2021-01-12 05:44:55
2736,624,3,888,115,1003,2696,2021-01-13 10:40:16
2737,290,3,1127,146,1273,2697,2021-01-13 19:49:55
2738,813,2,659,85,744,2698,2021-01-13 19:54:09
2739,813,2,659,85,744,2698,2021-01-13 19:54:09
2740,584,3,558,72,630,2699,2021-01-13 15:03:31
2741,129,3,827,107,934,2700,2021-01-14 04:09:24
2742,725,5,1026,133,1159,2701,2021-01-13 17:42:41
2743,589,2,698,90,788,2702,2021-01-13 21:39:10
2744,454,3,428,55,483,2703,2021-01-13 20:03:59
2745,57,3,1197,155,1352,2704,2021-01-12 23:15:10
2746,495,3,1027,133,1160,2705,2021-01-13 01:25:44
2747,683,6,1955,254,2209,2706,2021-01-13 15:55:58
2748,981,4,1226,159,1385,2707,2021-01-14 02:18:31
2749,465,5,1745,226,1971,2708,2021-01-13 21:41:47
2750,461,3,697,90,787,2709,2021-01-13 10:58:03
2751,778,3,997,129,1126,2710,2021-01-14 05:59:06
2752,814,4,1257,163,1420,2711,2021-01-13 13:57:36
2753,421,3,697,90,787,2712,2021-01-13 04:22:37
2754,917,2,659,85,744,2713,2021-01-12 19:11:46
2755,115,3,688,89,777,2714,2021-01-13 06:28:56
2756,952,2,798,103,901,2715,2021-01-13 05:27:19
2757,637,2,429,55,484,2716,2021-01-13 03:55:53
2758,758,5,1945,252,2197,2717,2021-01-13 13:55:06
2759,158,5,1195,155,1350,2718,2021-01-13 10:58:39
2760,925,2,698,90,788,2719,2021-01-13 12:01:29
2761,777,1,149,19,168,2720,2021-01-12 18:02:33
2762,216,3,927,120,1047,2721,2021-01-12 23:31:25
2763,47,3,827,107,934,2722,2021-01-13 02:47:41
2764,379,5,1276,165,1441,2723,2021-01-13 07:21:21
2765,826,2,698,90,788,2724,2021-01-13 00:27:57
2766,872,2,598,77,675,2725,2021-01-13 05:40:32
2767,770,2,429,55,484,2726,2021-01-13 00:02:49
2768,391,3,608,79,687,2727,2021-01-13 02:37:21
2769,622,2,798,103,901,2728,2021-01-12 23:03:40
2770,411,3,897,116,1013,2729,2021-01-13 14:57:20
2771,225,1,699,90,789,2730,2021-01-13 19:11:58
2772,378,2,898,116,1014,2731,2021-01-13 21:45:13
2773,462,3,727,94,821,2732,2021-01-13 16:24:02
2774,795,1,149,19,168,2733,2021-01-13 09:49:10
2775,63,3,847,110,957,2734,2021-01-13 08:53:31
2776,298,4,1157,150,1307,2735,2021-01-13 14:09:06
2777,169,3,1327,172,1499,2736,2021-01-13 01:46:20
2778,31,2,548,71,619,2737,2021-01-12 07:50:52
2779,224,3,558,72,630,2738,2021-01-13 12:39:46
2780,415,2,329,42,371,2739,2021-01-13 20:05:47
2781,747,2,329,42,371,2740,2021-01-13 21:00:51
2782,447,2,798,103,901,2741,2021-01-13 22:32:24
2783,275,3,997,129,1126,2742,2021-01-13 16:08:07
2784,784,5,1206,156,1362,2743,2021-01-14 05:26:46
2785,456,3,697,90,787,2744,2021-01-13 18:01:44
2786,360,5,2425,315,2740,2745,2021-01-13 22:59:24
2787,71,2,459,59,518,2746,2021-01-13 21:23:46
2788,589,3,827,107,934,2747,2021-01-13 01:35:09
2789,960,3,428,55,483,2748,2021-01-13 02:12:52
2790,347,2,598,77,675,2749,2021-01-13 17:33:25
2791,778,3,827,107,934,2750,2021-01-14 05:01:22
2792,334,3,997,129,1126,2751,2021-01-13 22:34:01
2793,232,1,229,29,258,2752,2021-01-13 11:52:44
2794,839,2,459,59,518,2753,2021-01-14 06:42:13
2795,270,1,99,12,111,2754,2021-01-13 14:08:41
2796,20,5,2095,272,2367,2755,2021-01-13 05:23:19
2797,325,2,429,55,484,2756,2021-01-12 20:06:13
2798,514,2,329,42,371,2757,2021-01-13 07:10:59
2799,352,3,1047,136,1183,2758,2021-01-13 05:36:00
2800,920,3,578,75,653,2759,2021-01-13 06:34:36
2801,920,3,578,75,653,2759,2021-01-13 06:34:36
2802,673,3,997,129,1126,2760,2021-01-13 15:20:11
2803,293,3,997,129,1126,2761,2021-01-13 13:39:43
2804,205,3,558,72,630,2762,2021-01-13 13:13:25
2805,391,3,997,129,1126,2763,2021-01-12 18:15:55
2806,353,3,558,72,630,2764,2021-01-13 00:40:09
2807,548,2,598,77,675,2765,2021-01-13 04:41:59
2808,93,3,697,90,787,2766,2021-01-13 08:58:06
2809,635,3,758,98,856,2767,2021-01-13 01:29:52
2810,105,2,459,59,518,2768,2021-01-13 07:08:04
2811,230,3,688,89,777,2769,2021-01-13 01:22:03
2812,957,3,597,77,674,2770,2021-01-13 02:57:01
2813,201,3,847,110,957,2771,2021-01-13 01:05:22
2814,595,2,329,42,371,2772,2021-01-13 15:39:46
2815,385,3,727,94,821,2773,2021-01-13 19:26:49
2816,829,2,898,116,1014,2774,2021-01-13 22:44:33
2817,859,2,928,120,1048,2775,2021-01-13 16:43:17
2818,852,4,1196,155,1351,2776,2021-01-13 12:08:31
2819,802,3,747,97,844,2777,2021-01-13 11:37:21
2820,569,2,848,110,958,2778,2021-01-13 14:13:27
2821,922,2,798,103,901,2779,2021-01-13 03:46:28
2822,26,2,659,85,744,2780,2021-01-12 10:28:37
2823,501,3,1127,146,1273,2781,2021-01-13 14:42:50
2824,832,3,997,129,1126,2782,2021-01-13 21:43:35
2825,722,3,1327,172,1499,2783,2021-01-13 23:44:02
2826,604,2,329,42,371,2784,2021-01-13 23:17:40
2827,939,5,1575,204,1779,2785,2021-01-13 16:27:37
2828,305,1,399,51,450,2786,2021-01-14 06:06:33
2829,624,5,1456,189,1645,2787,2021-01-13 18:55:04
2830,64,2,498,64,562,2788,2021-01-13 23:20:36
2831,312,3,827,107,934,2789,2021-01-13 21:31:09
2832,670,2,748,97,845,2790,2021-01-13 02:57:46
2833,528,3,428,55,483,2791,2021-01-13 04:24:23
2834,602,3,927,120,1047,2792,2021-01-13 18:13:57
2835,100,2,659,85,744,2793,2021-01-14 07:21:31
2836,903,3,727,94,821,2794,2021-01-14 00:38:33
2837,121,2,548,71,619,2795,2021-01-13 14:07:03
2838,718,2,598,77,675,2796,2021-01-14 07:22:18
2839,327,3,697,90,787,2797,2021-01-13 14:56:58
2840,85,4,1287,167,1454,2798,2021-01-13 06:29:29
2841,242,3,1247,162,1409,2799,2021-01-12 22:19:15
2842,261,3,997,129,1126,2800,2021-01-13 09:34:41
2843,362,3,1247,162,1409,2801,2021-01-13 06:56:47
2844,835,2,659,85,744,2802,2021-01-13 07:24:23
2845,776,5,2225,289,2514,2803,2021-01-13 07:48:31
2846,510,5,1825,237,2062,2804,2021-01-13 16:50:02
2847,671,3,747,97,844,2805,2021-01-13 13:51:37
2848,894,1,99,12,111,2806,2021-01-13 15:24:09
2849,821,4,977,127,1104,2807,2021-01-12 20:57:42
2850,915,3,727,94,821,2808,2021-01-13 02:52:12
2851,738,3,1247,162,1409,2809,2021-01-13 05:50:07
2852,564,2,548,71,619,2810,2021-01-13 10:00:31
2853,242,2,398,51,449,2811,2021-01-13 03:34:46
2854,840,3,658,85,743,2812,2021-01-13 07:16:17
2855,710,3,697,90,787,2813,2021-01-13 02:19:41
2856,783,3,658,85,743,2814,2021-01-13 03:48:23
2857,898,3,1197,155,1352,2815,2021-01-13 02:01:33
2858,15,3,758,98,856,2816,2021-01-13 17:35:13
2859,138,3,1327,172,1499,2817,2021-01-13 21:06:23
2860,698,2,598,77,675,2818,2021-01-13 23:49:54
2861,304,2,898,116,1014,2819,2021-01-13 19:09:04
2862,464,2,659,85,744,2820,2021-01-13 12:29:54
2863,494,3,697,90,787,2821,2021-01-13 13:17:47
2864,569,3,697,90,787,2822,2021-01-13 14:26:26
2865,767,3,847,110,957,2823,2021-01-13 05:32:27
2866,329,1,99,12,111,2824,2021-01-12 10:38:53
2867,426,3,927,120,1047,2825,2021-01-13 16:03:35
2868,776,3,558,72,630,2826,2021-01-14 00:22:28
2869,12,2,329,42,371,2827,2021-01-14 00:30:30
2870,741,1,399,51,450,2828,2021-01-14 00:20:57
2871,23,2,1098,142,1240,2829,2021-01-13 18:26:21
2872,537,3,1197,155,1352,2830,2021-01-14 06:29:29
2873,627,3,758,98,856,2831,2021-01-13 21:12:55
2874,526,2,598,77,675,2832,2021-01-14 00:00:16
2875,827,5,1756,228,1984,2833,2021-01-13 23:49:02
2876,275,3,997,129,1126,2834,2021-01-13 03:06:20
2877,118,3,827,107,934,2835,2021-01-13 04:35:59
2878,157,3,1127,146,1273,2836,2021-01-13 20:14:51
2879,474,4,1396,181,1577,2837,2021-01-14 09:50:38
2880,465,3,1027,133,1160,2838,2021-01-14 01:53:54
2881,809,3,727,94,821,2839,2021-01-13 14:38:50
2882,879,2,1098,142,1240,2840,2021-01-14 07:28:30
2883,424,2,429,55,484,2841,2021-01-13 16:58:13
2884,132,2,498,64,562,2842,2021-01-13 06:30:00
2885,224,5,1325,172,1497,2843,2021-01-13 00:15:38
2886,251,3,997,129,1126,2844,2021-01-13 09:58:29
2887,856,5,1356,176,1532,2845,2021-01-13 09:04:12
2888,156,3,727,94,821,2846,2021-01-13 09:17:47
2889,584,6,1205,156,1361,2847,2021-01-13 08:48:13
2890,576,2,548,71,619,2848,2021-01-13 16:59:29
2891,388,4,1007,130,1137,2849,2021-01-13 16:10:14
2892,621,3,608,79,687,2850,2021-01-13 17:29:07
2893,656,3,1127,146,1273,2851,2021-01-12 22:50:16
2894,39,3,688,89,777,2852,2021-01-13 05:16:13
2895,102,3,1127,146,1273,2853,2021-01-13 06:06:50
2896,556,2,1098,142,1240,2854,2021-01-13 11:56:48
2897,770,3,528,68,596,2855,2021-01-13 03:53:11
2898,405,6,1405,182,1587,2856,2021-01-13 09:12:56
2899,511,3,747,97,844,2857,2021-01-13 03:19:57
2900,432,3,827,107,934,2858,2021-01-13 04:00:36
2901,770,2,598,77,675,2859,2021-01-13 02:41:38
2902,729,2,498,64,562,2860,2021-01-13 19:14:09
2903,729,2,498,64,562,2860,2021-01-13 19:14:09
2904,318,6,1394,181,1575,2861,2021-01-13 21:43:17
2905,806,2,429,55,484,2862,2021-01-14 00:51:03
2906,227,3,947,123,1070,2863,2021-01-13 21:12:48
2907,421,2,459,59,518,2864,2021-01-13 13:02:13
2908,33,2,598,77,675,2865,2021-01-13 14:45:09
2909,274,3,797,103,900,2866,2021-01-13 14:56:27
2910,518,2,1098,142,1240,2867,2021-01-13 07:18:12
2911,694,2,728,94,822,2868,2021-01-12 12:52:46
2912,691,3,897,116,1013,2869,2021-01-13 18:28:57
2913,53,3,747,97,844,2870,2021-01-14 02:38:37
2914,599,2,398,51,449,2871,2021-01-14 01:30:20
2915,416,6,1425,185,1610,2872,2021-01-14 03:05:58
2916,878,3,747,97,844,2873,2021-01-13 19:53:51
2917,298,2,898,116,1014,2874,2021-01-14 08:24:39
2918,404,3,1197,155,1352,2875,2021-01-13 23:10:56
2919,673,3,578,75,653,2876,2021-01-14 02:25:42
2920,406,3,528,68,596,2877,2021-01-14 01:51:50
2921,832,3,797,103,900,2878,2021-01-13 03:58:41
2922,154,3,658,85,743,2879,2021-01-13 06:00:16
2923,99,3,1127,146,1273,2880,2021-01-13 20:27:13
2924,676,2,898,116,1014,2881,2021-01-14 11:30:55
2925,76,2,398,51,449,2882,2021-01-14 02:42:54
2926,338,3,428,55,483,2883,2021-01-13 16:09:51
2927,629,3,1127,146,1273,2884,2021-01-14 08:17:07
2928,298,5,1895,246,2141,2885,2021-01-13 17:19:21
2929,524,2,659,85,744,2886,2021-01-13 07:25:17
2930,133,2,798,103,901,2887,2021-01-13 01:16:45
2931,927,1,399,51,450,2888,2021-01-13 11:56:55
2932,442,3,697,90,787,2889,2021-01-13 09:54:17
2933,850,3,1127,146,1273,2890,2021-01-13 11:13:40
2934,242,3,847,110,957,2891,2021-01-13 11:23:51
2935,405,3,1027,133,1160,2892,2021-01-13 18:29:43
2936,965,2,798,103,901,2893,2021-01-13 16:29:44
2937,610,5,1595,207,1802,2894,2021-01-13 19:59:32
2938,905,4,1057,137,1194,2895,2021-01-13 00:45:12
2939,302,2,798,103,901,2896,2021-01-13 06:24:36
2940,154,2,798,103,901,2897,2021-01-13 07:07:36
2941,258,3,697,90,787,2898,2021-01-13 13:22:30
2942,376,3,578,75,653,2899,2021-01-13 06:35:40
2943,849,2,429,55,484,2900,2021-01-13 10:40:52
2944,202,3,758,98,856,2901,2021-01-13 04:59:45
2945,241,5,1536,199,1735,2902,2021-01-13 05:58:27
2946,854,6,1444,187,1631,2903,2021-01-13 03:29:24
2947,967,2,848,110,958,2904,2021-01-13 19:15:25
2948,939,2,1098,142,1240,2905,2021-01-13 21:23:16
2949,491,5,1706,221,1927,2906,2021-01-13 23:31:20
2950,457,3,558,72,630,2907,2021-01-14 01:51:48
2951,146,3,1047,136,1183,2908,2021-01-13 22:47:24
2952,231,3,1247,162,1409,2909,2021-01-13 13:54:35
2953,359,3,1327,172,1499,2910,2021-01-13 14:53:22
2954,333,6,1324,172,1496,2911,2021-01-13 15:06:58
2955,615,5,1545,200,1745,2912,2021-01-13 09:42:44
2956,477,2,498,64,562,2913,2021-01-12 14:48:13
2957,113,1,149,19,168,2914,2021-01-13 20:26:02
2958,561,5,1486,193,1679,2915,2021-01-14 04:19:11
2959,897,2,329,42,371,2916,2021-01-14 01:57:12
2960,154,3,947,123,1070,2917,2021-01-14 03:51:09
2961,23,3,997,129,1126,2918,2021-01-13 20:48:58
2962,705,3,697,90,787,2919,2021-01-14 10:17:32
2963,966,2,1098,142,1240,2920,2021-01-13 23:19:52
2964,698,3,947,123,1070,2921,2021-01-14 02:45:20
2965,528,3,1327,172,1499,2922,2021-01-14 04:09:06
2966,222,3,1127,146,1273,2923,2021-01-13 06:18:53
2967,961,3,727,94,821,2924,2021-01-13 06:40:39
2968,627,2,429,55,484,2925,2021-01-13 21:22:02
2969,713,3,727,94,821,2926,2021-01-14 13:28:44
2970,335,2,329,42,371,2927,2021-01-14 03:52:55
2971,508,3,658,85,743,2928,2021-01-13 17:07:59
2972,691,3,597,77,674,2929,2021-01-14 10:28:54
2973,96,3,558,72,630,2930,2021-01-13 17:41:01
2974,352,1,99,12,111,2931,2021-01-13 10:07:48
2975,211,4,707,91,798,2932,2021-01-13 03:18:32
2976,558,3,608,79,687,2933,2021-01-13 12:01:37
2977,721,3,827,107,934,2934,2021-01-13 11:05:02
2978,198,3,927,120,1047,2935,2021-01-13 11:21:42
2979,77,2,329,42,371,2936,2021-01-13 13:56:51
2980,395,3,897,116,1013,2937,2021-01-13 18:33:37
2981,662,2,848,110,958,2938,2021-01-13 17:10:27
2982,884,3,808,105,913,2939,2021-01-13 20:54:52
2983,550,1,149,19,168,2940,2021-01-13 01:07:18
2984,448,3,997,129,1126,2941,2021-01-13 07:55:06
2985,4,2,498,64,562,2942,2021-01-13 09:16:08
2986,55,2,698,90,788,2943,2021-01-13 13:40:59
2987,110,3,1327,172,1499,2944,2021-01-13 07:44:56
2988,762,2,898,116,1014,2945,2021-01-13 12:15:50
2989,323,3,747,97,844,2946,2021-01-13 05:19:55
2990,40,2,698,90,788,2947,2021-01-13 06:20:57
2991,798,3,758,98,856,2948,2021-01-13 05:11:59
2992,117,3,1197,155,1352,2949,2021-01-13 21:36:09
2993,117,3,1197,155,1352,2949,2021-01-13 21:36:09
2994,722,5,1126,146,1272,2950,2021-01-13 21:56:20
2995,647,6,1815,235,2050,2951,2021-01-14 01:37:44
2996,622,3,597,77,674,2952,2021-01-14 02:14:03
2997,717,2,498,64,562,2953,2021-01-14 01:28:32
2998,92,2,1098,142,1240,2954,2021-01-13 15:06:55
2999,620,6,2154,280,2434,2955,2021-01-13 16:56:38
3000,411,2,748,97,845,2956,2021-01-13 15:07:01
3001,535,3,747,97,844,2957,2021-01-13 12:16:07
3002,657,5,1745,226,1971,2958,2021-01-12 15:59:21
3003,507,2,898,116,1014,2959,2021-01-13 22:01:56
3004,602,2,1098,142,1240,2960,2021-01-14 07:02:13
3005,340,3,1047,136,1183,2961,2021-01-14 02:26:48
3006,621,3,647,84,731,2962,2021-01-14 04:06:17
3007,760,3,888,115,1003,2963,2021-01-13 23:00:15
3008,131,3,1047,136,1183,2964,2021-01-14 10:44:39
3009,834,3,758,98,856,2965,2021-01-14 01:11:12
3010,958,2,698,90,788,2966,2021-01-14 04:18:29
3011,983,3,558,72,630,2967,2021-01-14 05:03:10
3012,693,2,429,55,484,2968,2021-01-13 08:43:54
3013,445,1,99,12,111,2969,2021-01-13 08:27:20
3014,266,3,747,97,844,2970,2021-01-13 23:59:57
3015,430,6,1935,251,2186,2971,2021-01-14 14:45:59
3016,775,3,658,85,743,2972,2021-01-14 04:20:00
3017,78,3,727,94,821,2973,2021-01-13 18:25:50
3018,145,3,947,123,1070,2974,2021-01-14 10:40:11
3019,970,3,927,120,1047,2975,2021-01-13 20:17:57
3020,198,3,578,75,653,2976,2021-01-13 11:36:25
3021,776,2,398,51,449,2977,2021-01-13 05:45:34
3022,819,3,428,55,483,2978,2021-01-13 13:55:37
3023,367,4,1826,237,2063,2979,2021-01-13 11:56:39
3024,253,3,897,116,1013,2980,2021-01-13 12:34:23
3025,90,2,448,58,506,2981,2021-01-13 14:58:44
3026,458,3,647,84,731,2982,2021-01-13 21:17:57
3027,998,3,1027,133,1160,2983,2021-01-13 18:23:12
3028,585,3,888,115,1003,2984,2021-01-13 23:41:14
3029,804,2,459,59,518,2985,2021-01-13 02:24:02
3030,904,3,1127,146,1273,2986,2021-01-13 09:56:51
3031,279,3,808,105,913,2987,2021-01-13 09:27:23
3032,624,2,1098,142,1240,2988,2021-01-13 13:50:34
3033,28,5,1525,198,1723,2989,2021-01-13 08:37:03
3034,427,5,1425,185,1610,2990,2021-01-13 12:17:51
3035,251,5,1656,215,1871,2991,2021-01-13 06:45:41
3036,122,3,1247,162,1409,2992,2021-01-13 08:39:14
3037,660,2,429,55,484,2993,2021-01-13 07:06:00
3038,193,2,598,77,675,2994,2021-01-13 23:03:28
3039,565,2,548,71,619,2995,2021-01-13 22:11:36
3040,75,6,1136,147,1283,2996,2021-01-13 22:49:19
3041,951,3,808,105,913,2997,2021-01-14 03:02:52
3042,363,2,329,42,371,2998,2021-01-14 02:48:43
3043,371,2,698,90,788,2999,2021-01-14 01:28:42
3044,749,3,827,107,934,3000,2021-01-13 15:12:59
3045,14,4,1096,142,1238,3001,2021-01-13 18:18:39
3046,478,2,628,81,709,3002,2021-01-13 15:52:04
3047,165,2,798,103,901,3003,2021-01-13 14:05:57
3048,701,3,647,84,731,3004,2021-01-12 17:50:44
3049,163,5,1256,163,1419,3005,2021-01-14 00:36:02
3050,338,3,808,105,913,3006,2021-01-14 08:45:43
3051,962,5,1326,172,1498,3007,2021-01-14 03:22:00
3052,207,2,598,77,675,3008,2021-01-14 04:52:46
3053,509,4,927,120,1047,3009,2021-01-13 23:16:21
3054,425,2,659,85,744,3010,2021-01-14 11:59:59
3055,595,5,1276,165,1441,3011,2021-01-14 02:45:35
3056,271,2,548,71,619,3012,2021-01-14 05:27:35
3057,527,3,1247,162,1409,3013,2021-01-14 06:40:29
3058,351,4,1226,159,1385,3014,2021-01-13 10:14:56
3059,218,3,1047,136,1183,3015,2021-01-13 10:43:53
3060,382,3,758,98,856,3016,2021-01-14 01:48:17
3061,473,2,598,77,675,3017,2021-01-14 16:02:20
3062,927,3,827,107,934,3018,2021-01-14 06:02:47
3063,474,3,578,75,653,3019,2021-01-13 18:42:46
3064,674,3,758,98,856,3020,2021-01-14 13:22:13
3065,674,3,758,98,856,3020,2021-01-14 13:22:13
3066,187,5,1825,237,2062,3021,2021-01-13 22:32:10
3067,485,3,747,97,844,3022,2021-01-13 13:47:51
3068,107,6,1885,245,2130,3023,2021-01-13 07:34:15
3069,107,6,1885,245,2130,3023,2021-01-13 07:34:15
3070,157,3,558,72,630,3024,2021-01-13 16:34:53
3071,162,3,827,107,934,3025,2021-01-13 14:39:04
3072,137,3,697,90,787,3026,2021-01-13 13:12:27
3073,695,2,598,77,675,3027,2021-01-13 15:45:38
3074,794,2,798,103,901,3028,2021-01-13 22:15:55
3075,723,6,1844,239,2083,3029,2021-01-13 20:36:22
3076,828,3,558,72,630,3030,2021-01-14 00:48:28
3077,894,3,827,107,934,3031,2021-01-13 03:08:26
3078,785,2,459,59,518,3032,2021-01-13 12:04:17
3079,136,4,1226,159,1385,3033,2021-01-13 10:57:24
3080,273,2,459,59,518,3034,2021-01-13 15:37:42
3081,519,3,997,129,1126,3035,2021-01-13 08:43:17
3082,626,3,528,68,596,3036,2021-01-13 14:26:50
3083,723,2,329,42,371,3037,2021-01-13 07:53:10
3084,399,3,688,89,777,3038,2021-01-13 09:29:29
3085,564,5,1516,197,1713,3039,2021-01-13 07:16:04
3086,223,5,2025,263,2288,3040,2021-01-13 23:28:41
3087,115,3,658,85,743,3041,2021-01-13 23:31:04
3088,975,6,1615,209,1824,3042,2021-01-14 00:59:29
3089,528,1,499,64,563,3043,2021-01-14 04:00:40
3090,719,2,698,90,788,3044,2021-01-14 02:49:46
3091,906,3,647,84,731,3045,2021-01-14 04:12:17
3092,362,3,997,129,1126,3046,2021-01-13 16:22:29
3093,651,1,149,19,168,3047,2021-01-13 19:53:26
3094,361,2,429,55,484,3048,2021-01-13 17:24:11
3095,783,3,608,79,687,3049,2021-01-13 15:25:04
3096,679,3,758,98,856,3050,2021-01-12 19:29:13
3097,809,5,1756,228,1984,3051,2021-01-14 01:04:06
3098,415,2,898,116,1014,3052,2021-01-14 09:19:16
3099,145,3,827,107,934,3053,2021-01-14 03:33:34
3100,607,3,808,105,913,3054,2021-01-14 07:24:54
3101,779,3,888,115,1003,3055,2021-01-14 00:26:20
3102,837,3,1127,146,1273,3056,2021-01-14 13:39:49
3103,883,5,1906,247,2153,3057,2021-01-14 03:24:44
3104,440,3,1027,133,1160,3058,2021-01-14 06:31:10
3105,528,2,598,77,675,3059,2021-01-14 08:21:49
3106,789,3,1127,146,1273,3060,2021-01-13 11:56:07
3107,566,3,478,62,540,3061,2021-01-13 13:18:51
3108,406,2,698,90,788,3062,2021-01-14 04:01:32
3109,440,5,987,128,1115,3063,2021-01-14 16:10:06
3110,123,2,1098,142,1240,3064,2021-01-14 08:47:44
3111,727,2,648,84,732,3065,2021-01-13 20:52:40
3112,443,3,808,105,913,3066,2021-01-14 14:43:24
3113,253,3,597,77,674,3067,2021-01-14 14:18:03
3114,97,3,747,97,844,3068,2021-01-13 23:52:57
3115,998,2,898,116,1014,3069,2021-01-13 15:49:06
3116,665,3,558,72,630,3070,2021-01-13 09:32:57
3117,220,3,1027,133,1160,3071,2021-01-13 09:35:24
3118,811,2,498,64,562,3072,2021-01-13 17:08:08
3119,813,2,498,64,562,3073,2021-01-13 17:20:13
3120,422,2,798,103,901,3074,2021-01-13 14:21:59
3121,13,4,1096,142,1238,3075,2021-01-13 17:56:04
3122,517,3,1027,133,1160,3076,2021-01-14 00:11:39
3123,111,3,1027,133,1160,3077,2021-01-13 20:52:00
3124,239,2,1098,142,1240,3078,2021-01-14 01:52:06
3125,392,5,1595,207,1802,3079,2021-01-13 03:59:58
3126,493,3,797,103,900,3080,2021-01-13 12:31:16
3127,536,2,659,85,744,3081,2021-01-13 11:03:35
3128,477,3,1197,155,1352,3082,2021-01-13 16:36:47
3129,949,2,598,77,675,3083,2021-01-13 11:24:01
3130,584,3,897,116,1013,3084,2021-01-13 16:46:14
3131,686,3,747,97,844,3085,2021-01-13 08:02:28
3132,288,2,598,77,675,3086,2021-01-13 10:53:19
3133,849,1,229,29,258,3087,2021-01-13 07:42:59
3134,777,3,758,98,856,3088,2021-01-14 00:00:39
3135,975,2,798,103,901,3089,2021-01-14 01:29:57
3136,412,2,1098,142,1240,3090,2021-01-14 03:16:32
3137,933,4,977,127,1104,3091,2021-01-14 05:56:27
3138,841,2,748,97,845,3092,2021-01-14 02:54:45
3139,916,3,1047,136,1183,3093,2021-01-14 04:26:12
3140,459,5,1376,178,1554,3094,2021-01-13 17:47:23
3141,384,3,608,79,687,3095,2021-01-13 19:58:34
3142,617,3,827,107,934,3096,2021-01-13 19:13:00
3143,729,1,299,38,337,3097,2021-01-13 17:52:41
3144,778,2,1098,142,1240,3098,2021-01-12 20:28:17
3145,236,3,997,129,1126,3099,2021-01-14 03:05:36
3146,219,3,927,120,1047,3100,2021-01-14 09:34:22
3147,402,2,459,59,518,3101,2021-01-14 05:48:55
3148,204,3,808,105,913,3102,2021-01-14 09:19:06
3149,526,2,329,42,371,3103,2021-01-14 01:21:23
3150,654,3,528,68,596,3104,2021-01-14 16:14:33
3151,748,3,1247,162,1409,3105,2021-01-14 05:40:52
3152,342,5,1176,152,1328,3106,2021-01-14 08:51:48
3153,498,3,947,123,1070,3107,2021-01-14 09:40:24
3154,719,2,498,64,562,3108,2021-01-13 14:08:54
3155,607,3,897,116,1013,3109,2021-01-13 15:44:02
3156,205,3,597,77,674,3110,2021-01-14 05:12:03
3157,783,2,898,116,1014,3111,2021-01-14 17:18:39
3158,644,2,498,64,562,3112,2021-01-14 09:39:47
3159,51,1,149,19,168,3113,2021-01-13 21:35:47
3160,336,3,658,85,743,3114,2021-01-14 16:22:50
3161,252,5,1675,217,1892,3115,2021-01-14 14:35:30
3162,397,3,688,89,777,3116,2021-01-14 00:36:32
3163,733,2,598,77,675,3117,2021-01-13 15:57:54
3164,868,3,1327,172,1499,3118,2021-01-13 09:35:16
3165,425,2,898,116,1014,3119,2021-01-13 10:43:00
3166,734,3,897,116,1013,3120,2021-01-13 19:36:33
3167,56,3,428,55,483,3121,2021-01-13 19:30:48
3168,937,3,688,89,777,3122,2021-01-13 16:25:06
3169,919,3,897,116,1013,3123,2021-01-13 19:36:43
3170,236,2,329,42,371,3124,2021-01-14 02:00:46
3171,864,3,428,55,483,3125,2021-01-13 21:38:02
3172,680,3,428,55,483,3126,2021-01-14 03:50:55
3173,465,3,597,77,674,3127,2021-01-13 05:18:36
3174,135,6,2074,269,2343,3128,2021-01-13 13:01:42
3175,743,3,747,97,844,3129,2021-01-13 13:31:22
3176,67,3,888,115,1003,3130,2021-01-13 18:25:06
3177,904,2,898,116,1014,3131,2021-01-13 14:01:27
3178,563,3,747,97,844,3132,2021-01-13 18:18:58
3179,425,3,827,107,934,3133,2021-01-13 09:38:30
3180,31,3,1247,162,1409,3134,2021-01-13 11:48:56
3181,594,3,747,97,844,3135,2021-01-13 10:02:57
3182,929,3,897,116,1013,3136,2021-01-14 01:31:45
3183,733,4,957,124,1081,3137,2021-01-14 03:47:36
3184,689,3,478,62,540,3138,2021-01-14 05:14:44
3185,159,3,997,129,1126,3139,2021-01-14 06:41:49
3186,313,2,329,42,371,3140,2021-01-14 03:04:10
3187,132,5,1955,254,2209,3141,2021-01-14 05:28:56
3188,811,2,659,85,744,3142,2021-01-13 19:52:57
3189,711,3,428,55,483,3143,2021-01-13 20:36:07
3190,432,3,697,90,787,3144,2021-01-13 20:32:28
3191,432,3,697,90,787,3144,2021-01-13 20:32:28
3192,518,2,659,85,744,3145,2021-01-13 20:08:51
3193,813,5,1445,187,1632,3146,2021-01-12 21:03:06
3194,214,5,1455,189,1644,3147,2021-01-14 05:30:28
3195,434,3,927,120,1047,3148,2021-01-14 10:30:54
3196,25,2,459,59,518,3149,2021-01-14 08:25:50
3197,990,3,997,129,1126,3150,2021-01-14 11:58:55
3198,504,3,808,105,913,3151,2021-01-14 02:38:17
3199,95,3,1247,162,1409,3152,2021-01-14 16:42:28
3200,997,3,747,97,844,3153,2021-01-14 06:51:29
3201,68,2,429,55,484,3154,2021-01-14 11:14:51
3202,10,3,997,129,1126,3155,2021-01-14 10:59:55
3203,782,2,898,116,1014,3156,2021-01-13 15:54:15
3204,59,6,1735,225,1960,3157,2021-01-13 15:56:09
3205,843,1,99,12,111,3158,2021-01-14 07:45:35
3206,276,2,828,107,935,3159,2021-01-14 17:39:41
3207,589,2,798,103,901,3160,2021-01-14 11:56:28
3208,165,3,1047,136,1183,3161,2021-01-13 22:11:12
3209,2,2,598,77,675,3162,2021-01-14 18:37:48
3210,179,3,747,97,844,3163,2021-01-14 16:25:58
3211,629,3,747,97,844,3164,2021-01-14 02:37:24
3212,4,5,1456,189,1645,3165,2021-01-13 17:42:59
3213,507,3,597,77,674,3166,2021-01-13 11:00:31
3214,490,2,429,55,484,3167,2021-01-13 11:06:57
3215,665,2,459,59,518,3168,2021-01-13 22:10:17
3216,67,3,997,129,1126,3169,2021-01-13 20:49:18
3217,165,2,898,116,1014,3170,2021-01-13 18:43:31
3218,43,3,1127,146,1273,3171,2021-01-13 22:22:27
3219,639,3,897,116,1013,3172,2021-01-14 02:45:54
3220,830,2,498,64,562,3173,2021-01-13 22:42:44
3221,856,3,478,62,540,3174,2021-01-14 04:06:41
3222,156,5,2145,278,2423,3175,2021-01-13 07:44:35
3223,306,2,898,116,1014,3176,2021-01-13 13:11:34
3224,792,2,1098,142,1240,3177,2021-01-13 13:46:14
3225,169,2,598,77,675,3178,2021-01-13 18:37:08
3226,77,2,459,59,518,3179,2021-01-13 16:04:42
3227,544,3,1047,136,1183,3180,2021-01-13 19:33:36
3228,669,3,997,129,1126,3181,2021-01-13 11:07:39
3229,726,3,1327,172,1499,3182,2021-01-13 12:53:26
3230,39,5,1295,168,1463,3183,2021-01-13 11:35:48
3231,670,3,747,97,844,3184,2021-01-14 04:08:53
3232,32,2,898,116,1014,3185,2021-01-14 03:55:25
3233,682,3,747,97,844,3186,2021-01-14 05:25:23
3234,13,3,847,110,957,3187,2021-01-14 08:04:08
3235,264,2,728,94,822,3188,2021-01-14 05:39:49
3236,472,3,647,84,731,3189,2021-01-14 06:05:07
3237,44,3,428,55,483,3190,2021-01-13 20:17:04
3238,291,2,329,42,371,3191,2021-01-13 23:14:35
3239,532,3,847,110,957,3192,2021-01-13 22:46:21
3240,122,4,1046,135,1181,3193,2021-01-13 20:45:39
3241,566,3,608,79,687,3194,2021-01-13 20:58:33
3242,566,3,608,79,687,3194,2021-01-13 20:58:33
3243,817,2,748,97,845,3195,2021-01-12 22:59:25
3244,340,3,727,94,821,3196,2021-01-14 06:31:46
3245,175,3,747,97,844,3197,2021-01-14 12:39:27
3246,845,4,1646,213,1859,3198,2021-01-14 09:45:27
3247,499,3,747,97,844,3199,2021-01-14 13:18:02
3248,157,5,1386,180,1566,3200,2021-01-14 02:39:49
3249,9,3,947,123,1070,3201,2021-01-14 17:31:28
3250,423,4,1187,154,1341,3202,2021-01-14 07:20:33
3251,442,3,478,62,540,3203,2021-01-14 12:54:13
3252,47,3,608,79,687,3204,2021-01-14 12:39:19
3253,247,5,1695,220,1915,3205,2021-01-13 16:31:42
3254,291,2,648,84,732,3206,2021-01-13 16:12:21
3255,930,3,1047,136,1183,3207,2021-01-14 08:09:27
3256,774,3,1327,172,1499,3208,2021-01-14 20:22:41
3257,664,3,608,79,687,3209,2021-01-14 13:17:04
3258,164,3,747,97,844,3210,2021-01-14 00:41:51
3259,614,3,1327,172,1499,3211,2021-01-14 20:26:52
3260,106,3,597,77,674,3212,2021-01-14 17:32:35
3261,92,2,498,64,562,3213,2021-01-14 04:19:17
3262,618,3,797,103,900,3214,2021-01-13 18:57:49
3263,791,3,997,129,1126,3215,2021-01-13 11:37:55
3264,616,3,797,103,900,3216,2021-01-13 12:00:26
3265,635,2,498,64,562,3217,2021-01-13 23:04:07
3266,345,3,847,110,957,3218,2021-01-13 21:32:48
3267,844,3,947,123,1070,3219,2021-01-13 19:38:53
3268,899,2,459,59,518,3220,2021-01-14 00:49:12
3269,962,6,1805,234,2039,3221,2021-01-14 05:10:06
3270,268,3,758,98,856,3222,2021-01-14 00:03:05
3271,671,2,898,116,1014,3223,2021-01-14 05:16:33
3272,120,2,898,116,1014,3224,2021-01-13 10:28:17
3273,732,3,528,68,596,3225,2021-01-13 15:56:56
3274,636,3,997,129,1126,3226,2021-01-13 15:47:52
3275,354,3,797,103,900,3227,2021-01-13 20:56:52
3276,332,3,578,75,653,3228,2021-01-13 18:45:35
3277,246,3,647,84,731,3229,2021-01-13 20:12:15
3278,215,3,578,75,653,3230,2021-01-13 11:15:49
3279,105,2,429,55,484,3231,2021-01-13 14:37:09
3280,65,2,548,71,619,3232,2021-01-13 12:32:03
3281,626,3,747,97,844,3233,2021-01-14 06:51:55
3282,607,3,797,103,900,3234,2021-01-14 04:15:15
3283,74,3,747,97,844,3235,2021-01-14 06:31:07
3284,553,3,727,94,821,3236,2021-01-14 10:36:56
3285,938,5,1656,215,1871,3237,2021-01-14 07:24:12
3286,873,5,1825,237,2062,3238,2021-01-14 07:00:27
3287,566,3,647,84,731,3239,2021-01-13 20:56:21
3288,81,6,1605,208,1813,3240,2021-01-13 23:29:10
3289,236,2,898,116,1014,3241,2021-01-13 23:05:27
3290,875,5,1486,193,1679,3242,2021-01-13 21:02:30
3291,267,2,459,59,518,3243,2021-01-13 22:52:54
3292,906,3,478,62,540,3244,2021-01-13 23:18:17
3293,425,2,459,59,518,3245,2021-01-13 01:12:57
3294,614,4,1357,176,1533,3246,2021-01-14 07:11:45
3295,86,2,329,42,371,3247,2021-01-14 14:00:51
3296,93,5,1655,215,1870,3248,2021-01-14 09:48:50
3297,178,3,1247,162,1409,3249,2021-01-14 14:28:59
3298,166,3,1197,155,1352,3250,2021-01-14 04:25:31
3299,376,3,947,123,1070,3251,2021-01-14 19:40:52
3300,155,2,698,90,788,3252,2021-01-14 07:29:31
3301,345,3,478,62,540,3253,2021-01-14 14:56:48
3302,931,1,399,51,450,3254,2021-01-14 12:42:37
3303,25,4,1446,187,1633,3255,2021-01-13 19:13:51
3304,674,3,1197,155,1352,3256,2021-01-13 18:57:06
3305,178,2,448,58,506,3257,2021-01-14 10:01:34
3306,818,2,459,59,518,3258,2021-01-14 23:08:00
3307,61,3,528,68,596,3259,2021-01-14 13:36:13
3308,590,3,608,79,687,3260,2021-01-14 02:24:01
3309,590,3,608,79,687,3260,2021-01-14 02:24:01
3310,952,3,947,123,1070,3261,2021-01-14 21:15:43
3311,969,2,459,59,518,3262,2021-01-14 18:04:08
3312,301,1,599,77,676,3263,2021-01-14 04:27:35
3313,637,1,499,64,563,3264,2021-01-13 21:29:56
3314,309,3,997,129,1126,3265,2021-01-13 14:22:44
3315,877,3,658,85,743,3266,2021-01-13 12:45:17
3316,458,3,847,110,957,3267,2021-01-14 01:37:33
3317,130,5,1545,200,1745,3268,2021-01-13 22:40:00
3318,900,5,1456,189,1645,3269,2021-01-13 21:42:42
3319,866,2,598,77,675,3270,2021-01-14 00:52:30
3320,494,3,1247,162,1409,3271,2021-01-14 06:27:14
3321,441,3,1127,146,1273,3272,2021-01-14 00:49:35
3322,678,3,558,72,630,3273,2021-01-14 05:32:22
3323,306,3,1047,136,1183,3274,2021-01-13 10:53:29
3324,403,2,1098,142,1240,3275,2021-01-13 16:47:43
3325,962,4,1246,161,1407,3276,2021-01-13 16:02:28
3326,531,2,548,71,619,3277,2021-01-13 23:38:37
3327,916,3,528,68,596,3278,2021-01-13 20:46:46
3328,948,3,847,110,957,3279,2021-01-13 20:16:57
3329,300,3,947,123,1070,3280,2021-01-13 12:58:24
3330,331,2,459,59,518,3281,2021-01-13 16:13:05
3331,110,3,947,123,1070,3282,2021-01-13 14:18:15
3332,677,3,888,115,1003,3283,2021-01-14 09:29:32
3333,529,2,329,42,371,3284,2021-01-14 06:33:06
3334,91,5,1545,200,1745,3285,2021-01-14 08:07:36
3335,263,3,558,72,630,3286,2021-01-14 12:50:26
3336,228,3,1327,172,1499,3287,2021-01-14 09:27:31
3337,707,5,1425,185,1610,3288,2021-01-14 08:16:43
3338,883,5,1645,213,1858,3289,2021-01-13 22:48:03
3339,906,3,647,84,731,3290,2021-01-14 00:07:41
3340,278,2,798,103,901,3291,2021-01-14 00:23:32
3341,616,4,727,94,821,3292,2021-01-13 23:44:00
3342,389,3,758,98,856,3293,2021-01-14 01:24:20
3343,764,3,1047,136,1183,3294,2021-01-13 23:21:55
3344,389,3,428,55,483,3295,2021-01-13 03:43:24
3345,610,2,698,90,788,3296,2021-01-14 09:13:01
3346,628,3,1247,162,1409,3297,2021-01-14 16:27:49
3347,948,3,558,72,630,3298,2021-01-14 11:11:22
3348,705,3,747,97,844,3299,2021-01-14 15:39:09
3349,316,3,1127,146,1273,3300,2021-01-14 06:10:25
3350,725,2,398,51,449,3301,2021-01-14 22:27:13
3351,372,4,1226,159,1385,3302,2021-01-14 09:08:54
3352,356,3,808,105,913,3303,2021-01-14 16:39:27
3353,784,3,1247,162,1409,3304,2021-01-14 15:20:39
3354,329,3,608,79,687,3305,2021-01-13 19:31:41
3355,141,4,1626,211,1837,3306,2021-01-13 21:24:37
3356,141,4,1626,211,1837,3306,2021-01-13 21:24:37
3357,441,3,1127,146,1273,3307,2021-01-14 11:51:56
3358,948,1,299,38,337,3308,2021-01-14 23:21:38
3359,246,2,448,58,506,3309,2021-01-14 16:07:34
3360,303,3,747,97,844,3310,2021-01-14 04:29:25
3361,950,2,698,90,788,3311,2021-01-14 04:02:36
3362,54,3,558,72,630,3312,2021-01-14 22:56:49
3363,787,2,598,77,675,3313,2021-01-14 19:45:15
3364,776,4,1096,142,1238,3314,2021-01-14 05:50:38
3365,137,3,888,115,1003,3315,2021-01-13 22:19:03
3366,707,6,1355,176,1531,3316,2021-01-13 14:33:31
3367,238,2,498,64,562,3317,2021-01-13 14:00:22
3368,275,3,528,68,596,3318,2021-01-14 01:39:26
3369,379,2,698,90,788,3319,2021-01-14 01:11:09
3370,550,3,808,105,913,3320,2021-01-14 00:22:13
3371,634,3,558,72,630,3321,2021-01-14 01:31:33
3372,521,3,847,110,957,3322,2021-01-14 08:11:04
3373,933,3,478,62,540,3323,2021-01-14 02:55:02
3374,162,4,1027,133,1160,3324,2021-01-14 08:11:48
3375,66,2,898,116,1014,3325,2021-01-13 11:48:38
3376,906,1,499,64,563,3326,2021-01-13 17:14:32
3377,544,3,697,90,787,3327,2021-01-13 16:05:06
3378,594,2,598,77,675,3328,2021-01-14 01:25:50
3379,810,3,528,68,596,3329,2021-01-13 21:28:37
3380,469,2,329,42,371,3330,2021-01-13 22:23:53
3381,946,6,1285,167,1452,3331,2021-01-13 14:09:49
3382,754,3,688,89,777,3332,2021-01-13 16:48:24
3383,135,3,697,90,787,3333,2021-01-13 15:04:34
3384,81,2,598,77,675,3334,2021-01-14 11:57:04
3385,36,3,1327,172,1499,3335,2021-01-14 07:40:17
3386,899,3,647,84,731,3336,2021-01-14 09:54:45
3387,887,6,1554,202,1756,3337,2021-01-14 13:28:38
3388,375,3,1047,136,1183,3338,2021-01-14 09:43:43
3389,557,5,1425,185,1610,3339,2021-01-14 10:52:44
3390,157,2,698,90,788,3340,2021-01-13 23:18:22
3391,833,4,1546,200,1746,3341,2021-01-14 02:23:34
3392,620,1,149,19,168,3342,2021-01-14 02:57:37
3393,401,3,758,98,856,3343,2021-01-14 01:05:20
3394,723,3,578,75,653,3344,2021-01-14 02:45:43
3395,397,2,1098,142,1240,3345,2021-01-14 02:05:21
3396,998,2,698,90,788,3346,2021-01-13 05:12:35
3397,998,2,698,90,788,3346,2021-01-13 05:12:35
3398,921,2,898,116,1014,3347,2021-01-14 10:48:53
3399,438,2,659,85,744,3348,2021-01-14 16:29:08
3400,358,3,1047,136,1183,3349,2021-01-14 12:24:05
3401,420,1,699,90,789,3350,2021-01-14 18:01:10
3402,215,3,747,97,844,3351,2021-01-14 07:55:23
3403,548,3,608,79,687,3352,2021-01-14 23:13:52
3404,97,3,1127,146,1273,3353,2021-01-14 09:16:08
3405,157,3,558,72,630,3354,2021-01-14 17:36:07
3406,882,3,1127,146,1273,3355,2021-01-14 16:57:06
3407,912,2,1098,142,1240,3356,2021-01-13 19:50:25
3408,549,5,1226,159,1385,3357,2021-01-13 22:16:24
3409,759,2,798,103,901,3358,2021-01-13 22:47:57
3410,286,4,1487,193,1680,3359,2021-01-14 13:31:00
3411,432,4,1726,224,1950,3360,2021-01-15 00:32:11
3412,610,3,827,107,934,3361,2021-01-14 16:39:35
3413,232,3,947,123,1070,3362,2021-01-14 04:54:57
3414,216,6,1694,220,1914,3363,2021-01-14 06:09:46
3415,746,3,597,77,674,3364,2021-01-15 01:06:04
3416,0,2,698,90,788,3365,2021-01-14 19:54:34
3417,960,3,797,103,900,3366,2021-01-14 06:07:36
3418,360,2,1098,142,1240,3367,2021-01-13 22:51:42
3419,970,3,428,55,483,3368,2021-01-13 16:59:53
3420,603,3,727,94,821,3369,2021-01-13 16:38:59
3421,844,3,1047,136,1183,3370,2021-01-14 04:09:00
3422,460,2,398,51,449,3371,2021-01-14 03:10:42
3423,34,6,1735,225,1960,3372,2021-01-14 02:27:52
3424,515,3,997,129,1126,3373,2021-01-14 03:15:32
3425,324,3,997,129,1126,3374,2021-01-14 08:54:29
3426,709,2,928,120,1048,3375,2021-01-14 04:37:36
3427,573,3,847,110,957,3376,2021-01-14 09:53:40
3428,836,3,927,120,1047,3377,2021-01-13 12:07:08
3429,81,5,1267,164,1431,3378,2021-01-13 18:52:20
3430,228,3,758,98,856,3379,2021-01-13 18:20:53
3431,502,3,688,89,777,3380,2021-01-14 02:20:34
3432,546,2,698,90,788,3381,2021-01-13 22:35:10
3433,982,2,329,42,371,3382,2021-01-13 23:12:19
3434,617,2,1098,142,1240,3383,2021-01-13 14:27:38
3435,698,3,1047,136,1183,3384,2021-01-13 18:27:09
3436,726,2,329,42,371,3385,2021-01-13 15:10:40
3437,840,2,898,116,1014,3386,2021-01-14 14:36:44
3438,206,3,658,85,743,3387,2021-01-14 08:10:46
3439,682,3,658,85,743,3388,2021-01-14 11:09:01
3440,526,3,808,105,913,3389,2021-01-14 15:21:05
3441,526,3,808,105,913,3389,2021-01-14 15:21:05
3442,322,4,1596,207,1803,3390,2021-01-14 12:28:18
3443,721,1,699,90,789,3391,2021-01-14 11:32:21
3444,255,5,887,115,1002,3392,2021-01-14 01:44:29
3445,728,3,597,77,674,3393,2021-01-14 04:57:23
3446,949,2,329,42,371,3394,2021-01-14 05:36:27
3447,501,3,897,116,1013,3395,2021-01-14 03:06:39
3448,39,5,2055,267,2322,3396,2021-01-14 03:27:27
3449,493,2,1098,142,1240,3397,2021-01-14 04:01:26
3450,124,3,797,103,900,3398,2021-01-13 06:00:08
3451,991,3,578,75,653,3399,2021-01-13 06:15:59
3452,917,3,747,97,844,3400,2021-01-14 11:30:56
3453,742,3,827,107,934,3401,2021-01-14 18:29:43
3454,925,2,329,42,371,3402,2021-01-14 14:48:11
3455,182,2,429,55,484,3403,2021-01-14 20:20:56
3456,918,5,1056,137,1193,3404,2021-01-14 08:21:41
3457,389,3,808,105,913,3405,2021-01-15 00:52:43
3458,629,5,1017,132,1149,3406,2021-01-14 10:24:12
3459,402,2,329,42,371,3407,2021-01-14 19:59:40
3460,729,3,827,107,934,3408,2021-01-14 18:30:44
3461,254,6,1225,159,1384,3409,2021-01-13 22:11:03
3462,332,1,149,19,168,3410,2021-01-13 23:01:58
3463,707,2,659,85,744,3411,2021-01-14 00:52:54
3464,834,3,558,72,630,3412,2021-01-14 15:59:27
3465,76,2,659,85,744,3413,2021-01-15 01:06:11
3466,182,3,608,79,687,3414,2021-01-14 18:52:44
3467,769,2,329,42,371,3415,2021-01-14 05:29:59
3468,53,3,647,84,731,3416,2021-01-14 08:06:41
3469,190,3,847,110,957,3417,2021-01-15 03:01:41
3470,452,2,1098,142,1240,3418,2021-01-14 20:36:21
3471,883,2,648,84,732,3419,2021-01-14 08:42:27
3472,284,2,848,110,958,3420,2021-01-14 00:31:19
3473,780,3,1327,172,1499,3421,2021-01-13 19:37:09
3474,225,3,688,89,777,3422,2021-01-13 17:27:42
3475,464,3,827,107,934,3423,2021-01-14 06:01:55
3476,966,3,647,84,731,3424,2021-01-14 05:48:04
3477,229,4,1346,174,1520,3425,2021-01-14 03:29:11
3478,993,3,1197,155,1352,3426,2021-01-14 05:49:24
3479,565,1,599,77,676,3427,2021-01-14 10:39:48
3480,108,2,659,85,744,3428,2021-01-14 06:52:06
3481,589,3,1247,162,1409,3429,2021-01-14 10:46:01
3482,569,3,758,98,856,3430,2021-01-13 12:52:24
3483,327,2,329,42,371,3431,2021-01-13 19:14:54
3484,674,3,478,62,540,3432,2021-01-13 18:54:56
3485,815,5,1786,232,2018,3433,2021-01-14 03:27:41
3486,642,3,797,103,900,3434,2021-01-13 23:47:01
3487,616,3,558,72,630,3435,2021-01-14 00:41:23
3488,273,2,1098,142,1240,3436,2021-01-13 16:02:05
3489,372,3,927,120,1047,3437,2021-01-13 21:00:01
3490,153,3,797,103,900,3438,2021-01-13 15:32:14
3491,741,3,608,79,687,3439,2021-01-14 16:21:07
3492,538,3,478,62,540,3440,2021-01-14 10:31:01
3493,761,5,2045,265,2310,3441,2021-01-14 13:20:29
3494,191,3,597,77,674,3442,2021-01-14 16:15:13
3495,155,5,1206,156,1362,3443,2021-01-14 16:18:42
3496,821,3,1027,133,1160,3444,2021-01-14 13:41:16
3497,31,3,888,115,1003,3445,2021-01-14 13:59:57
3498,563,6,1994,259,2253,3446,2021-01-14 04:23:43
3499,120,3,647,84,731,3447,2021-01-14 06:54:41
3500,595,3,727,94,821,3448,2021-01-14 07:01:24
3501,85,2,659,85,744,3449,2021-01-14 04:53:49
3502,919,3,997,129,1126,3450,2021-01-14 05:53:53
3503,661,5,1156,150,1306,3451,2021-01-14 04:25:47
3504,804,6,1724,224,1948,3452,2021-01-13 08:39:18
3505,851,3,1127,146,1273,3453,2021-01-13 08:30:20
3506,301,2,898,116,1014,3454,2021-01-14 13:25:20
3507,667,2,659,85,744,3455,2021-01-14 21:06:29
3508,13,6,2374,308,2682,3456,2021-01-14 15:36:58
3509,586,3,578,75,653,3457,2021-01-14 20:59:56
3510,153,3,688,89,777,3458,2021-01-14 08:27:11
3511,872,2,1098,142,1240,3459,2021-01-15 02:21:04
3512,503,3,558,72,630,3460,2021-01-14 12:46:36
3513,771,2,898,116,1014,3461,2021-01-14 21:19:22
3514,818,3,808,105,913,3462,2021-01-14 19:20:20
3515,636,6,1585,206,1791,3463,2021-01-13 23:28:56
3516,797,2,698,90,788,3464,2021-01-13 23:48:15
3517,540,2,598,77,675,3465,2021-01-14 02:24:13
3518,939,3,608,79,687,3466,2021-01-14 18:06:58
3519,521,2,1098,142,1240,3467,2021-01-15 01:29:06
3520,767,2,498,64,562,3468,2021-01-14 19:05:56
3521,122,2,1098,142,1240,3469,2021-01-14 07:06:03
3522,385,3,597,77,674,3470,2021-01-14 09:03:51
3523,665,2,728,94,822,3471,2021-01-15 05:37:40
3524,133,2,429,55,484,3472,2021-01-14 23:15:12
3525,338,3,1047,136,1183,3473,2021-01-14 10:26:23
3526,134,6,1086,141,1227,3474,2021-01-14 00:54:47
3527,35,5,1745,226,1971,3475,2021-01-13 20:16:27
3528,157,3,997,129,1126,3476,2021-01-13 20:11:31
3529,363,3,727,94,821,3477,2021-01-14 06:45:53
3530,931,2,798,103,901,3478,2021-01-14 06:32:12
3531,207,5,1395,181,1576,3479,2021-01-14 05:31:38
3532,958,2,498,64,562,3480,2021-01-14 06:18:21
3533,560,3,808,105,913,3481,2021-01-14 10:54:50
3534,390,3,1327,172,1499,3482,2021-01-14 06:52:10
3535,929,2,598,77,675,3483,2021-01-14 12:54:26
3536,919,3,578,75,653,3484,2021-01-13 13:58:46
3537,619,2,459,59,518,3485,2021-01-13 20:13:38
3538,980,3,827,107,934,3486,2021-01-13 20:00:41
3539,907,3,947,123,1070,3487,2021-01-14 06:03:12
3540,909,3,997,129,1126,3488,2021-01-14 01:15:35
3541,546,2,598,77,675,3489,2021-01-14 02:22:55
3542,667,3,697,90,787,3490,2021-01-13 16:07:49
3543,21,5,1356,176,1532,3491,2021-01-13 23:42:55
3544,622,3,697,90,787,3492,2021-01-13 16:15:41
3545,998,3,1047,136,1183,3493,2021-01-14 18:11:45
3546,350,6,1735,225,1960,3494,2021-01-14 11:51:24
3547,926,2,459,59,518,3495,2021-01-14 15:10:12
3548,656,2,429,55,484,3496,2021-01-14 16:49:43
3549,233,3,647,84,731,3497,2021-01-14 17:59:43
3550,12,2,898,116,1014,3498,2021-01-14 16:25:04
3551,574,1,229,29,258,3499,2021-01-14 15:41:04
3552,966,5,1506,195,1701,3500,2021-01-14 04:44:03
3553,379,2,1098,142,1240,3501,2021-01-14 09:40:39
3554,944,2,898,116,1014,3502,2021-01-14 07:23:45
3555,181,6,2054,267,2321,3503,2021-01-14 05:54:47
3556,341,3,888,115,1003,3504,2021-01-14 07:49:22
3557,561,3,1047,136,1183,3505,2021-01-14 06:49:01
3558,629,3,827,107,934,3506,2021-01-13 10:55:31
3559,885,2,459,59,518,3507,2021-01-13 09:59:33
3560,969,3,428,55,483,3508,2021-01-14 15:48:57
3561,138,3,597,77,674,3509,2021-01-14 21:44:12
3562,495,3,808,105,913,3510,2021-01-14 17:27:46
3563,7,3,808,105,913,3511,2021-01-14 21:02:33
3564,183,2,659,85,744,3512,2021-01-14 10:08:28
3565,459,3,797,103,900,3513,2021-01-15 02:28:47
3566,498,2,898,116,1014,3514,2021-01-14 14:33:00
3567,429,3,428,55,483,3515,2021-01-15 00:03:25
3568,273,3,1127,146,1273,3516,2021-01-14 20:28:06
3569,756,2,628,81,709,3517,2021-01-14 00:06:25
3570,548,3,947,123,1070,3518,2021-01-14 00:09:20
3571,897,5,1425,185,1610,3519,2021-01-14 04:10:09
3572,894,3,847,110,957,3520,2021-01-14 20:04:18
3573,527,2,429,55,484,3521,2021-01-15 02:39:48
3574,857,5,1606,208,1814,3522,2021-01-14 20:19:18
3575,594,5,2045,265,2310,3523,2021-01-14 07:33:39
3576,795,3,1027,133,1160,3524,2021-01-14 09:40:34
3577,233,3,697,90,787,3525,2021-01-15 07:59:16
3578,334,3,697,90,787,3526,2021-01-15 00:05:15
3579,1,3,747,97,844,3527,2021-01-14 11:45:50
3580,119,3,747,97,844,3528,2021-01-14 02:55:16
3581,510,1,399,51,450,3529,2021-01-13 22:54:04
3582,518,2,659,85,744,3530,2021-01-13 21:37:04
3583,98,3,727,94,821,3531,2021-01-14 08:44:57
3584,907,2,329,42,371,3532,2021-01-14 08:02:06
3585,839,3,997,129,1126,3533,2021-01-14 07:14:16
3586,528,3,827,107,934,3534,2021-01-14 07:21:15
3587,370,5,1117,145,1262,3535,2021-01-14 11:12:18
3588,91,3,947,123,1070,3536,2021-01-14 09:13:12
3589,91,3,947,123,1070,3536,2021-01-14 09:13:12
3590,928,1,229,29,258,3537,2021-01-14 14:42:14
3591,931,5,1395,181,1576,3538,2021-01-13 15:34:13
3592,44,3,727,94,821,3539,2021-01-13 22:55:04
3593,343,2,898,116,1014,3540,2021-01-13 20:57:41
3594,953,6,2174,282,2456,3541,2021-01-14 08:08:52
3595,882,3,888,115,1003,3542,2021-01-14 02:01:54
3596,257,3,1197,155,1352,3543,2021-01-14 03:00:35
3597,432,3,428,55,483,3544,2021-01-13 17:39:36
3598,442,6,1705,221,1926,3545,2021-01-14 02:12:05
3599,792,2,698,90,788,3546,2021-01-13 18:07:24
3600,369,5,1176,152,1328,3547,2021-01-14 19:06:29
3601,839,6,1236,160,1396,3548,2021-01-14 13:08:41
3602,484,2,798,103,901,3549,2021-01-14 17:16:54
3603,957,2,798,103,901,3550,2021-01-14 19:01:42
3604,452,2,498,64,562,3551,2021-01-14 19:59:26
3605,243,2,398,51,449,3552,2021-01-14 18:07:30
3606,514,1,499,64,563,3553,2021-01-14 16:48:29
3607,61,3,478,62,540,3554,2021-01-14 05:53:51
3608,932,1,499,64,563,3555,2021-01-14 11:08:28
3609,485,6,1294,168,1462,3556,2021-01-14 09:53:04
3610,399,1,399,51,450,3557,2021-01-14 06:23:48
3611,267,2,598,77,675,3558,2021-01-14 08:31:28
3612,345,3,1327,172,1499,3559,2021-01-14 07:14:36
3613,596,3,997,129,1126,3560,2021-01-13 12:48:30
3614,375,3,847,110,957,3561,2021-01-13 11:33:36
3615,603,3,1027,133,1160,3562,2021-01-14 18:34:45
3616,407,3,1127,146,1273,3563,2021-01-14 23:34:32
3617,92,2,1098,142,1240,3564,2021-01-14 19:47:49
3618,901,5,1395,181,1576,3565,2021-01-14 22:33:14
3619,833,3,897,116,1013,3566,2021-01-14 10:43:42
3620,688,2,659,85,744,3567,2021-01-15 04:33:37
3621,747,3,727,94,821,3568,2021-01-14 15:31:12
3622,826,3,808,105,913,3569,2021-01-15 01:13:30
3623,192,3,747,97,844,3570,2021-01-14 21:56:55
3624,768,2,498,64,562,3571,2021-01-14 00:12:43
3625,603,3,1197,155,1352,3572,2021-01-14 02:11:52
3626,153,3,1047,136,1183,3573,2021-01-14 06:16:36
3627,950,3,947,123,1070,3574,2021-01-14 22:43:56
3628,482,3,1197,155,1352,3575,2021-01-15 03:32:39
3629,811,2,798,103,901,3576,2021-01-14 21:29:20
3630,883,3,597,77,674,3577,2021-01-14 07:52:13
3631,36,3,997,129,1126,3578,2021-01-14 11:17:51
3632,832,2,659,85,744,3579,2021-01-15 08:42:11
3633,542,3,808,105,913,3580,2021-01-15 00:49:58
3634,198,3,1327,172,1499,3581,2021-01-14 13:41:36
3635,481,2,429,55,484,3582,2021-01-14 03:12:28
3636,406,3,697,90,787,3583,2021-01-14 00:34:31
3637,241,2,548,71,619,3584,2021-01-13 23:23:19
3638,746,3,1127,146,1273,3585,2021-01-14 08:57:08
3639,900,2,329,42,371,3586,2021-01-14 08:26:27
3640,289,3,578,75,653,3587,2021-01-14 09:09:15
3641,580,2,598,77,675,3588,2021-01-14 09:28:34
3642,456,5,1255,163,1418,3589,2021-01-14 13:03:35
3643,93,5,1037,134,1171,3590,2021-01-14 11:18:05
3644,636,3,528,68,596,3591,2021-01-14 11:57:08
3645,903,1,149,19,168,3592,2021-01-14 16:23:32
3646,132,3,1127,146,1273,3593,2021-01-13 15:49:04
3647,207,3,997,129,1126,3594,2021-01-14 00:50:00
3648,720,4,1077,140,1217,3595,2021-01-13 22:21:33
3649,865,5,1137,147,1284,3596,2021-01-14 08:11:40
3650,61,4,927,120,1047,3597,2021-01-14 03:55:36
3651,789,3,897,116,1013,3598,2021-01-14 05:38:34
3652,349,3,478,62,540,3599,2021-01-13 19:29:11
3653,344,3,927,120,1047,3600,2021-01-14 02:13:58
3654,913,2,1098,142,1240,3601,2021-01-13 20:25:12
3655,733,2,548,71,619,3602,2021-01-14 20:32:56
3656,934,3,888,115,1003,3603,2021-01-14 15:43:00
3657,979,3,697,90,787,3604,2021-01-14 19:25:30
3658,214,5,1545,200,1745,3605,2021-01-14 21:42:23
3659,917,6,1175,152,1327,3606,2021-01-14 21:09:53
3660,718,5,1347,175,1522,3607,2021-01-14 19:19:39
3661,18,2,598,77,675,3608,2021-01-14 18:45:05
3662,635,2,548,71,619,3609,2021-01-14 06:37:25
3663,109,3,997,129,1126,3610,2021-01-14 12:26:22
3664,663,2,1098,142,1240,3611,2021-01-14 10:36:40
3665,595,3,428,55,483,3612,2021-01-14 08:08:42
3666,557,6,1555,202,1757,3613,2021-01-14 10:54:14
3667,823,3,808,105,913,3614,2021-01-14 07:14:45
3668,14,3,647,84,731,3615,2021-01-13 15:24:18
3669,838,3,697,90,787,3616,2021-01-13 12:44:32
3670,637,3,997,129,1126,3617,2021-01-14 19:37:10
3671,620,3,897,116,1013,3618,2021-01-15 01:20:16
3672,689,2,498,64,562,3619,2021-01-14 22:29:24
3673,864,4,1157,150,1307,3620,2021-01-15 00:31:02
3674,421,2,329,42,371,3621,2021-01-14 12:58:00
3675,299,3,808,105,913,3622,2021-01-15 05:54:28
3676,433,4,987,128,1115,3623,2021-01-14 17:32:26
3677,789,3,927,120,1047,3624,2021-01-15 02:06:06
3678,528,3,827,107,934,3625,2021-01-14 23:19:21
3679,45,3,1027,133,1160,3626,2021-01-14 01:03:41
3680,5,2,898,116,1014,3627,2021-01-14 04:27:20
3681,463,3,1327,172,1499,3628,2021-01-14 06:46:45
3682,314,2,548,71,619,3629,2021-01-14 23:39:26
3683,239,3,747,97,844,3630,2021-01-15 04:07:20
3684,632,3,997,129,1126,3631,2021-01-14 23:05:05
3685,561,3,997,129,1126,3632,2021-01-14 08:10:01
3686,143,3,597,77,674,3633,2021-01-14 13:00:05
3687,377,2,498,64,562,3634,2021-01-15 08:44:00
3688,573,2,498,64,562,3635,2021-01-15 02:41:14
3689,316,2,498,64,562,3636,2021-01-14 15:38:02
3690,776,3,1127,146,1273,3637,2021-01-14 05:36:22
3691,484,3,478,62,540,3638,2021-01-14 01:50:14
3692,211,2,1098,142,1240,3639,2021-01-14 00:20:26
3693,211,2,1098,142,1240,3639,2021-01-14 00:20:26
3694,10,6,1624,211,1835,3640,2021-01-14 10:05:19
3695,444,3,1047,136,1183,3641,2021-01-14 10:34:00
3696,479,2,429,55,484,3642,2021-01-14 09:18:54
3697,103,3,658,85,743,3643,2021-01-14 10:15:16
3698,970,4,1157,150,1307,3644,2021-01-14 15:28:57
3699,491,1,399,51,450,3645,2021-01-14 11:22:33
3700,398,2,498,64,562,3646,2021-01-14 12:49:44
3701,106,2,659,85,744,3647,2021-01-14 18:27:15
3702,823,3,747,97,844,3648,2021-01-13 16:29:57
3703,342,5,1186,154,1340,3649,2021-01-14 02:45:56
3704,798,3,1027,133,1160,3650,2021-01-13 23:00:50
3705,431,3,688,89,777,3651,2021-01-14 09:27:01
3706,339,3,808,105,913,3652,2021-01-14 04:11:20
3707,924,3,1327,172,1499,3653,2021-01-14 06:59:23
3708,261,3,608,79,687,3654,2021-01-13 20:37:19
3709,282,5,1906,247,2153,3655,2021-01-14 04:16:57
3710,139,3,747,97,844,3656,2021-01-13 22:48:05
3711,58,3,558,72,630,3657,2021-01-14 21:56:02
3712,393,2,429,55,484,3658,2021-01-14 17:58:30
3713,610,4,957,124,1081,3659,2021-01-14 19:46:03
3714,580,3,428,55,483,3660,2021-01-14 22:50:47
3715,82,3,827,107,934,3661,2021-01-14 22:04:27
3716,766,3,897,116,1013,3662,2021-01-14 20:02:45
3717,266,1,399,51,450,3663,2021-01-14 19:59:47
3718,145,3,608,79,687,3664,2021-01-14 07:18:25
3719,375,3,827,107,934,3665,2021-01-14 13:02:12
3720,419,2,329,42,371,3666,2021-01-14 13:18:22
3721,656,1,499,64,563,3667,2021-01-14 10:29:45
3722,180,3,897,116,1013,3668,2021-01-14 12:37:58
3723,406,1,149,19,168,3669,2021-01-14 07:39:56
3724,976,4,827,107,934,3670,2021-01-13 15:51:15
3725,963,2,798,103,901,3671,2021-01-13 12:46:08
3726,774,3,1197,155,1352,3672,2021-01-14 20:35:35
3727,542,2,329,42,371,3673,2021-01-15 01:35:01
3728,856,3,1197,155,1352,3674,2021-01-14 22:44:07
3729,639,2,498,64,562,3675,2021-01-15 02:40:09
3730,644,6,1805,234,2039,3676,2021-01-14 14:20:38
3731,285,3,1047,136,1183,3677,2021-01-15 06:35:34
3732,25,3,578,75,653,3678,2021-01-14 19:27:18
3733,960,3,1127,146,1273,3679,2021-01-15 02:23:50
3734,581,2,429,55,484,3680,2021-01-15 00:11:04
3735,871,3,1197,155,1352,3681,2021-01-14 01:18:20
3736,646,2,498,64,562,3682,2021-01-14 04:46:58
3737,94,2,459,59,518,3683,2021-01-14 07:36:27
3738,481,2,628,81,709,3684,2021-01-15 01:44:12
3739,257,2,498,64,562,3685,2021-01-15 04:56:01
3740,251,6,1854,241,2095,3686,2021-01-14 23:08:43
3741,283,3,758,98,856,3687,2021-01-14 08:50:51
3742,505,3,747,97,844,3688,2021-01-14 15:42:53
3743,786,2,798,103,901,3689,2021-01-15 09:43:43
3744,859,5,1825,237,2062,3690,2021-01-15 05:14:47
3745,516,3,888,115,1003,3691,2021-01-14 17:59:39
3746,15,2,698,90,788,3692,2021-01-14 05:49:18
3747,995,1,599,77,676,3693,2021-01-14 02:43:01
3748,720,2,1098,142,1240,3694,2021-01-14 02:10:19
3749,673,5,937,121,1058,3695,2021-01-14 02:13:13
3750,946,3,1127,146,1273,3696,2021-01-14 10:10:56
3751,325,3,897,116,1013,3697,2021-01-14 11:12:27
3752,606,3,897,116,1013,3698,2021-01-14 10:13:08
3753,823,2,429,55,484,3699,2021-01-14 11:58:19
3754,288,4,1346,174,1520,3700,2021-01-14 16:04:23
3755,721,3,697,90,787,3701,2021-01-14 12:11:13
3756,261,2,329,42,371,3702,2021-01-14 14:25:11
3757,73,5,1586,206,1792,3703,2021-01-14 18:28:24
3758,372,2,848,110,958,3704,2021-01-13 17:51:46
3759,104,2,429,55,484,3705,2021-01-14 02:46:09
3760,813,2,728,94,822,3706,2021-01-13 23:16:00
3761,338,4,1596,207,1803,3707,2021-01-14 10:06:24
3762,797,3,697,90,787,3708,2021-01-14 06:31:13
3763,45,2,659,85,744,3709,2021-01-14 07:41:14
3764,71,2,459,59,518,3710,2021-01-13 22:33:43
3765,653,3,827,107,934,3711,2021-01-14 05:58:13
3766,799,3,478,62,540,3712,2021-01-13 23:45:25
3767,672,2,1098,142,1240,3713,2021-01-14 23:56:56
3768,337,3,897,116,1013,3714,2021-01-14 19:40:34
3769,750,4,1526,198,1724,3715,2021-01-14 21:11:21
3770,77,3,797,103,900,3716,2021-01-15 01:33:56
3771,181,2,598,77,675,3717,2021-01-14 23:41:58
3772,228,3,758,98,856,3718,2021-01-14 21:50:16
3773,191,3,997,129,1126,3719,2021-01-14 20:27:19
3774,457,3,647,84,731,3720,2021-01-14 07:49:30
3775,693,3,1247,162,1409,3721,2021-01-14 15:27:02
3776,707,2,1098,142,1240,3722,2021-01-14 16:00:23
3777,468,1,229,29,258,3723,2021-01-14 10:41:12
3778,837,5,1195,155,1350,3724,2021-01-14 13:14:27
3779,643,4,927,120,1047,3725,2021-01-14 09:48:36
3780,259,2,598,77,675,3726,2021-01-13 17:37:33
3781,751,3,578,75,653,3727,2021-01-13 15:00:14
3782,970,3,1197,155,1352,3728,2021-01-14 21:47:25
3783,956,3,997,129,1126,3729,2021-01-15 02:54:42
3784,612,3,658,85,743,3730,2021-01-14 23:32:14
3785,558,2,498,64,562,3731,2021-01-15 03:21:23
3786,638,3,558,72,630,3732,2021-01-14 16:53:07
3787,75,3,727,94,821,3733,2021-01-15 06:38:01
3788,692,3,1127,146,1273,3734,2021-01-14 20:31:47
3789,460,3,608,79,687,3735,2021-01-15 03:09:28
3790,234,2,498,64,562,3736,2021-01-15 01:48:31
3791,269,3,927,120,1047,3737,2021-01-14 02:29:18
3792,578,5,1645,213,1858,3738,2021-01-14 05:49:27
3793,921,3,1197,155,1352,3739,2021-01-14 09:55:48
3794,12,3,558,72,630,3740,2021-01-15 02:14:11
3795,650,2,898,116,1014,3741,2021-01-15 05:58:14
3796,382,6,1454,189,1643,3742,2021-01-15 00:14:46
3797,490,6,1874,243,2117,3743,2021-01-14 09:57:35
3798,174,2,698,90,788,3744,2021-01-14 18:19:21
3799,481,3,1247,162,1409,3745,2021-01-15 10:36:57
3800,275,2,498,64,562,3746,2021-01-15 07:39:32
3801,111,2,398,51,449,3747,2021-01-14 19:34:08
3802,214,2,429,55,484,3748,2021-01-14 06:49:19
3803,549,3,1197,155,1352,3749,2021-01-14 05:15:40
3804,976,1,229,29,258,3750,2021-01-14 04:13:48
3805,228,5,1176,152,1328,3751,2021-01-14 04:44:01
3806,495,3,578,75,653,3752,2021-01-14 11:06:22
3807,991,5,1925,250,2175,3753,2021-01-14 11:15:16
3808,725,3,947,123,1070,3754,2021-01-14 10:15:45
3809,991,2,498,64,562,3755,2021-01-14 12:18:48
3810,320,3,827,107,934,3756,2021-01-14 16:24:11
3811,547,3,827,107,934,3757,2021-01-14 12:31:50
3812,990,2,798,103,901,3758,2021-01-14 15:57:36
3813,903,1,699,90,789,3759,2021-01-14 19:21:28
3814,505,3,658,85,743,3760,2021-01-13 18:43:17
3815,718,3,428,55,483,3761,2021-01-14 04:02:29
3816,473,3,747,97,844,3762,2021-01-14 00:22:11
3817,609,3,797,103,900,3763,2021-01-14 11:06:33
3818,609,3,797,103,900,3763,2021-01-14 11:06:33
3819,248,1,229,29,258,3764,2021-01-14 08:08:14
3820,681,3,897,116,1013,3765,2021-01-14 08:34:36
3821,248,1,149,19,168,3766,2021-01-13 22:54:14
3822,195,3,647,84,731,3767,2021-01-14 07:59:34
3823,973,2,698,90,788,3768,2021-01-14 00:27:49
3824,378,2,498,64,562,3769,2021-01-15 00:09:38
3825,719,3,797,103,900,3770,2021-01-14 21:34:06
3826,413,3,888,115,1003,3771,2021-01-14 22:50:50
3827,817,3,428,55,483,3772,2021-01-15 01:43:35
3828,167,6,2244,291,2535,3773,2021-01-15 02:06:59
3829,278,3,1127,146,1273,3774,2021-01-14 22:32:49
3830,841,3,478,62,540,3775,2021-01-14 20:39:59
3831,928,2,798,103,901,3776,2021-01-14 10:30:28
3832,293,2,459,59,518,3777,2021-01-14 17:54:18
3833,322,2,548,71,619,3778,2021-01-14 18:26:31
3834,621,3,597,77,674,3779,2021-01-14 12:38:08
3835,108,3,897,116,1013,3780,2021-01-14 15:19:38
3836,294,2,798,103,901,3781,2021-01-14 10:55:04
3837,855,3,827,107,934,3782,2021-01-13 19:30:34
3838,704,2,898,116,1014,3783,2021-01-13 16:59:00
3839,791,2,898,116,1014,3784,2021-01-14 23:17:03
3840,587,2,898,116,1014,3785,2021-01-15 03:29:14
3841,597,3,558,72,630,3786,2021-01-14 23:41:58
3842,923,3,697,90,787,3787,2021-01-15 04:56:40
3843,504,3,647,84,731,3788,2021-01-14 18:07:10
3844,912,3,428,55,483,3789,2021-01-15 08:57:26
3845,192,2,598,77,675,3790,2021-01-14 21:49:31
3846,264,3,697,90,787,3791,2021-01-15 04:06:27
3847,673,3,688,89,777,3792,2021-01-15 04:30:08
3848,537,5,1595,207,1802,3793,2021-01-14 05:11:42
3849,723,4,1426,185,1611,3794,2021-01-14 08:02:49
3850,98,3,827,107,934,3795,2021-01-14 12:15:00
3851,9,5,1037,134,1171,3796,2021-01-15 04:33:46
3852,110,5,1245,161,1406,3797,2021-01-15 07:42:55
3853,191,3,747,97,844,3798,2021-01-15 02:05:33
3854,843,3,997,129,1126,3799,2021-01-14 11:44:23
3855,577,3,808,105,913,3800,2021-01-14 20:05:54
3856,926,3,897,116,1013,3801,2021-01-15 11:59:55
3857,64,2,459,59,518,3802,2021-01-15 09:26:01
3858,167,5,1226,159,1385,3803,2021-01-14 21:32:16
3859,564,3,797,103,900,3804,2021-01-14 08:47:13
3860,805,3,947,123,1070,3805,2021-01-14 08:00:17
3861,108,3,478,62,540,3806,2021-01-14 04:57:43
3862,221,3,927,120,1047,3807,2021-01-14 07:08:26
3863,760,3,727,94,821,3808,2021-01-14 12:02:25
3864,440,3,1027,133,1160,3809,2021-01-14 11:20:49
3865,614,2,898,116,1014,3810,2021-01-14 11:09:13
3866,82,2,598,77,675,3811,2021-01-14 13:07:16
3867,370,2,1098,142,1240,3812,2021-01-14 16:33:47
3868,230,3,747,97,844,3813,2021-01-14 14:51:03
3869,894,2,848,110,958,3814,2021-01-14 16:50:32
3870,46,3,1047,136,1183,3815,2021-01-14 21:59:36
3871,695,3,947,123,1070,3816,2021-01-13 18:58:45
3872,529,2,1098,142,1240,3817,2021-01-14 06:03:06
3873,201,2,429,55,484,3818,2021-01-14 02:01:06
3874,647,2,748,97,845,3819,2021-01-14 11:40:07
3875,860,3,827,107,934,3820,2021-01-14 12:33:19
3876,884,2,448,58,506,3821,2021-01-14 08:30:19
3877,518,4,1326,172,1498,3822,2021-01-14 10:30:13
3878,720,3,997,129,1126,3823,2021-01-13 23:37:02
3879,81,5,976,126,1102,3824,2021-01-14 08:31:16
3880,68,1,599,77,676,3825,2021-01-14 00:50:10
3881,324,3,1027,133,1160,3826,2021-01-15 00:13:00
3882,345,3,558,72,630,3827,2021-01-15 00:09:36
3883,786,3,758,98,856,3828,2021-01-14 23:11:41
3884,458,3,697,90,787,3829,2021-01-15 02:19:14
3885,348,3,827,107,934,3830,2021-01-15 02:54:32
3886,684,2,928,120,1048,3831,2021-01-15 00:29:59
3887,383,2,429,55,484,3832,2021-01-14 22:36:10
3888,655,3,1127,146,1273,3833,2021-01-14 10:40:25
3889,585,3,747,97,844,3834,2021-01-14 19:02:46
3890,68,3,797,103,900,3835,2021-01-14 18:31:03
3891,979,3,1127,146,1273,3836,2021-01-14 15:14:52
3892,166,3,808,105,913,3837,2021-01-14 16:34:43
3893,835,1,149,19,168,3838,2021-01-14 13:32:09
3894,731,2,1098,142,1240,3839,2021-01-13 22:02:22
3895,942,3,697,90,787,3840,2021-01-13 18:21:30
3896,646,2,528,68,596,3841,2021-01-14 23:51:49
3897,241,2,659,85,744,3842,2021-01-15 04:18:35
3898,607,2,459,59,518,3843,2021-01-15 00:13:43
3899,465,2,898,116,1014,3844,2021-01-15 05:15:44
3900,496,3,1127,146,1273,3845,2021-01-14 18:38:37
3901,75,2,1098,142,1240,3846,2021-01-15 11:00:19
3902,993,3,827,107,934,3847,2021-01-14 23:28:16
3903,929,3,927,120,1047,3848,2021-01-15 06:37:06
3904,317,3,888,115,1003,3849,2021-01-15 04:36:46
3905,483,3,647,84,731,3850,2021-01-14 07:48:25
3906,697,3,558,72,630,3851,2021-01-14 09:06:03
3907,467,2,598,77,675,3852,2021-01-14 15:00:04
3908,642,1,299,38,337,3853,2021-01-15 04:57:33
3909,778,2,1098,142,1240,3854,2021-01-15 07:47:38
3910,273,3,747,97,844,3855,2021-01-15 03:44:21
3911,273,3,747,97,844,3855,2021-01-15 03:44:21
3912,647,3,997,129,1126,3856,2021-01-14 11:52:58
3913,288,1,99,12,111,3857,2021-01-14 21:31:46
3914,511,1,599,77,676,3858,2021-01-15 12:45:12
3915,746,3,897,116,1013,3859,2021-01-15 11:41:48
3916,961,4,1396,181,1577,3860,2021-01-14 23:55:55
3917,850,4,1196,155,1351,3861,2021-01-14 08:51:52
3918,819,5,2125,276,2401,3862,2021-01-14 08:10:05
3919,774,3,1047,136,1183,3863,2021-01-14 05:00:20
3920,542,2,659,85,744,3864,2021-01-14 08:20:17
3921,734,2,598,77,675,3865,2021-01-14 12:27:11
3922,709,2,659,85,744,3866,2021-01-14 13:12:02
3923,119,2,498,64,562,3867,2021-01-14 12:04:24
3924,238,2,898,116,1014,3868,2021-01-14 14:39:05
3925,963,3,608,79,687,3869,2021-01-14 18:01:53
3926,46,3,1127,146,1273,3870,2021-01-14 16:01:44
3927,10,2,429,55,484,3871,2021-01-14 18:04:38
3928,618,2,598,77,675,3872,2021-01-14 23:25:56
3929,198,3,1247,162,1409,3873,2021-01-13 19:12:32
3930,266,3,727,94,821,3874,2021-01-14 07:39:02
3931,201,5,1795,233,2028,3875,2021-01-14 02:16:04
3932,667,2,598,77,675,3876,2021-01-14 14:07:23
3933,189,2,898,116,1014,3877,2021-01-14 13:07:31
3934,636,3,578,75,653,3878,2021-01-14 08:53:39
3935,959,2,459,59,518,3879,2021-01-14 11:55:19
3936,329,2,698,90,788,3880,2021-01-14 01:53:47
3937,601,1,499,64,563,3881,2021-01-14 09:11:28
3938,745,3,827,107,934,3882,2021-01-14 02:15:01
3939,179,3,1127,146,1273,3883,2021-01-15 00:58:06
3940,368,2,598,77,675,3884,2021-01-15 01:15:29
3941,996,2,698,90,788,3885,2021-01-15 00:58:31
3942,14,3,847,110,957,3886,2021-01-15 03:56:23
3943,478,3,608,79,687,3887,2021-01-15 03:51:19
3944,178,6,2054,267,2321,3888,2021-01-15 00:33:17
3945,838,2,1098,142,1240,3889,2021-01-14 23:14:41
3946,19,2,628,81,709,3890,2021-01-14 11:05:03
3947,318,3,827,107,934,3891,2021-01-14 21:17:46
3948,635,3,758,98,856,3892,2021-01-14 19:01:43
3949,970,2,698,90,788,3893,2021-01-14 16:08:20
3950,970,2,698,90,788,3893,2021-01-14 16:08:20
3951,611,6,1555,202,1757,3894,2021-01-14 18:59:39
3952,656,3,658,85,743,3895,2021-01-14 15:25:31
3953,493,3,1047,136,1183,3896,2021-01-14 00:09:38
3954,593,3,1127,146,1273,3897,2021-01-13 18:39:00
3955,290,1,499,64,563,3898,2021-01-15 00:34:35
3956,609,2,598,77,675,3899,2021-01-15 06:44:55
3957,750,3,597,77,674,3900,2021-01-15 02:55:17
3958,45,3,997,129,1126,3901,2021-01-15 07:50:41
3959,833,2,598,77,675,3902,2021-01-14 21:06:40
3960,982,3,697,90,787,3903,2021-01-15 13:19:04
3961,694,3,1127,146,1273,3904,2021-01-15 00:18:40
3962,582,3,747,97,844,3905,2021-01-15 07:23:31
3963,473,3,1327,172,1499,3906,2021-01-15 05:40:50
3964,193,3,997,129,1126,3907,2021-01-14 10:11:30
3965,988,3,478,62,540,3908,2021-01-14 09:31:50
3966,105,3,997,129,1126,3909,2021-01-14 15:14:50
3967,84,3,658,85,743,3910,2021-01-15 06:19:07
3968,262,3,1027,133,1160,3911,2021-01-15 09:30:21
3969,740,3,947,123,1070,3912,2021-01-15 05:12:47
3970,220,3,897,116,1013,3913,2021-01-15 04:47:53
3971,601,3,997,129,1126,3914,2021-01-14 14:25:07
3972,564,3,597,77,674,3915,2021-01-14 22:47:24
3973,526,3,558,72,630,3916,2021-01-15 13:40:53
3974,668,6,1675,217,1892,3917,2021-01-15 12:00:12
3975,3,2,1098,142,1240,3918,2021-01-15 01:14:39
3976,72,5,1645,213,1858,3919,2021-01-14 09:13:42
3977,254,5,1476,191,1667,3920,2021-01-14 09:56:49
3978,390,3,847,110,957,3921,2021-01-14 07:39:09
3979,639,1,599,77,676,3922,2021-01-14 09:59:30
3980,478,4,1157,150,1307,3923,2021-01-14 13:34:20
3981,361,2,898,116,1014,3924,2021-01-14 15:04:44
3982,493,3,1197,155,1352,3925,2021-01-14 14:32:53
3983,728,3,747,97,844,3926,2021-01-14 17:12:37
3984,353,3,1027,133,1160,3927,2021-01-14 19:42:46
3985,427,2,659,85,744,3928,2021-01-14 18:21:20
3986,479,3,688,89,777,3929,2021-01-14 20:30:17
3987,592,3,1247,162,1409,3930,2021-01-15 01:10:47
3988,141,3,997,129,1126,3931,2021-01-13 21:41:55
3989,876,2,798,103,901,3932,2021-01-14 08:59:13
3990,930,6,1524,198,1722,3933,2021-01-14 04:31:21
3991,361,3,428,55,483,3934,2021-01-14 16:37:01
3992,900,3,1047,136,1183,3935,2021-01-14 15:01:48
3993,486,5,1745,226,1971,3936,2021-01-14 10:56:38
3994,695,3,1028,133,1161,3937,2021-01-14 13:57:41
3995,846,3,997,129,1126,3938,2021-01-14 02:08:31
3996,809,3,478,62,540,3939,2021-01-14 10:24:27
3997,802,5,1955,254,2209,3940,2021-01-14 04:52:04
3998,698,3,1127,146,1273,3941,2021-01-15 02:53:23
3999,629,2,598,77,675,3942,2021-01-15 03:10:53
4000,537,3,1047,136,1183,3943,2021-01-15 02:15:55
4001,987,3,558,72,630,3944,2021-01-15 06:18:23
4002,580,2,1098,142,1240,3945,2021-01-15 04:05:23
4003,935,2,828,107,935,3946,2021-01-15 03:05:02
4004,325,2,329,42,371,3947,2021-01-15 00:44:33
4005,545,3,747,97,844,3948,2021-01-14 13:26:06
4006,314,3,797,103,900,3949,2021-01-14 22:20:39
4007,517,2,798,103,901,3950,2021-01-14 19:42:21
4008,232,2,548,71,619,3951,2021-01-14 16:20:23
4009,747,5,1245,161,1406,3952,2021-01-14 17:51:44
4010,123,5,1906,247,2153,3953,2021-01-14 20:33:37
4011,857,5,1445,187,1632,3954,2021-01-14 16:48:47
4012,634,2,429,55,484,3955,2021-01-14 01:03:46
4013,51,2,598,77,675,3956,2021-01-13 18:48:53
4014,117,3,647,84,731,3957,2021-01-15 01:18:38
4015,138,2,898,116,1014,3958,2021-01-15 06:45:50
4016,190,2,798,103,901,3959,2021-01-15 04:47:58
4017,55,2,798,103,901,3960,2021-01-15 10:37:05
4018,857,3,897,116,1013,3961,2021-01-14 21:40:55
4019,900,2,329,42,371,3962,2021-01-15 13:35:12
4020,935,3,997,129,1126,3963,2021-01-15 00:34:30
4021,26,5,1795,233,2028,3964,2021-01-15 08:45:47
4022,388,2,528,68,596,3965,2021-01-15 06:42:22
4023,734,3,647,84,731,3966,2021-01-14 11:43:06
4024,338,3,888,115,1003,3967,2021-01-14 09:39:30
4025,767,2,698,90,788,3968,2021-01-14 15:16:41
4026,490,3,927,120,1047,3969,2021-01-15 07:04:48
4027,902,3,747,97,844,3970,2021-01-15 11:23:41
4028,171,3,528,68,596,3971,2021-01-15 05:43:13
4029,58,3,697,90,787,3972,2021-01-15 05:47:06
4030,701,3,927,120,1047,3973,2021-01-14 17:01:00
4031,118,3,897,116,1013,3974,2021-01-15 00:45:19
4032,657,3,558,72,630,3975,2021-01-15 15:01:09
4033,618,5,1217,158,1375,3976,2021-01-15 14:07:53
4034,697,2,498,64,562,3977,2021-01-15 01:17:50
4035,461,1,99,12,111,3978,2021-01-14 10:08:18
4036,410,2,698,90,788,3979,2021-01-14 11:31:59
4037,459,5,1445,187,1632,3980,2021-01-14 08:18:26
4038,721,2,329,42,371,3981,2021-01-14 11:10:29
4039,167,3,827,107,934,3982,2021-01-14 14:01:20
4040,98,3,428,55,483,3983,2021-01-14 16:52:52
4041,321,2,459,59,518,3984,2021-01-14 15:25:26
4042,641,5,1386,180,1566,3985,2021-01-14 18:48:40
4043,568,2,659,85,744,3986,2021-01-14 22:23:05
4044,481,3,1047,136,1183,3987,2021-01-14 20:45:35
4045,382,3,688,89,777,3988,2021-01-14 20:46:37
4046,896,3,997,129,1126,3989,2021-01-15 01:33:53
4047,462,3,1327,172,1499,3990,2021-01-13 23:09:56
4048,554,5,1945,252,2197,3991,2021-01-14 09:36:34
4049,228,6,1694,220,1914,3992,2021-01-14 06:26:37
4050,911,4,1157,150,1307,3993,2021-01-14 16:39:53
4051,330,3,1197,155,1352,3994,2021-01-14 16:55:46
4052,266,2,698,90,788,3995,2021-01-14 11:26:45
4053,476,3,658,85,743,3996,2021-01-14 14:45:45
4054,195,2,598,77,675,3997,2021-01-14 02:21:58
4055,74,3,747,97,844,3998,2021-01-14 10:39:53
4056,615,2,828,107,935,3999,2021-01-14 07:27:53
4057,60,3,947,123,1070,4000,2021-01-15 05:36:33
4058,611,3,597,77,674,4001,2021-01-15 03:54:05
4059,927,2,598,77,675,4002,2021-01-15 02:44:37
4060,650,3,797,103,900,4003,2021-01-15 07:44:28
4061,928,5,1345,174,1519,4004,2021-01-15 06:40:44
4062,578,2,898,116,1014,4005,2021-01-15 05:35:33
4063,461,3,997,129,1126,4006,2021-01-15 01:57:21
4064,992,5,1495,194,1689,4007,2021-01-14 13:42:31
4065,400,2,498,64,562,4008,2021-01-14 22:21:45
4066,896,3,758,98,856,4009,2021-01-14 20:28:27
4067,490,3,827,107,934,4010,2021-01-14 18:47:33
4068,122,2,429,55,484,4011,2021-01-14 19:43:43
4069,375,2,429,55,484,4012,2021-01-14 22:48:06
4070,49,2,459,59,518,4013,2021-01-14 17:11:38
4071,972,3,608,79,687,4014,2021-01-14 02:04:55
4072,40,3,947,123,1070,4015,2021-01-13 20:15:01
4073,122,2,898,116,1014,4016,2021-01-15 02:42:25
4074,70,3,1027,133,1160,4017,2021-01-15 09:00:05
4075,103,3,997,129,1126,4018,2021-01-15 07:32:24
4076,321,2,698,90,788,4019,2021-01-15 12:29:26
4077,409,2,598,77,675,4020,2021-01-15 00:00:27
4078,21,3,528,68,596,4021,2021-01-15 15:40:59
4079,33,3,528,68,596,4022,2021-01-15 02:06:57
4080,320,3,827,107,934,4023,2021-01-15 09:47:41
4081,827,3,1127,146,1273,4024,2021-01-15 07:17:10
4082,777,3,658,85,743,4025,2021-01-14 13:37:11
4083,910,2,598,77,675,4026,2021-01-14 09:42:59
4084,745,3,827,107,934,4027,2021-01-14 15:16:56
4085,23,2,429,55,484,4028,2021-01-15 09:26:04
4086,294,3,827,107,934,4029,2021-01-15 12:46:07
4087,862,3,1247,162,1409,4030,2021-01-15 06:59:42
4088,295,5,1345,174,1519,4031,2021-01-15 06:06:32
4089,512,2,598,77,675,4032,2021-01-14 19:47:00
4090,402,2,659,85,744,4033,2021-01-15 02:49:03
4091,70,3,578,75,653,4034,2021-01-15 17:18:22
4092,979,2,598,77,675,4035,2021-01-15 15:56:59
4093,881,2,598,77,675,4036,2021-01-15 03:30:00
4094,14,3,578,75,653,4037,2021-01-14 11:20:07
4095,440,3,797,103,900,4038,2021-01-14 12:28:11
4096,22,3,658,85,743,4039,2021-01-14 10:47:16
4097,435,5,2025,263,2288,4040,2021-01-14 12:35:48
4098,60,3,558,72,630,4041,2021-01-14 15:54:47
4099,835,1,99,12,111,4042,2021-01-14 19:27:41
4100,973,3,658,85,743,4043,2021-01-14 16:42:21
4101,822,1,149,19,168,4044,2021-01-14 19:36:32
4102,913,5,1925,250,2175,4045,2021-01-15 01:03:18
4103,742,2,928,120,1048,4046,2021-01-14 23:01:33
4104,961,3,1127,146,1273,4047,2021-01-14 21:37:28
4105,208,3,697,90,787,4048,2021-01-15 03:18:16
4106,316,3,647,84,731,4049,2021-01-14 01:40:41
4107,413,3,1197,155,1352,4050,2021-01-14 11:03:27
4108,471,3,1047,136,1183,4051,2021-01-14 06:42:13
4109,276,2,828,107,935,4052,2021-01-14 18:56:24
4110,113,3,1127,146,1273,4053,2021-01-14 18:53:11
4111,234,3,478,62,540,4054,2021-01-14 13:50:05
4112,198,3,727,94,821,4055,2021-01-14 15:07:06
4113,436,1,599,77,676,4056,2021-01-14 03:07:19
4114,250,2,598,77,675,4057,2021-01-14 11:16:16
4115,220,5,2225,289,2514,4058,2021-01-14 08:23:34
4116,987,2,598,77,675,4059,2021-01-15 07:43:56
4117,507,3,897,116,1013,4060,2021-01-15 04:04:11
4118,885,6,1605,208,1813,4061,2021-01-15 03:43:44
4119,139,2,598,77,675,4062,2021-01-15 09:32:51
4120,658,3,758,98,856,4063,2021-01-15 08:03:48
4121,735,3,558,72,630,4064,2021-01-15 06:40:59
4122,956,6,1455,189,1644,4065,2021-01-15 03:25:38
4123,458,2,898,116,1014,4066,2021-01-14 13:47:30
4124,690,3,478,62,540,4067,2021-01-15 00:13:24
4125,250,3,888,115,1003,4068,2021-01-14 21:17:44
4126,82,3,758,98,856,4069,2021-01-14 21:07:01
4127,402,3,688,89,777,4070,2021-01-14 22:13:45
4128,165,3,1127,146,1273,4071,2021-01-14 23:43:13
4129,613,5,1625,211,1836,4072,2021-01-14 18:22:40
4130,788,2,598,77,675,4073,2021-01-14 04:20:20
4131,388,3,927,120,1047,4074,2021-01-13 22:25:03
4132,94,3,997,129,1126,4075,2021-01-15 05:25:49
4133,891,2,898,116,1014,4076,2021-01-15 10:09:35
4134,104,3,747,97,844,4077,2021-01-15 10:16:24
4135,321,3,528,68,596,4078,2021-01-15 12:58:14
4136,63,3,997,129,1126,4079,2021-01-15 00:27:31
4137,590,4,1396,181,1577,4080,2021-01-15 16:01:12
4138,716,3,658,85,743,4081,2021-01-15 04:53:29
4139,166,3,597,77,674,4082,2021-01-15 12:15:14
4140,21,3,1197,155,1352,4083,2021-01-15 07:41:52
4141,176,3,608,79,687,4084,2021-01-14 16:05:21
4142,549,3,747,97,844,4085,2021-01-14 12:04:45
4143,574,3,727,94,821,4086,2021-01-14 17:41:13
4144,837,3,1027,133,1160,4087,2021-01-15 10:55:53
4145,399,2,659,85,744,4088,2021-01-15 13:02:11
4146,381,3,1127,146,1273,4089,2021-01-15 09:05:16
4147,111,3,1197,155,1352,4090,2021-01-15 08:16:51
4148,519,3,697,90,787,4091,2021-01-14 19:53:32
4149,752,2,429,55,484,4092,2021-01-15 04:49:33
4150,288,2,898,116,1014,4093,2021-01-15 19:35:44
4151,973,2,828,107,935,4094,2021-01-15 16:15:20
4152,1,2,698,90,788,4095,2021-01-15 04:37:41
4153,292,1,149,19,168,4096,2021-01-14 13:55:32
4154,221,4,1296,168,1464,4097,2021-01-14 13:05:14
4155,866,6,1305,169,1474,4098,2021-01-14 11:33:07
4156,264,6,1974,256,2230,4099,2021-01-14 15:04:16
4157,865,3,528,68,596,4100,2021-01-14 17:33:03
4158,742,6,1435,186,1621,4101,2021-01-14 21:33:06
4159,656,3,697,90,787,4102,2021-01-14 18:25:09
4160,610,2,898,116,1014,4103,2021-01-14 21:09:35
4161,710,6,1344,174,1518,4104,2021-01-15 02:57:56
4162,10,2,898,116,1014,4105,2021-01-15 00:06:18
4163,933,3,1197,155,1352,4106,2021-01-15 00:00:08
4164,929,3,888,115,1003,4107,2021-01-15 04:26:55
4165,564,2,698,90,788,4108,2021-01-14 03:19:44
4166,217,3,727,94,821,4109,2021-01-14 12:00:49
4167,104,3,997,129,1126,4110,2021-01-14 09:19:38
4168,321,3,658,85,743,4111,2021-01-14 21:21:25
4169,208,5,1475,191,1666,4112,2021-01-14 19:29:16
4170,165,3,997,129,1126,4113,2021-01-14 16:13:47
4171,356,2,459,59,518,4114,2021-01-14 15:16:44
4172,94,3,647,84,731,4115,2021-01-14 03:18:02
4173,862,3,1197,155,1352,4116,2021-01-14 12:47:23
4174,437,2,659,85,744,4117,2021-01-14 10:07:01
4175,10,4,957,124,1081,4118,2021-01-15 08:22:48
4176,506,3,1027,133,1160,4119,2021-01-15 04:45:41
4177,855,3,1247,162,1409,4120,2021-01-15 05:30:55
4178,794,2,598,77,675,4121,2021-01-15 11:05:01
4179,989,3,1127,146,1273,4122,2021-01-15 09:43:59
4180,747,2,498,64,562,4123,2021-01-15 06:58:04
4181,254,4,1296,168,1464,4124,2021-01-15 03:27:32
4182,568,3,478,62,540,4125,2021-01-14 15:16:15
4183,223,2,598,77,675,4126,2021-01-15 00:53:42
4184,776,3,697,90,787,4127,2021-01-14 21:26:05
4185,122,2,798,103,901,4128,2021-01-14 21:14:00
4186,384,6,2494,324,2818,4129,2021-01-15 00:56:52
4187,291,2,459,59,518,4130,2021-01-15 00:29:38
4188,559,2,398,51,449,4131,2021-01-14 18:39:25
4189,324,3,827,107,934,4132,2021-01-14 04:44:48
4190,443,3,1027,133,1160,4133,2021-01-13 22:56:11
4191,994,3,927,120,1047,4134,2021-01-15 07:28:10
4192,171,6,1815,235,2050,4135,2021-01-15 10:24:29
4193,225,1,229,29,258,4136,2021-01-15 11:28:34
4194,136,2,898,116,1014,4137,2021-01-15 14:20:27
4195,689,2,659,85,744,4138,2021-01-15 01:16:46
4196,908,2,698,90,788,4139,2021-01-15 16:30:55
4197,350,5,1206,156,1362,4140,2021-01-15 06:21:52
4198,254,2,598,77,675,4141,2021-01-15 12:49:46
4199,718,3,578,75,653,4142,2021-01-15 10:04:40
4200,220,5,1575,204,1779,4143,2021-01-14 17:20:46
4201,92,2,898,116,1014,4144,2021-01-14 13:22:47
4202,369,3,1197,155,1352,4145,2021-01-14 19:45:56
4203,676,2,798,103,901,4146,2021-01-15 13:00:54
4204,759,3,827,107,934,4147,2021-01-15 15:09:11
4205,930,2,798,103,901,4148,2021-01-15 09:05:32
4206,529,5,1187,154,1341,4149,2021-01-15 09:55:00
4207,666,3,697,90,787,4150,2021-01-14 21:30:21
4208,454,2,798,103,901,4151,2021-01-15 05:24:04
4209,285,4,1126,146,1272,4152,2021-01-15 20:57:53
4210,967,4,1526,198,1724,4153,2021-01-15 17:10:18
4211,969,3,428,55,483,4154,2021-01-15 07:22:45
4212,345,3,688,89,777,4155,2021-01-14 14:46:05
4213,426,2,748,97,845,4156,2021-01-14 13:29:30
4214,480,3,847,110,957,4157,2021-01-14 13:09:14
4215,956,4,1356,176,1532,4158,2021-01-14 16:37:54
4216,115,3,927,120,1047,4159,2021-01-14 18:00:41
4217,406,3,647,84,731,4160,2021-01-14 22:24:40
4218,884,3,1047,136,1183,4161,2021-01-14 20:59:01
4219,39,3,1327,172,1499,4162,2021-01-14 22:49:07
4220,965,2,459,59,518,4163,2021-01-15 03:05:21
4221,414,2,698,90,788,4164,2021-01-15 02:34:05
4222,440,3,428,55,483,4165,2021-01-15 02:32:45
4223,215,2,898,116,1014,4166,2021-01-15 04:59:47
4224,257,3,827,107,934,4167,2021-01-14 05:54:54
4225,477,3,1327,172,1499,4168,2021-01-14 14:39:47
4226,934,2,659,85,744,4169,2021-01-14 09:19:50
4227,506,3,647,84,731,4170,2021-01-14 21:59:01
4228,571,3,688,89,777,4171,2021-01-14 22:03:54
4229,790,2,598,77,675,4172,2021-01-14 16:49:03
4230,525,2,429,55,484,4173,2021-01-14 17:47:19
4231,110,5,1675,217,1892,4174,2021-01-14 05:59:31
4232,218,4,1326,172,1498,4175,2021-01-14 13:14:42
4233,505,3,597,77,674,4176,2021-01-14 11:23:12
4234,933,2,798,103,901,4177,2021-01-15 09:43:41
4235,273,2,598,77,675,4178,2021-01-15 07:23:55
4236,564,3,997,129,1126,4179,2021-01-15 06:14:38
4237,378,3,947,123,1070,4180,2021-01-15 11:18:53
4238,874,3,608,79,687,4181,2021-01-15 10:13:29
4239,692,3,478,62,540,4182,2021-01-15 09:29:49
4240,508,2,1098,142,1240,4183,2021-01-15 03:39:10
4241,298,3,1127,146,1273,4184,2021-01-14 15:43:55
4242,377,3,1197,155,1352,4185,2021-01-15 01:29:18
4243,326,4,1426,185,1611,4186,2021-01-14 23:18:36
4244,432,2,798,103,901,4187,2021-01-14 23:51:08
4245,208,2,698,90,788,4188,2021-01-15 03:30:06
4246,336,2,329,42,371,4189,2021-01-15 01:07:04
4247,913,6,1685,219,1904,4190,2021-01-14 18:50:58
4248,496,3,697,90,787,4191,2021-01-14 06:36:49
4249,447,3,727,94,821,4192,2021-01-13 23:20:26
4250,608,3,808,105,913,4193,2021-01-15 08:32:22
4251,738,2,698,90,788,4194,2021-01-15 10:27:48
4252,528,2,898,116,1014,4195,2021-01-15 11:43:39
4253,417,3,478,62,540,4196,2021-01-15 15:03:27
4254,324,3,558,72,630,4197,2021-01-15 03:52:32
4255,599,3,658,85,743,4198,2021-01-15 17:59:02
4256,999,4,1146,148,1294,4199,2021-01-15 09:05:39
4257,421,3,847,110,957,4200,2021-01-15 14:26:24
4258,331,4,1326,172,1498,4201,2021-01-15 10:53:29
4259,255,3,1247,162,1409,4202,2021-01-14 19:50:24
4260,558,3,597,77,674,4203,2021-01-14 15:15:24
4261,350,3,758,98,856,4204,2021-01-14 21:16:22
4262,824,2,528,68,596,4205,2021-01-15 13:31:45
4263,941,3,1197,155,1352,4206,2021-01-15 15:18:17
4264,644,2,898,116,1014,4207,2021-01-15 09:30:28
4265,324,2,798,103,901,4208,2021-01-15 10:44:04
4266,473,3,897,116,1013,4209,2021-01-14 22:50:19
4267,815,3,897,116,1013,4210,2021-01-15 06:09:22
4268,585,3,947,123,1070,4211,2021-01-15 23:36:51
4269,359,1,99,12,111,4212,2021-01-15 19:45:31
4270,458,3,827,107,934,4213,2021-01-15 08:37:50
4271,711,2,798,103,901,4214,2021-01-14 14:57:51
4272,55,3,478,62,540,4215,2021-01-14 15:24:00
4273,876,2,898,116,1014,4216,2021-01-14 14:27:08
4274,273,3,1027,133,1160,4217,2021-01-14 17:03:30
4275,123,3,888,115,1003,4218,2021-01-14 19:59:15
4276,959,6,1854,241,2095,4219,2021-01-14 23:06:09
4277,270,5,1545,200,1745,4220,2021-01-14 21:59:11
4278,665,3,1327,172,1499,4221,2021-01-15 01:18:30
4279,990,4,1396,181,1577,4222,2021-01-15 03:49:56
4280,826,2,1098,142,1240,4223,2021-01-15 03:10:41
4281,463,3,597,77,674,4224,2021-01-15 03:45:20
4282,691,3,827,107,934,4225,2021-01-15 05:19:15
4283,5,1,299,38,337,4226,2021-01-14 07:51:23
4284,365,3,1047,136,1183,4227,2021-01-14 15:45:20
4285,973,3,1047,136,1183,4228,2021-01-14 09:57:22
4286,318,3,608,79,687,4229,2021-01-15 00:13:06
4287,307,2,898,116,1014,4230,2021-01-14 23:18:59
4288,328,3,927,120,1047,4231,2021-01-14 18:21:59
4289,461,5,1295,168,1463,4232,2021-01-14 18:51:32
4290,560,1,299,38,337,4233,2021-01-14 07:27:05
4291,208,2,898,116,1014,4234,2021-01-14 13:53:45
4292,572,3,758,98,856,4235,2021-01-14 12:32:00
4293,568,3,1247,162,1409,4236,2021-01-15 11:02:35
4294,54,2,598,77,675,4237,2021-01-15 08:45:32
4295,949,2,698,90,788,4238,2021-01-15 08:32:35
4296,92,2,598,77,675,4239,2021-01-15 13:51:23
4297,981,3,428,55,483,4240,2021-01-15 10:45:52
4298,640,3,947,123,1070,4241,2021-01-15 10:53:24
4299,268,2,598,77,675,4242,2021-01-15 05:27:40
4300,473,2,329,42,371,4243,2021-01-14 16:16:14
4301,518,2,898,116,1014,4244,2021-01-15 03:27:33
4302,518,2,898,116,1014,4244,2021-01-15 03:27:33
4303,576,5,1625,211,1836,4245,2021-01-15 00:08:55
4304,858,3,528,68,596,4246,2021-01-15 01:55:11
4305,867,6,1405,182,1587,4247,2021-01-15 05:20:20
4306,269,3,1047,136,1183,4248,2021-01-15 03:13:17
4307,316,6,1485,193,1678,4249,2021-01-14 20:25:12
4308,103,3,847,110,957,4250,2021-01-14 07:47:32
4309,758,3,1247,162,1409,4251,2021-01-14 00:12:31
4310,207,2,798,103,901,4252,2021-01-15 08:36:19
4311,346,2,429,55,484,4253,2021-01-15 11:12:19
4312,162,2,329,42,371,4254,2021-01-15 13:20:25
4313,968,3,827,107,934,4255,2021-01-15 16:14:14
4314,691,2,1098,142,1240,4256,2021-01-15 06:25:59
4315,631,3,847,110,957,4257,2021-01-15 18:12:23
4316,300,3,888,115,1003,4258,2021-01-15 10:18:25
4317,145,3,997,129,1126,4259,2021-01-15 14:58:39
4318,84,3,658,85,743,4260,2021-01-15 11:28:18
4319,670,1,229,29,258,4261,2021-01-14 21:21:58
4320,765,2,498,64,562,4262,2021-01-14 16:16:30
4321,501,3,608,79,687,4263,2021-01-14 21:33:10
4322,303,2,659,85,744,4264,2021-01-15 14:55:58
4323,15,3,647,84,731,4265,2021-01-15 16:05:59
4324,347,6,1805,234,2039,4266,2021-01-15 10:33:59
4325,232,3,608,79,687,4267,2021-01-15 10:52:18
4326,390,5,1875,243,2118,4268,2021-01-14 23:54:05
4327,334,5,1156,150,1306,4269,2021-01-15 08:43:19
4328,312,3,758,98,856,4270,2021-01-15 23:55:51
4329,519,2,698,90,788,4271,2021-01-15 19:48:05
4330,806,3,997,129,1126,4272,2021-01-15 11:12:56
4331,390,6,1854,241,2095,4273,2021-01-14 17:25:10
4332,634,3,1197,155,1352,4274,2021-01-14 15:36:21
4333,145,2,598,77,675,4275,2021-01-14 16:58:13
4334,401,2,798,103,901,4276,2021-01-14 19:05:07
4335,326,6,1935,251,2186,4277,2021-01-14 21:53:18
4336,975,6,1205,156,1361,4278,2021-01-14 23:38:47
4337,901,3,1127,146,1273,4279,2021-01-14 22:22:55
4338,954,2,548,71,619,4280,2021-01-15 03:09:43
4339,924,3,528,68,596,4281,2021-01-15 03:57:41
4340,123,1,699,90,789,4282,2021-01-15 04:28:12
4341,310,2,898,116,1014,4283,2021-01-15 05:28:56
4342,113,4,1826,237,2063,4284,2021-01-15 07:07:16
4343,443,2,548,71,619,4285,2021-01-14 09:50:27
4344,992,3,428,55,483,4286,2021-01-14 16:21:59
4345,696,2,498,64,562,4287,2021-01-14 09:58:48
4346,846,2,498,64,562,4288,2021-01-15 02:30:00
4347,837,3,528,68,596,4289,2021-01-15 01:30:36
4348,800,3,727,94,821,4290,2021-01-14 18:50:17
4349,787,5,1256,163,1419,4291,2021-01-14 20:02:49
4350,286,2,598,77,675,4292,2021-01-14 08:16:12
4351,988,5,1436,186,1622,4293,2021-01-14 14:46:15
4352,22,3,797,103,900,4294,2021-01-14 15:06:30
4353,984,6,1854,241,2095,4295,2021-01-15 12:48:26
4354,480,2,459,59,518,4296,2021-01-15 09:32:12
4355,355,3,827,107,934,4297,2021-01-15 11:18:41
4356,723,3,647,84,731,4298,2021-01-15 16:32:09
4357,636,2,659,85,744,4299,2021-01-15 10:59:26
4358,299,3,927,120,1047,4300,2021-01-15 11:17:12
4359,853,5,1425,185,1610,4301,2021-01-15 06:15:40
4360,205,3,827,107,934,4302,2021-01-14 18:14:22
4361,814,3,758,98,856,4303,2021-01-15 04:35:54
4362,567,3,997,129,1126,4304,2021-01-15 05:16:12
4363,883,2,459,59,518,4305,2021-01-15 02:03:12
4364,679,3,558,72,630,4306,2021-01-15 04:24:21
4365,946,3,597,77,674,4307,2021-01-15 07:37:25
4366,553,3,478,62,540,4308,2021-01-15 03:58:58
4367,527,2,598,77,675,4309,2021-01-14 21:29:43
4368,69,5,1656,215,1871,4310,2021-01-14 08:46:52
4369,968,3,1047,136,1183,4311,2021-01-14 01:55:15
4370,760,6,1374,178,1552,4312,2021-01-15 10:17:37
4371,843,2,548,71,619,4313,2021-01-15 13:52:40
4372,575,3,797,103,900,4314,2021-01-15 13:55:08
4373,402,3,528,68,596,4315,2021-01-15 16:18:08
4374,108,3,658,85,743,4316,2021-01-15 07:27:25
4375,269,1,149,19,168,4317,2021-01-15 18:35:24
4376,702,3,578,75,653,4318,2021-01-15 11:45:16
4377,37,5,1645,213,1858,4319,2021-01-15 15:44:42
4378,839,2,498,64,562,4320,2021-01-15 13:53:04
4379,415,3,808,105,913,4321,2021-01-14 23:11:51
4380,546,3,428,55,483,4322,2021-01-14 17:30:44
4381,923,3,888,115,1003,4323,2021-01-14 22:08:52
4382,923,3,888,115,1003,4323,2021-01-14 22:08:52
4383,104,3,1197,155,1352,4324,2021-01-15 16:07:38
4384,557,5,1007,130,1137,4325,2021-01-15 18:08:53
4385,980,1,299,38,337,4326,2021-01-15 12:47:55
4386,52,3,947,123,1070,4327,2021-01-15 13:21:31
4387,548,2,398,51,449,4328,2021-01-15 02:30:26
4388,512,3,808,105,913,4329,2021-01-15 10:26:47
4389,645,3,747,97,844,4330,2021-01-16 01:05:58
4390,910,3,1197,155,1352,4331,2021-01-15 20:02:29
4391,856,3,797,103,900,4332,2021-01-15 12:26:17
4392,108,4,1096,142,1238,4333,2021-01-14 20:08:59
4393,805,3,647,84,731,4334,2021-01-14 16:59:29
4394,859,3,658,85,743,4335,2021-01-14 17:23:03
4395,179,3,697,90,787,4336,2021-01-14 19:27:00
4396,219,3,927,120,1047,4337,2021-01-14 23:03:19
4397,903,2,659,85,744,4338,2021-01-15 02:08:43
4398,834,1,299,38,337,4339,2021-01-14 22:37:42
4399,632,6,1655,215,1870,4340,2021-01-15 04:20:56
4400,322,3,558,72,630,4341,2021-01-15 04:32:29
4401,425,3,1127,146,1273,4342,2021-01-15 04:54:23
4402,536,3,597,77,674,4343,2021-01-15 08:05:29
4403,647,2,728,94,822,4344,2021-01-15 07:53:03
4404,202,2,659,85,744,4345,2021-01-14 10:50:24
4405,791,3,578,75,653,4346,2021-01-14 16:42:39
4406,593,3,428,55,483,4347,2021-01-14 10:41:57
4407,624,3,827,107,934,4348,2021-01-15 03:05:24
4408,640,3,1047,136,1183,4349,2021-01-15 03:48:16
4409,420,1,399,51,450,4350,2021-01-14 19:22:35
4410,889,3,927,120,1047,4351,2021-01-14 20:56:39
4411,738,5,1345,174,1519,4352,2021-01-14 09:16:58
4412,573,1,399,51,450,4353,2021-01-14 16:56:28
4413,15,1,149,19,168,4354,2021-01-14 17:34:13
4414,556,3,1327,172,1499,4355,2021-01-15 15:10:55
4415,414,3,428,55,483,4356,2021-01-15 10:30:56
4416,343,3,697,90,787,4357,2021-01-15 12:23:04
4417,57,2,329,42,371,4358,2021-01-15 18:49:19
4418,696,3,1047,136,1183,4359,2021-01-15 13:30:20
4419,410,3,847,110,957,4360,2021-01-15 12:35:11
4420,711,3,997,129,1126,4361,2021-01-15 08:52:44
4421,506,3,1327,172,1499,4362,2021-01-14 19:04:23
4422,874,3,808,105,913,4363,2021-01-15 04:55:36
4423,484,3,897,116,1013,4364,2021-01-15 07:46:38
4424,783,2,459,59,518,4365,2021-01-15 04:14:38
4425,917,3,647,84,731,4366,2021-01-15 05:01:37
4426,666,3,697,90,787,4367,2021-01-15 08:03:52
4427,365,3,847,110,957,4368,2021-01-15 06:10:59
4428,120,3,428,55,483,4369,2021-01-14 22:25:40
4429,687,3,558,72,630,4370,2021-01-14 09:16:21
4430,645,3,578,75,653,4371,2021-01-14 04:34:45
4431,76,2,898,116,1014,4372,2021-01-15 10:31:29
4432,845,3,578,75,653,4373,2021-01-15 15:37:44
4433,426,3,478,62,540,4374,2021-01-15 14:58:15
4434,647,3,897,116,1013,4375,2021-01-15 19:04:35
4435,356,5,2095,272,2367,4376,2021-01-15 07:30:45
4436,780,3,897,116,1013,4377,2021-01-15 19:47:56
4437,478,3,827,107,934,4378,2021-01-15 11:57:56
4438,420,1,229,29,258,4379,2021-01-15 16:36:16
4439,14,3,1047,136,1183,4380,2021-01-15 15:32:42
4440,469,2,598,77,675,4381,2021-01-15 00:13:09
4441,474,2,698,90,788,4382,2021-01-14 19:51:43
4442,624,3,847,110,957,4383,2021-01-15 00:17:59
4443,175,3,608,79,687,4384,2021-01-14 22:27:47
4444,285,2,429,55,484,4385,2021-01-15 16:08:23
4445,512,3,997,129,1126,4386,2021-01-15 18:29:32
4446,229,2,798,103,901,4387,2021-01-15 14:26:23
4447,168,2,598,77,675,4388,2021-01-15 14:04:48
4448,813,2,528,68,596,4389,2021-01-15 05:00:00
4449,691,2,928,120,1048,4390,2021-01-15 11:16:06
4450,887,3,808,105,913,4391,2021-01-16 02:32:31
4451,195,2,429,55,484,4392,2021-01-15 21:18:52
4452,774,3,747,97,844,4393,2021-01-15 14:20:00
4453,868,5,1156,150,1306,4394,2021-01-14 22:49:10
4454,510,2,898,116,1014,4395,2021-01-14 19:11:44
4455,245,1,99,12,111,4396,2021-01-14 19:42:36
4456,657,3,827,107,934,4397,2021-01-14 20:00:31
4457,727,2,659,85,744,4398,2021-01-15 01:26:14
4458,665,3,428,55,483,4399,2021-01-15 02:54:46
4459,563,3,597,77,674,4400,2021-01-15 00:26:02
4460,565,3,947,123,1070,4401,2021-01-15 05:20:29
4461,113,4,1426,185,1611,4402,2021-01-15 05:21:44
4462,462,3,827,107,934,4403,2021-01-15 07:02:58
4463,752,3,997,129,1126,4404,2021-01-15 10:17:59
4464,563,3,758,98,856,4405,2021-01-15 09:01:40
4465,424,3,1027,133,1160,4406,2021-01-14 12:12:11
4466,935,2,498,64,562,4407,2021-01-14 18:05:52
4467,458,3,647,84,731,4408,2021-01-14 12:51:33
4468,363,2,459,59,518,4409,2021-01-15 04:21:05
4469,574,2,498,64,562,4410,2021-01-15 04:31:57
4470,858,3,997,129,1126,4411,2021-01-14 21:59:20
4471,963,2,659,85,744,4412,2021-01-14 23:36:23
4472,620,3,528,68,596,4413,2021-01-14 11:45:52
4473,553,3,658,85,743,4414,2021-01-14 19:41:30
4474,319,2,598,77,675,4415,2021-01-14 18:38:19
4475,585,3,608,79,687,4416,2021-01-15 17:20:06
4476,719,3,1047,136,1183,4417,2021-01-15 12:20:36
4477,362,2,648,84,732,4418,2021-01-15 14:29:33
4478,326,3,608,79,687,4419,2021-01-15 19:15:46
4479,12,3,797,103,900,4420,2021-01-15 15:54:44
4480,864,3,808,105,913,4421,2021-01-15 14:16:55
4481,318,2,698,90,788,4422,2021-01-15 10:04:40
4482,789,3,597,77,674,4423,2021-01-14 19:52:39
4483,496,2,329,42,371,4424,2021-01-15 07:26:09
4484,837,3,608,79,687,4425,2021-01-15 08:07:27
4485,632,2,698,90,788,4426,2021-01-15 06:35:10
4486,358,4,826,107,933,4427,2021-01-15 05:24:26
4487,511,3,808,105,913,4428,2021-01-15 09:45:53
4488,701,6,1855,241,2096,4429,2021-01-15 08:41:09
4489,38,1,399,51,450,4430,2021-01-15 01:08:31
4490,548,3,847,110,957,4431,2021-01-14 11:24:29
4491,869,3,847,110,957,4432,2021-01-14 05:36:06
4492,258,3,1047,136,1183,4433,2021-01-15 12:08:52
4493,344,3,697,90,787,4434,2021-01-15 16:00:16
4494,467,4,1088,141,1229,4435,2021-01-15 14:59:46
4495,248,3,997,129,1126,4436,2021-01-15 20:43:16
4496,199,2,798,103,901,4437,2021-01-15 09:22:49
4497,932,3,608,79,687,4438,2021-01-15 20:34:28
4498,880,3,688,89,777,4439,2021-01-15 13:56:44
4499,200,3,697,90,787,4440,2021-01-15 17:17:03
4500,723,4,1296,168,1464,4441,2021-01-15 17:35:50
4501,635,2,898,116,1014,4442,2021-01-15 00:22:03
4502,251,3,1197,155,1352,4443,2021-01-14 19:52:36
4503,736,3,1047,136,1183,4444,2021-01-15 02:35:13
4504,676,2,898,116,1014,4445,2021-01-15 00:39:08
4505,85,3,558,72,630,4446,2021-01-15 18:50:04
4506,32,3,827,107,934,4447,2021-01-15 18:48:10
4507,863,3,558,72,630,4448,2021-01-15 15:36:30
4508,799,3,1197,155,1352,4449,2021-01-15 16:23:48
4509,34,3,688,89,777,4450,2021-01-15 07:02:53
4510,960,3,997,129,1126,4451,2021-01-15 11:54:05
4511,6,3,758,98,856,4452,2021-01-16 03:46:43
4512,158,3,597,77,674,4453,2021-01-15 23:19:06
4513,593,2,459,59,518,4454,2021-01-15 16:29:29
4514,533,5,1326,172,1498,4455,2021-01-15 01:02:27
4515,521,2,698,90,788,4456,2021-01-14 20:24:08
4516,305,2,598,77,675,4457,2021-01-14 19:51:54
4517,483,3,747,97,844,4458,2021-01-14 20:21:57
4518,22,2,798,103,901,4459,2021-01-15 03:27:54
4519,382,3,847,110,957,4460,2021-01-15 03:18:47
4520,948,3,997,129,1126,4461,2021-01-15 01:18:41
4521,332,2,429,55,484,4462,2021-01-15 07:53:38
4522,836,3,888,115,1003,4463,2021-01-15 05:57:44
4523,112,3,827,107,934,4464,2021-01-15 09:08:46
4524,272,6,1624,211,1835,4465,2021-01-15 11:14:44
4525,733,3,947,123,1070,4466,2021-01-15 11:07:47
4526,263,1,149,19,168,4467,2021-01-14 13:09:20
4527,281,3,1047,136,1183,4468,2021-01-14 20:31:32
4528,605,3,888,115,1003,4469,2021-01-14 14:50:43
4529,439,2,698,90,788,4470,2021-01-15 04:38:46
4530,35,2,498,64,562,4471,2021-01-15 05:52:56
4531,67,2,429,55,484,4472,2021-01-14 23:45:33
4532,41,3,688,89,777,4473,2021-01-14 23:38:36
4533,711,2,659,85,744,4474,2021-01-14 13:50:33
4534,181,2,898,116,1014,4475,2021-01-14 20:31:44
4535,312,5,1445,187,1632,4476,2021-01-14 18:40:59
4536,479,3,478,62,540,4477,2021-01-15 17:56:21
4537,715,3,697,90,787,4478,2021-01-15 13:02:17
4538,765,3,1327,172,1499,4479,2021-01-15 16:30:40
4539,175,3,1197,155,1352,4480,2021-01-15 19:58:22
4540,179,2,548,71,619,4481,2021-01-15 17:07:57
4541,177,1,699,90,789,4482,2021-01-15 15:18:47
4542,61,2,898,116,1014,4483,2021-01-15 10:06:32
4543,440,3,558,72,630,4484,2021-01-14 21:06:36
4544,726,3,827,107,934,4485,2021-01-15 07:54:46
4545,597,3,1027,133,1160,4486,2021-01-15 09:45:05
4546,285,6,1874,243,2117,4487,2021-01-15 08:02:07
4547,161,3,608,79,687,4488,2021-01-15 07:52:43
4548,850,3,697,90,787,4489,2021-01-15 10:46:24
4549,730,3,697,90,787,4490,2021-01-15 10:32:17
4550,406,1,229,29,258,4491,2021-01-15 02:15:27
4551,781,3,747,97,844,4492,2021-01-14 13:48:01
4552,631,3,1127,146,1273,4493,2021-01-14 07:59:34
4553,344,3,827,107,934,4494,2021-01-15 12:39:48
4554,429,2,598,77,675,4495,2021-01-15 16:33:58
4555,810,2,548,71,619,4496,2021-01-15 16:23:46
4556,571,3,1047,136,1183,4497,2021-01-15 22:55:23
4557,570,1,99,12,111,4498,2021-01-15 09:36:38
4558,846,3,1027,133,1160,4499,2021-01-15 22:00:29
4559,12,2,598,77,675,4500,2021-01-15 15:52:17
4560,375,2,698,90,788,4501,2021-01-15 17:54:12
4561,44,3,597,77,674,4502,2021-01-15 18:06:22
4562,43,2,898,116,1014,4503,2021-01-15 01:45:14
4563,752,3,847,110,957,4504,2021-01-14 20:52:15
4564,504,3,597,77,674,4505,2021-01-15 03:54:20
4565,504,3,597,77,674,4505,2021-01-15 03:54:20
4566,842,3,727,94,821,4506,2021-01-15 02:01:46
4567,69,3,808,105,913,4507,2021-01-15 21:27:26
4568,916,3,558,72,630,4508,2021-01-15 19:44:34
4569,916,3,558,72,630,4508,2021-01-15 19:44:34
4570,300,3,997,129,1126,4509,2021-01-15 16:28:07
4571,269,2,1098,142,1240,4510,2021-01-15 18:00:08
4572,491,2,659,85,744,4511,2021-01-15 07:36:15
4573,25,3,947,123,1070,4512,2021-01-15 13:53:24
4574,175,3,997,129,1126,4513,2021-01-16 06:17:21
4575,127,3,797,103,900,4514,2021-01-16 01:09:06
4576,24,3,888,115,1003,4515,2021-01-15 17:47:34
4577,333,2,1098,142,1240,4516,2021-01-15 01:08:11
4578,496,5,1825,237,2062,4517,2021-01-14 20:47:42
4579,423,2,548,71,619,4518,2021-01-14 21:55:54
4580,948,3,997,129,1126,4519,2021-01-14 21:49:02
4581,404,3,947,123,1070,4520,2021-01-15 04:12:48
4582,269,3,827,107,934,4521,2021-01-15 05:35:32
4583,147,3,747,97,844,4522,2021-01-15 02:53:56
4584,491,3,1127,146,1273,4523,2021-01-15 08:42:08
4585,312,2,898,116,1014,4524,2021-01-15 07:46:30
4586,791,3,647,84,731,4525,2021-01-15 10:52:46
4587,13,3,478,62,540,4526,2021-01-15 11:42:02
4588,146,2,898,116,1014,4527,2021-01-15 13:53:54
4589,16,1,149,19,168,4528,2021-01-14 14:02:02
4590,987,3,1197,155,1352,4529,2021-01-14 22:11:47
4591,400,2,459,59,518,4530,2021-01-14 14:54:17
4592,697,3,727,94,821,4531,2021-01-15 05:13:57
4593,478,5,1786,232,2018,4532,2021-01-15 07:22:08
4594,504,4,977,127,1104,4533,2021-01-15 01:43:33
4595,650,1,229,29,258,4534,2021-01-15 01:17:54
4596,645,3,747,97,844,4535,2021-01-14 14:25:47
4597,787,5,1426,185,1611,4536,2021-01-14 22:09:38
4598,715,1,149,19,168,4537,2021-01-14 21:00:34
4599,958,2,828,107,935,4538,2021-01-15 18:06:42
4600,453,2,798,103,901,4539,2021-01-15 13:52:14
4601,996,5,1445,187,1632,4540,2021-01-15 17:10:27
4602,466,3,1127,146,1273,4541,2021-01-15 21:23:19
4603,879,3,1127,146,1273,4542,2021-01-15 19:52:43
4604,887,2,429,55,484,4543,2021-01-15 16:52:17
4605,251,2,1098,142,1240,4544,2021-01-15 12:48:17
4606,965,3,747,97,844,4545,2021-01-14 22:59:17
4607,420,2,598,77,675,4546,2021-01-15 09:35:41
4608,863,3,1247,162,1409,4547,2021-01-15 10:55:41
4609,897,3,827,107,934,4548,2021-01-15 08:24:15
4610,737,2,429,55,484,4549,2021-01-15 09:04:24
4611,941,3,558,72,630,4550,2021-01-15 11:56:33
4612,860,5,1076,139,1215,4551,2021-01-15 11:48:02
4613,784,2,448,58,506,4552,2021-01-15 04:07:32
4614,928,1,599,77,676,4553,2021-01-14 14:02:27
4615,948,2,659,85,744,4554,2021-01-14 09:48:12
4616,373,3,947,123,1070,4555,2021-01-15 13:31:19
4617,385,3,478,62,540,4556,2021-01-15 17:37:25
4618,658,3,658,85,743,4557,2021-01-15 18:18:50
4619,188,3,647,84,731,4558,2021-01-16 01:15:48
4620,663,3,658,85,743,4559,2021-01-15 10:26:13
4621,806,3,997,129,1126,4560,2021-01-15 22:21:39
4622,817,2,798,103,901,4561,2021-01-15 16:42:08
4623,938,4,757,98,855,4562,2021-01-15 18:02:41
4624,636,3,727,94,821,4563,2021-01-15 20:23:51
4625,194,2,598,77,675,4564,2021-01-15 02:12:00
4626,257,3,747,97,844,4565,2021-01-14 22:21:43
4627,739,3,697,90,787,4566,2021-01-15 03:56:50
4628,767,5,1586,206,1792,4567,2021-01-15 05:45:20
4629,572,2,459,59,518,4568,2021-01-15 04:39:17
4630,3,2,898,116,1014,4569,2021-01-15 22:10:54
4631,930,3,727,94,821,4570,2021-01-15 21:59:56
4632,608,5,1706,221,1927,4571,2021-01-15 20:05:33
4633,90,4,1196,155,1351,4572,2021-01-15 17:46:14
4634,558,2,798,103,901,4573,2021-01-15 19:09:19
4635,357,3,558,72,630,4574,2021-01-15 10:09:48
4636,848,3,997,129,1126,4575,2021-01-15 15:00:55
4637,237,3,1127,146,1273,4576,2021-01-16 06:38:02
4638,299,2,329,42,371,4577,2021-01-16 03:39:57
4639,357,4,1526,198,1724,4578,2021-01-15 18:44:59
4640,783,4,1396,181,1577,4579,2021-01-15 02:43:31
4641,587,3,428,55,483,4580,2021-01-14 22:19:25
4642,377,2,329,42,371,4581,2021-01-14 22:01:53
4643,231,3,997,129,1126,4582,2021-01-14 22:56:04
4644,578,3,528,68,596,4583,2021-01-15 05:36:53
4645,623,1,149,19,168,4584,2021-01-15 08:18:10
4646,536,6,1394,181,1575,4585,2021-01-15 05:26:08
4647,366,5,1276,165,1441,4586,2021-01-15 08:58:51
4648,837,2,628,81,709,4587,2021-01-15 08:01:32
4649,315,5,1217,158,1375,4588,2021-01-15 11:21:53
4650,372,3,478,62,540,4589,2021-01-15 13:39:00
4651,824,3,528,68,596,4590,2021-01-15 16:15:39
4652,845,3,478,62,540,4591,2021-01-14 14:37:12
4653,771,1,399,51,450,4592,2021-01-14 23:51:53
4654,67,3,528,68,596,4593,2021-01-14 16:37:05
4655,964,3,1127,146,1273,4594,2021-01-15 06:02:52
4656,113,3,688,89,777,4595,2021-01-15 09:37:49
4657,445,2,598,77,675,4596,2021-01-15 03:57:54
4658,382,6,2194,285,2479,4597,2021-01-15 02:03:38
4659,598,3,1027,133,1160,4598,2021-01-14 14:59:29
4660,864,2,459,59,518,4599,2021-01-15 00:10:10
4661,542,3,428,55,483,4600,2021-01-14 22:59:50
4662,432,6,1685,219,1904,4601,2021-01-15 18:49:07
4663,91,2,898,116,1014,4602,2021-01-15 14:48:07
4664,92,2,598,77,675,4603,2021-01-15 17:56:06
4665,74,2,459,59,518,4604,2021-01-15 22:03:39
4666,814,2,329,42,371,4605,2021-01-15 20:56:28
4667,860,2,798,103,901,4606,2021-01-15 19:22:42
4668,82,3,727,94,821,4607,2021-01-15 12:59:42
4669,866,2,459,59,518,4608,2021-01-14 23:31:31
4670,27,5,1526,198,1724,4609,2021-01-15 10:47:10
4671,345,3,1127,146,1273,4610,2021-01-15 12:35:19
4672,41,2,659,85,744,4611,2021-01-15 09:46:33
4673,939,3,827,107,934,4612,2021-01-15 09:08:40
4674,255,4,1246,161,1407,4613,2021-01-15 12:30:17
4675,651,3,1197,155,1352,4614,2021-01-15 13:23:31
4676,375,3,927,120,1047,4615,2021-01-15 04:57:53
4677,968,4,1057,137,1194,4616,2021-01-14 14:39:54
4678,919,1,699,90,789,4617,2021-01-14 10:42:05
4679,562,3,528,68,596,4618,2021-01-15 15:58:48
4680,810,3,888,115,1003,4619,2021-01-15 19:04:20
4681,644,3,997,129,1126,4620,2021-01-15 19:42:21
4682,371,3,758,98,856,4621,2021-01-16 03:48:21
4683,423,3,747,97,844,4622,2021-01-15 12:39:31
4684,590,2,798,103,901,4623,2021-01-15 22:34:17
4685,609,3,1027,133,1160,4624,2021-01-15 18:40:29
4686,284,3,597,77,674,4625,2021-01-15 18:18:38
4687,366,3,758,98,856,4626,2021-01-15 21:34:51
4688,343,1,229,29,258,4627,2021-01-15 04:14:37
4689,653,3,658,85,743,4628,2021-01-14 23:38:51
4690,140,2,698,90,788,4629,2021-01-15 06:25:44
4691,845,1,229,29,258,4630,2021-01-15 07:01:12
4692,238,3,758,98,856,4631,2021-01-15 05:05:30
4693,336,2,898,116,1014,4632,2021-01-16 00:09:05
4694,804,6,1705,221,1926,4633,2021-01-15 22:28:12
4695,493,2,898,116,1014,4634,2021-01-15 22:46:11
4696,717,3,797,103,900,4635,2021-01-15 18:52:44
4697,61,3,1047,136,1183,4636,2021-01-15 20:40:04
4698,632,3,658,85,743,4637,2021-01-15 10:38:04
4699,307,3,727,94,821,4638,2021-01-15 16:38:51
4700,298,3,1327,172,1499,4639,2021-01-16 08:43:28
4701,671,3,647,84,731,4640,2021-01-16 04:36:42
4702,705,2,429,55,484,4641,2021-01-15 19:03:06
4703,258,2,528,68,596,4642,2021-01-15 04:39:16
4704,921,1,229,29,258,4643,2021-01-15 00:40:57
4705,441,2,798,103,901,4644,2021-01-14 22:14:24
4706,438,3,558,72,630,4645,2021-01-14 23:05:22
4707,638,3,658,85,743,4646,2021-01-15 07:37:40
4708,996,3,697,90,787,4647,2021-01-15 10:28:46
4709,203,1,229,29,258,4648,2021-01-15 08:03:28
4710,567,6,1574,204,1778,4649,2021-01-15 09:25:33
4711,590,3,658,85,743,4650,2021-01-15 08:19:18
4712,990,1,229,29,258,4651,2021-01-15 13:36:00
4713,111,2,798,103,901,4652,2021-01-15 14:50:38
4714,589,5,1325,172,1497,4653,2021-01-15 16:49:17
4715,272,3,1247,162,1409,4654,2021-01-14 15:29:54
4716,889,3,1327,172,1499,4655,2021-01-15 00:09:46
4717,91,3,927,120,1047,4656,2021-01-14 19:17:55
4718,129,1,229,29,258,4657,2021-01-15 06:53:50
4719,606,3,578,75,653,4658,2021-01-15 11:22:10
4720,285,2,898,116,1014,4659,2021-01-15 06:06:07
4721,197,3,658,85,743,4660,2021-01-15 04:11:50
4722,557,3,797,103,900,4661,2021-01-14 16:17:42
4723,184,4,1007,130,1137,4662,2021-01-15 02:44:39
4724,644,1,399,51,450,4663,2021-01-15 01:00:47
4725,526,2,1098,142,1240,4664,2021-01-15 20:16:09
4726,607,3,478,62,540,4665,2021-01-15 17:34:00
4727,228,3,578,75,653,4666,2021-01-15 18:53:56
4728,443,2,898,116,1014,4667,2021-01-15 23:23:56
4729,679,3,1027,133,1160,4668,2021-01-15 23:29:38
4730,307,6,1325,172,1497,4669,2021-01-15 20:39:16
4731,896,2,329,42,371,4670,2021-01-15 15:35:26
4732,119,2,459,59,518,4671,2021-01-15 00:02:50
4733,119,2,459,59,518,4671,2021-01-15 00:02:50
4734,974,5,2145,278,2423,4672,2021-01-15 11:22:35
4735,853,2,598,77,675,4673,2021-01-15 13:51:12
4736,285,6,1874,243,2117,4674,2021-01-15 12:24:18
4737,125,2,329,42,371,4675,2021-01-15 10:43:24
4738,527,3,758,98,856,4676,2021-01-15 13:23:06
4739,164,3,897,116,1013,4677,2021-01-15 14:53:15
4740,358,2,798,103,901,4678,2021-01-15 06:28:26
4741,667,3,578,75,653,4679,2021-01-14 15:37:33
4742,476,3,897,116,1013,4680,2021-01-14 13:21:26
4743,182,3,1047,136,1183,4681,2021-01-15 17:17:41
4744,912,4,1726,224,1950,4682,2021-01-15 20:54:09
4745,85,3,697,90,787,4683,2021-01-15 21:26:18
4746,354,2,329,42,371,4684,2021-01-16 06:12:30
4747,352,5,1356,176,1532,4685,2021-01-15 14:03:33
4748,200,3,677,88,765,4686,2021-01-16 00:19:10
4749,866,3,478,62,540,4687,2021-01-15 18:58:01
4750,814,5,1325,172,1497,4688,2021-01-15 19:02:36
4751,803,2,598,77,675,4689,2021-01-15 21:45:06
4752,925,3,1047,136,1183,4690,2021-01-15 06:43:03
4753,86,3,528,68,596,4691,2021-01-15 01:09:18
4754,609,3,847,110,957,4692,2021-01-15 07:43:40
4755,285,6,1435,186,1621,4693,2021-01-15 07:38:00
4756,649,1,229,29,258,4694,2021-01-15 06:00:47
4757,338,2,329,42,371,4695,2021-01-16 00:54:06
4758,401,2,598,77,675,4696,2021-01-15 23:37:32
4759,994,1,99,12,111,4697,2021-01-16 00:47:11
4760,634,2,429,55,484,4698,2021-01-15 21:37:44
4761,491,3,827,107,934,4699,2021-01-15 22:16:33
4762,344,2,598,77,675,4700,2021-01-15 10:50:43
4763,718,3,727,94,821,4701,2021-01-15 17:06:57
4764,298,3,578,75,653,4702,2021-01-16 11:21:57
4765,674,6,1654,215,1869,4703,2021-01-16 05:03:05
4766,205,3,578,75,653,4704,2021-01-15 19:13:33
4767,453,3,1127,146,1273,4705,2021-01-15 06:45:52
4768,127,3,827,107,934,4706,2021-01-15 00:55:42
4769,911,4,1726,224,1950,4707,2021-01-14 23:37:56
4770,699,3,747,97,844,4708,2021-01-15 00:27:15
4771,754,2,498,64,562,4709,2021-01-15 08:46:26
4772,616,3,997,129,1126,4710,2021-01-15 11:26:53
4773,86,3,758,98,856,4711,2021-01-15 09:13:56
4774,662,3,647,84,731,4712,2021-01-15 10:38:15
4775,820,2,598,77,675,4713,2021-01-15 10:27:25
4776,787,4,1427,185,1612,4714,2021-01-15 14:12:56
4777,98,2,698,90,788,4715,2021-01-15 15:29:34
4778,143,3,1327,172,1499,4716,2021-01-15 18:02:05
4779,637,2,898,116,1014,4717,2021-01-14 17:32:03
4780,529,4,977,127,1104,4718,2021-01-15 00:36:24
4781,275,3,888,115,1003,4719,2021-01-14 21:41:00
4782,382,2,659,85,744,4720,2021-01-15 07:54:03
4783,303,2,798,103,901,4721,2021-01-15 14:01:04
4784,360,2,329,42,371,4722,2021-01-15 07:25:28
4785,168,3,647,84,731,4723,2021-01-15 05:37:06
4786,493,3,808,105,913,4724,2021-01-14 18:24:11
4787,8,2,898,116,1014,4725,2021-01-15 03:13:53
4788,599,3,688,89,777,4726,2021-01-15 01:23:17
4789,623,3,608,79,687,4727,2021-01-15 20:57:21
4790,203,2,459,59,518,4728,2021-01-15 18:56:52
4791,347,3,558,72,630,4729,2021-01-15 20:38:20
4792,895,4,1926,250,2176,4730,2021-01-15 23:44:20
4793,919,3,827,107,934,4731,2021-01-15 23:44:00
4794,245,3,697,90,787,4732,2021-01-15 20:58:20
4795,276,2,628,81,709,4733,2021-01-15 17:20:54
4796,965,6,1455,189,1644,4734,2021-01-15 00:05:08
4797,324,2,598,77,675,4735,2021-01-15 01:28:43
4798,918,5,907,117,1024,4736,2021-01-15 12:34:19
4799,125,3,947,123,1070,4737,2021-01-15 15:52:53
4800,87,4,987,128,1115,4738,2021-01-15 14:33:29
4801,993,5,1625,211,1836,4739,2021-01-15 12:25:38
4802,939,3,1127,146,1273,4740,2021-01-15 15:55:41
4803,336,2,698,90,788,4741,2021-01-15 17:01:45
4804,157,5,1755,228,1983,4742,2021-01-15 08:08:44
4805,48,3,597,77,674,4743,2021-01-14 18:14:50
4806,724,2,698,90,788,4744,2021-01-14 14:53:08
4807,212,2,898,116,1014,4745,2021-01-15 19:13:41
4808,67,1,299,38,337,4746,2021-01-15 20:58:00
4809,68,3,697,90,787,4747,2021-01-15 23:14:44
4810,262,2,748,97,845,4748,2021-01-16 07:45:57
4811,2,2,898,116,1014,4749,2021-01-15 16:03:02
4812,216,3,897,116,1013,4750,2021-01-16 00:43:55
4813,985,3,888,115,1003,4751,2021-01-15 21:39:05
4814,684,3,688,89,777,4752,2021-01-15 20:39:13
4815,374,3,1027,133,1160,4753,2021-01-15 21:48:23
4816,352,2,628,81,709,4754,2021-01-15 07:18:01
4817,218,2,1098,142,1240,4755,2021-01-15 03:35:34
4818,993,3,478,62,540,4756,2021-01-15 09:55:26
4819,446,3,827,107,934,4757,2021-01-15 09:39:12
4820,659,3,827,107,934,4758,2021-01-15 06:41:02
4821,137,3,578,75,653,4759,2021-01-16 01:51:07
4822,418,5,1595,207,1802,4760,2021-01-16 01:19:41
4823,42,3,478,62,540,4761,2021-01-16 02:26:17
4824,478,2,698,90,788,4762,2021-01-15 23:59:28
4825,835,3,847,110,957,4763,2021-01-16 00:16:40
4826,910,3,947,123,1070,4764,2021-01-15 11:08:30
4827,659,6,1466,190,1656,4765,2021-01-15 18:32:31
4828,55,3,1047,136,1183,4766,2021-01-16 11:30:08
4829,146,3,827,107,934,4767,2021-01-16 07:09:50
4830,283,3,888,115,1003,4768,2021-01-15 20:20:55
4831,507,2,429,55,484,4769,2021-01-15 07:55:45
4832,460,2,598,77,675,4770,2021-01-15 01:03:16
4833,23,3,927,120,1047,4771,2021-01-15 01:34:30
4834,467,3,747,97,844,4772,2021-01-15 02:49:23
4835,570,6,1774,230,2004,4773,2021-01-15 11:16:36
4836,676,3,727,94,821,4774,2021-01-15 13:18:33
4837,161,2,498,64,562,4775,2021-01-15 09:35:58
4838,113,3,888,115,1003,4776,2021-01-15 11:11:05
4839,438,4,1426,185,1611,4777,2021-01-15 12:52:17
4840,133,1,399,51,450,4778,2021-01-15 16:28:51
4841,129,3,1397,181,1578,4779,2021-01-15 17:27:32
4842,805,3,558,72,630,4780,2021-01-15 18:06:24
4843,767,3,688,89,777,4781,2021-01-14 18:29:05
4844,312,3,747,97,844,4782,2021-01-15 00:55:48
4845,91,3,827,107,934,4783,2021-01-14 22:46:30
4846,385,1,99,12,111,4784,2021-01-15 10:01:49
4847,251,4,1396,181,1577,4785,2021-01-15 15:49:12
4848,949,2,329,42,371,4786,2021-01-15 09:01:58
4849,430,3,808,105,913,4787,2021-01-15 08:22:56
4850,41,3,1047,136,1183,4788,2021-01-14 19:47:00
4851,375,2,898,116,1014,4789,2021-01-15 04:49:47
4852,176,2,898,116,1014,4790,2021-01-15 04:01:48
4853,313,2,898,116,1014,4791,2021-01-15 21:49:15
4854,138,2,698,90,788,4792,2021-01-15 19:31:16
4855,835,3,997,129,1126,4793,2021-01-15 22:34:32
4856,375,2,659,85,744,4794,2021-01-16 02:26:08
4857,942,2,698,90,788,4795,2021-01-16 02:13:58
4858,402,3,1127,146,1273,4796,2021-01-15 21:54:09
4859,825,3,1047,136,1183,4797,2021-01-15 19:25:32
4860,163,3,528,68,596,4798,2021-01-15 02:15:04
4861,426,3,927,120,1047,4799,2021-01-15 02:07:01
4862,399,5,1356,176,1532,4800,2021-01-15 12:43:24
4863,960,3,558,72,630,4801,2021-01-15 17:51:38
4864,60,3,827,107,934,4802,2021-01-15 15:50:19
4865,407,2,928,120,1048,4803,2021-01-15 13:41:29
4866,606,6,1325,172,1497,4804,2021-01-15 17:30:45
4867,192,6,1794,233,2027,4805,2021-01-15 18:02:50
4868,400,6,1225,159,1384,4806,2021-01-15 08:19:16
4869,701,3,1247,162,1409,4807,2021-01-14 20:08:39
4870,312,2,828,107,935,4808,2021-01-14 15:00:06
4871,701,3,647,84,731,4809,2021-01-15 21:09:25
4872,20,2,798,103,901,4810,2021-01-15 23:40:22
4873,663,2,598,77,675,4811,2021-01-15 23:31:47
4874,510,3,647,84,731,4812,2021-01-16 08:54:12
4875,594,2,898,116,1014,4813,2021-01-15 16:57:03
4876,735,3,797,103,900,4814,2021-01-16 03:22:06
4877,126,3,758,98,856,4815,2021-01-15 22:56:15
4878,950,3,597,77,674,4816,2021-01-15 23:06:58
4879,857,2,459,59,518,4817,2021-01-15 22:16:35
4880,929,3,697,90,787,4818,2021-01-15 07:23:20
4881,660,3,1247,162,1409,4819,2021-01-15 05:56:18
4882,520,2,898,116,1014,4820,2021-01-15 10:08:08
4883,954,6,1505,195,1700,4821,2021-01-15 10:51:30
4884,283,2,698,90,788,4822,2021-01-15 08:07:42
4885,81,3,608,79,687,4823,2021-01-16 04:20:27
4886,335,3,758,98,856,4824,2021-01-16 02:03:01
4887,457,3,578,75,653,4825,2021-01-16 04:34:18
4888,930,3,997,129,1126,4826,2021-01-16 02:07:22
4889,290,3,997,129,1126,4827,2021-01-16 01:36:05
4890,884,3,428,55,483,4828,2021-01-15 11:24:07
4891,11,3,747,97,844,4829,2021-01-15 21:05:33
4892,259,4,1057,137,1194,4830,2021-01-16 13:51:06
4893,602,3,608,79,687,4831,2021-01-16 07:13:32
4894,865,1,299,38,337,4832,2021-01-15 21:37:56
4895,74,2,1098,142,1240,4833,2021-01-15 09:26:07
4896,603,3,647,84,731,4834,2021-01-15 01:43:47
4897,687,2,698,90,788,4835,2021-01-15 03:06:21
4898,965,3,758,98,856,4836,2021-01-15 03:46:00
4899,226,3,528,68,596,4837,2021-01-15 11:33:22
4900,453,2,798,103,901,4838,2021-01-15 14:44:59
4901,262,6,1344,174,1518,4839,2021-01-15 09:43:51
4902,812,3,647,84,731,4840,2021-01-15 12:41:25
4903,424,3,597,77,674,4841,2021-01-15 13:45:26
4904,431,3,528,68,596,4842,2021-01-15 16:36:22
4905,826,2,898,116,1014,4843,2021-01-15 18:35:23
4906,473,2,598,77,675,4844,2021-01-15 19:15:50
4907,279,3,597,77,674,4845,2021-01-14 19:46:28
4908,758,2,659,85,744,4846,2021-01-15 02:40:28
4909,888,3,697,90,787,4847,2021-01-14 23:13:33
4910,910,3,478,62,540,4848,2021-01-15 11:14:26
4911,493,3,1127,146,1273,4849,2021-01-15 16:59:31
4912,678,2,898,116,1014,4850,2021-01-15 11:15:12
4913,137,3,478,62,540,4851,2021-01-15 09:54:27
4914,35,2,698,90,788,4852,2021-01-14 20:42:06
4915,358,3,647,84,731,4853,2021-01-15 06:15:45
4916,470,3,727,94,821,4854,2021-01-15 05:52:50
4917,27,2,898,116,1014,4855,2021-01-16 00:03:53
4918,553,3,478,62,540,4856,2021-01-15 22:09:11
4919,266,3,1127,146,1273,4857,2021-01-16 01:07:56
4920,658,3,747,97,844,4858,2021-01-16 04:29:03
4921,837,5,1147,149,1296,4859,2021-01-16 03:54:19
4922,749,2,1098,142,1240,4860,2021-01-15 22:08:32
4923,79,3,647,84,731,4861,2021-01-15 21:58:03
4924,129,3,727,94,821,4862,2021-01-15 02:21:48
4925,406,3,478,62,540,4863,2021-01-15 03:35:56
4926,700,1,399,51,450,4864,2021-01-15 14:19:03
4927,998,3,727,94,821,4865,2021-01-15 18:09:54
4928,509,3,747,97,844,4866,2021-01-15 18:09:44
4929,368,3,428,55,483,4867,2021-01-15 14:04:06
4930,251,6,1544,200,1744,4868,2021-01-15 18:11:42
4931,373,3,808,105,913,4869,2021-01-15 20:21:15
4932,813,3,697,90,787,4870,2021-01-15 09:24:42
4933,291,3,528,68,596,4871,2021-01-14 20:54:33
4934,319,2,798,103,901,4872,2021-01-14 15:09:19
4935,350,2,1098,142,1240,4873,2021-01-15 23:31:44
4936,632,3,1327,172,1499,4874,2021-01-16 01:50:38
4937,625,3,997,129,1126,4875,2021-01-16 01:43:50
4938,483,3,697,90,787,4876,2021-01-16 10:44:26
4939,326,3,747,97,844,4877,2021-01-15 19:32:21
4940,889,2,1098,142,1240,4878,2021-01-16 05:18:16
4941,454,3,1127,146,1273,4879,2021-01-15 23:49:41
4942,792,3,558,72,630,4880,2021-01-16 00:27:27
4943,383,2,548,71,619,4881,2021-01-15 23:05:57
4944,916,3,827,107,934,4882,2021-01-15 09:26:49
4945,983,3,888,115,1003,4883,2021-01-15 07:11:11
4946,913,4,627,81,708,4884,2021-01-15 10:33:07
4947,280,3,827,107,934,4885,2021-01-15 13:12:56
4948,506,2,1098,142,1240,4886,2021-01-15 08:48:26
4949,512,2,548,71,619,4887,2021-01-16 05:10:17
4950,725,2,698,90,788,4888,2021-01-16 03:20:54
4951,277,3,897,116,1013,4889,2021-01-16 06:14:15
4952,491,3,747,97,844,4890,2021-01-16 02:30:21
4953,321,3,697,90,787,4891,2021-01-16 02:31:12
4954,831,3,1247,162,1409,4892,2021-01-15 13:43:44
4955,720,4,1246,161,1407,4893,2021-01-15 21:27:15
4956,488,3,797,103,900,4894,2021-01-16 16:08:45
4957,133,2,598,77,675,4895,2021-01-16 07:19:27
4958,150,3,697,90,787,4896,2021-01-15 21:58:17
4959,507,3,1327,172,1499,4897,2021-01-15 10:49:26
4960,609,3,808,105,913,4898,2021-01-15 02:48:26
4961,595,4,1387,180,1567,4899,2021-01-15 03:49:36
4962,101,2,798,103,901,4900,2021-01-15 04:53:50
4963,562,3,758,98,856,4901,2021-01-15 13:14:38
4964,562,3,758,98,856,4901,2021-01-15 13:14:38
4965,191,2,898,116,1014,4902,2021-01-15 16:50:23
4966,823,2,498,64,562,4903,2021-01-15 09:48:04
4967,268,2,459,59,518,4904,2021-01-15 15:11:50
4968,658,3,1127,146,1273,4905,2021-01-15 13:50:30
4969,294,3,747,97,844,4906,2021-01-15 16:39:38
4970,893,3,897,116,1013,4907,2021-01-15 20:22:36
4971,460,4,1126,146,1272,4908,2021-01-15 20:50:47
4972,579,3,997,129,1126,4909,2021-01-14 19:59:24
4973,143,2,628,81,709,4910,2021-01-15 04:56:12
4974,526,2,898,116,1014,4911,2021-01-14 23:54:47
4975,644,3,597,77,674,4912,2021-01-15 13:07:29
4976,240,3,927,120,1047,4913,2021-01-15 19:43:04
4977,650,2,898,116,1014,4914,2021-01-15 12:16:55
4978,184,3,758,98,856,4915,2021-01-15 10:51:50
4979,859,2,498,64,562,4916,2021-01-14 21:05:14
4980,245,6,1405,182,1587,4917,2021-01-15 07:12:43
4981,598,2,898,116,1014,4918,2021-01-15 06:11:09
4982,986,3,528,68,596,4919,2021-01-16 00:13:39
4983,725,4,1257,163,1420,4920,2021-01-15 23:52:45
4984,964,3,1247,162,1409,4921,2021-01-16 02:27:57
4985,376,2,698,90,788,4922,2021-01-16 04:47:12
4986,282,2,598,77,675,4923,2021-01-16 05:30:02
4987,153,2,1098,142,1240,4924,2021-01-15 22:18:36
4988,543,6,1735,225,1960,4925,2021-01-16 00:44:06
4989,841,3,797,103,900,4926,2021-01-15 02:42:06
4990,249,3,478,62,540,4927,2021-01-15 04:37:23
4991,608,3,528,68,596,4928,2021-01-15 15:45:30
4992,157,2,498,64,562,4929,2021-01-15 19:45:13
4993,440,4,1326,172,1498,4930,2021-01-15 20:06:19
4994,809,3,658,85,743,4931,2021-01-15 15:24:01
4995,65,4,927,120,1047,4932,2021-01-15 19:49:40
4996,750,5,1295,168,1463,4933,2021-01-15 21:59:02
4997,606,3,578,75,653,4934,2021-01-15 10:18:42
4998,147,3,697,90,787,4935,2021-01-14 23:12:59
4999,840,2,898,116,1014,4936,2021-01-14 16:18:30
5000,451,4,1546,200,1746,4937,2021-01-16 00:40:06
5001,686,2,498,64,562,4938,2021-01-16 01:50:56
5002,330,3,1247,162,1409,4939,2021-01-16 03:46:09
5003,392,3,1047,136,1183,4940,2021-01-16 11:20:52
5004,361,3,478,62,540,4941,2021-01-15 22:11:12
5005,288,3,1027,133,1160,4942,2021-01-16 06:25:26
5006,350,1,399,51,450,4943,2021-01-16 00:52:12
5007,536,3,727,94,821,4944,2021-01-16 00:44:17
5008,989,3,1197,155,1352,4945,2021-01-15 23:39:01
5009,961,3,528,68,596,4946,2021-01-15 11:20:50
5010,65,1,699,90,789,4947,2021-01-15 09:03:14
5011,606,6,2044,265,2309,4948,2021-01-15 11:07:00
5012,606,6,2044,265,2309,4948,2021-01-15 11:07:00
5013,749,3,697,90,787,4949,2021-01-15 13:42:08
5014,986,3,758,98,856,4950,2021-01-15 11:33:28
5015,780,1,599,77,676,4951,2021-01-16 06:25:13
5016,780,1,599,77,676,4951,2021-01-16 06:25:13
5017,162,1,599,77,676,4952,2021-01-16 04:02:49
5018,61,3,827,107,934,4953,2021-01-16 07:17:45
5019,61,3,1197,155,1352,4954,2021-01-16 05:16:36
5020,603,5,1555,202,1757,4955,2021-01-16 04:11:18
5021,140,6,1935,251,2186,4956,2021-01-15 16:28:03
5022,548,3,997,129,1126,4957,2021-01-15 23:05:22
5023,196,3,688,89,777,4958,2021-01-16 17:54:13
5024,472,3,1327,172,1499,4959,2021-01-16 08:15:36
5025,973,3,597,77,674,4960,2021-01-15 22:36:07
5026,591,3,1027,133,1160,4961,2021-01-15 11:48:14
5027,215,3,478,62,540,4962,2021-01-15 05:23:44
5028,35,3,888,115,1003,4963,2021-01-15 05:53:09
5029,860,2,598,77,675,4964,2021-01-15 06:17:13
5030,474,3,647,84,731,4965,2021-01-15 14:53:54
5031,431,1,149,19,168,4966,2021-01-15 15:38:09
5032,186,3,697,90,787,4967,2021-01-15 19:24:34
5033,444,3,897,116,1013,4968,2021-01-15 11:27:08
5034,783,3,1127,146,1273,4969,2021-01-15 15:57:16
5035,977,2,598,77,675,4970,2021-01-15 15:10:11
5036,946,2,798,103,901,4971,2021-01-15 17:20:30
5037,84,3,847,110,957,4972,2021-01-15 21:27:41
5038,680,3,758,98,856,4973,2021-01-15 21:16:16
5039,367,2,628,81,709,4974,2021-01-14 22:27:49
5040,691,3,1247,162,1409,4975,2021-01-15 06:49:31
5041,378,2,659,85,744,4976,2021-01-15 00:16:30
5042,605,2,898,116,1014,4977,2021-01-15 14:01:24
5043,857,2,429,55,484,4978,2021-01-15 21:36:30
5044,865,2,429,55,484,4979,2021-01-15 14:14:38
5045,71,5,1026,133,1159,4980,2021-01-15 12:26:21
5046,922,3,888,115,1003,4981,2021-01-14 23:47:31
5047,526,3,558,72,630,4982,2021-01-15 08:47:53
5048,815,5,1326,172,1498,4983,2021-01-15 06:36:44
5049,820,3,1197,155,1352,4984,2021-01-16 00:46:15
5050,707,2,598,77,675,4985,2021-01-16 01:03:11
5051,475,3,1027,133,1160,4986,2021-01-16 02:41:52
5052,0,5,1725,224,1949,4987,2021-01-16 05:41:24
5053,494,2,598,77,675,4988,2021-01-16 06:19:36
5054,626,2,798,103,901,4989,2021-01-15 22:48:32
5055,66,3,747,97,844,4990,2021-01-16 01:21:09
5056,256,3,647,84,731,4991,2021-01-15 04:10:03
5057,609,3,697,90,787,4992,2021-01-15 06:13:59
5058,57,3,1047,136,1183,4993,2021-01-15 18:01:29
5059,630,2,898,116,1014,4994,2021-01-15 22:29:02
5060,635,3,997,129,1126,4995,2021-01-15 22:10:02
5061,80,3,797,103,900,4996,2021-01-15 16:38:11
5062,261,3,847,110,957,4997,2021-01-15 21:58:38
5063,66,3,808,105,913,4998,2021-01-15 22:19:29
5064,231,3,578,75,653,4999,2021-01-15 11:00:21
5065,276,3,1327,172,1499,5000,2021-01-14 23:29:05
5066,235,2,798,103,901,5001,2021-01-14 17:07:32
5067,896,2,498,64,562,5002,2021-01-16 01:44:28
5068,338,3,747,97,844,5003,2021-01-16 04:25:48
5069,338,3,747,97,844,5003,2021-01-16 04:25:48
5070,74,3,697,90,787,5004,2021-01-16 06:12:49
5071,588,3,647,84,731,5005,2021-01-16 12:47:44
5072,474,3,727,94,821,5006,2021-01-16 00:28:44
5073,878,5,1345,174,1519,5007,2021-01-16 08:18:51
5074,729,1,99,12,111,5008,2021-01-16 02:21:14
5075,625,1,149,19,168,5009,2021-01-16 03:24:46
5076,184,1,399,51,450,5010,2021-01-16 01:57:21
5077,933,3,897,116,1013,5011,2021-01-15 12:31:26
5078,602,3,558,72,630,5012,2021-01-15 10:05:59
5079,578,3,697,90,787,5013,2021-01-15 13:35:46
5080,711,3,688,89,777,5014,2021-01-15 12:10:18
5081,340,3,808,105,913,5015,2021-01-15 15:26:28
5082,340,3,808,105,913,5015,2021-01-15 15:26:28
5083,781,2,429,55,484,5016,2021-01-15 13:13:00
5084,429,3,888,115,1003,5017,2021-01-16 07:47:06
5085,790,3,888,115,1003,5018,2021-01-16 07:46:53
5086,395,2,898,116,1014,5019,2021-01-16 06:39:11
5087,239,3,827,107,934,5020,2021-01-16 07:57:37
5088,257,3,597,77,674,5021,2021-01-16 06:28:25
5089,811,2,329,42,371,5022,2021-01-16 05:56:24
5090,55,3,558,72,630,5023,2021-01-15 18:22:19
5091,110,4,1226,159,1385,5024,2021-01-16 01:20:16
5092,109,3,758,98,856,5025,2021-01-16 19:50:04
5093,250,3,997,129,1126,5026,2021-01-16 09:57:54
5094,612,3,1247,162,1409,5027,2021-01-15 23:35:26
5095,575,3,1047,136,1183,5028,2021-01-15 12:04:05
5096,798,2,448,58,506,5029,2021-01-15 05:38:48
5097,898,3,897,116,1013,5030,2021-01-15 06:28:39
5098,745,2,429,55,484,5031,2021-01-15 06:18:34
5099,104,3,528,68,596,5032,2021-01-15 16:03:11
5100,704,3,478,62,540,5033,2021-01-15 17:43:43
5101,322,3,1127,146,1273,5034,2021-01-15 20:36:52
5102,24,3,697,90,787,5035,2021-01-15 12:26:25
5103,6,3,847,110,957,5036,2021-01-15 17:15:59
5104,535,5,1256,163,1419,5037,2021-01-15 15:35:31
5105,779,1,229,29,258,5038,2021-01-15 20:01:47
5106,118,2,898,116,1014,5039,2021-01-15 23:18:03
5107,336,2,1098,142,1240,5040,2021-01-15 22:05:07
5108,869,2,598,77,675,5041,2021-01-15 00:41:22
5109,857,2,459,59,518,5042,2021-01-15 08:53:58
5110,318,5,987,128,1115,5043,2021-01-15 00:47:50
5111,79,3,758,98,856,5044,2021-01-15 15:48:08
5112,318,2,459,59,518,5045,2021-01-15 22:34:21
5113,1,4,1096,142,1238,5046,2021-01-15 15:04:18
5114,703,3,1247,162,1409,5047,2021-01-15 14:42:05
5115,602,3,728,94,822,5048,2021-01-15 01:50:07
5116,29,3,1327,172,1499,5049,2021-01-15 09:02:16
5117,258,3,747,97,844,5050,2021-01-15 07:15:50
5118,235,2,598,77,675,5051,2021-01-16 01:31:44
5119,151,3,727,94,821,5052,2021-01-16 01:19:43
5120,944,5,2025,263,2288,5053,2021-01-16 04:59:04
5121,266,2,1098,142,1240,5054,2021-01-16 08:21:00
5122,116,2,898,116,1014,5055,2021-01-16 07:01:12
5123,217,6,1825,237,2062,5056,2021-01-15 23:16:53
5124,537,3,1047,136,1183,5057,2021-01-16 01:48:23
5125,311,3,1197,155,1352,5058,2021-01-15 05:07:24
5126,824,3,647,84,731,5059,2021-01-15 08:13:40
5127,127,3,478,62,540,5060,2021-01-15 20:19:57
5128,280,2,548,71,619,5061,2021-01-16 00:46:30
5129,804,3,647,84,731,5062,2021-01-16 00:46:30
5130,580,2,329,42,371,5063,2021-01-15 17:36:10
5131,734,1,149,19,168,5064,2021-01-15 23:17:42
5132,237,2,459,59,518,5065,2021-01-16 01:00:10
5133,932,2,598,77,675,5066,2021-01-15 11:24:25
5134,497,2,898,116,1014,5067,2021-01-15 00:08:49
5135,224,6,1755,228,1983,5068,2021-01-14 18:12:15
5136,377,1,599,77,676,5069,2021-01-16 03:39:59
5137,715,3,1327,172,1499,5070,2021-01-16 07:03:29
5138,242,2,598,77,675,5071,2021-01-16 06:10:25
5139,349,3,1047,136,1183,5072,2021-01-16 08:55:40
5140,991,2,598,77,675,5073,2021-01-16 13:01:43
5141,82,3,608,79,687,5074,2021-01-16 01:32:05
5142,113,2,498,64,562,5075,2021-01-16 10:23:28
5143,895,3,478,62,540,5076,2021-01-16 04:49:23
5144,483,3,1127,146,1273,5077,2021-01-16 05:17:06
5145,689,3,897,116,1013,5078,2021-01-16 03:30:43
5146,559,3,528,68,596,5079,2021-01-15 14:50:07
5147,616,3,827,107,934,5080,2021-01-15 10:08:26
5148,576,3,747,97,844,5081,2021-01-15 16:10:41
5149,78,2,898,116,1014,5082,2021-01-15 14:39:16
5150,180,3,758,98,856,5083,2021-01-15 17:14:42
5151,99,5,1156,150,1306,5084,2021-01-15 15:43:40
5152,587,3,1197,155,1352,5085,2021-01-15 14:07:26
5153,172,3,697,90,787,5086,2021-01-16 08:39:07
5154,840,6,1305,169,1474,5087,2021-01-16 09:32:33
5155,654,2,659,85,744,5088,2021-01-16 07:40:54
5156,677,2,459,59,518,5089,2021-01-16 10:30:27
5157,265,2,698,90,788,5090,2021-01-16 06:49:09
5158,655,2,1098,142,1240,5091,2021-01-16 07:55:27
5159,688,3,428,55,483,5092,2021-01-15 19:38:40
5160,848,3,688,89,777,5093,2021-01-16 01:54:51
5161,486,3,808,105,913,5094,2021-01-16 21:13:59
5162,195,3,1027,133,1160,5095,2021-01-16 12:43:22
5163,532,2,659,85,744,5096,2021-01-16 02:12:52
5164,272,2,598,77,675,5097,2021-01-15 12:41:40
5165,197,5,1545,200,1745,5098,2021-01-15 05:55:28
5166,661,3,697,90,787,5099,2021-01-15 08:37:05
5167,273,2,698,90,788,5100,2021-01-15 07:57:43
5168,668,3,478,62,540,5101,2021-01-15 16:48:34
5169,579,2,598,77,675,5102,2021-01-15 20:09:26
5170,873,3,697,90,787,5103,2021-01-15 22:45:44
5171,140,5,1286,167,1453,5104,2021-01-15 13:18:49
5172,375,3,1197,155,1352,5105,2021-01-15 18:48:41
5173,270,3,847,110,957,5106,2021-01-15 16:42:13
5174,437,3,1027,133,1160,5107,2021-01-15 20:06:45
5175,666,2,459,59,518,5108,2021-01-16 00:42:57
5176,641,3,897,116,1013,5109,2021-01-15 23:29:06
5177,618,2,698,90,788,5110,2021-01-15 01:52:52
5178,243,3,747,97,844,5111,2021-01-15 09:57:27
5179,315,2,628,81,709,5112,2021-01-15 01:44:34
5180,273,3,478,62,540,5113,2021-01-15 16:58:46
5181,640,3,1127,146,1273,5114,2021-01-16 01:19:50
5182,615,3,897,116,1013,5115,2021-01-15 16:55:49
5183,53,2,498,64,562,5116,2021-01-15 17:12:34
5184,423,3,927,120,1047,5117,2021-01-15 02:25:01
5185,446,6,1305,169,1474,5118,2021-01-15 10:59:22
5186,295,3,997,129,1126,5119,2021-01-15 09:56:51
5187,188,5,1467,190,1657,5120,2021-01-16 04:16:16
5188,927,3,897,116,1013,5121,2021-01-16 02:27:45
5189,756,1,229,29,258,5122,2021-01-16 06:58:22
5190,558,2,798,103,901,5123,2021-01-16 10:02:04
5191,491,2,798,103,901,5124,2021-01-16 07:11:41
5192,987,2,659,85,744,5125,2021-01-15 23:35:36
5193,157,1,399,51,450,5126,2021-01-16 03:03:23
5194,274,3,608,79,687,5127,2021-01-15 05:21:50
5195,555,5,1795,233,2028,5128,2021-01-15 10:17:13
5196,576,1,399,51,450,5129,2021-01-15 22:16:48
5197,231,3,897,116,1013,5130,2021-01-16 02:25:26
5198,227,4,1626,211,1837,5131,2021-01-16 03:09:25
5199,524,3,1197,155,1352,5132,2021-01-15 19:17:13
5200,460,3,1127,146,1273,5133,2021-01-16 01:28:27
5201,686,3,658,85,743,5134,2021-01-16 02:22:26
5202,264,3,747,97,844,5135,2021-01-15 13:56:45
5203,647,3,797,103,900,5136,2021-01-15 02:51:55
5204,260,4,1246,161,1407,5137,2021-01-14 19:43:45
5205,801,3,1247,162,1409,5138,2021-01-16 05:55:10
5206,619,3,608,79,687,5139,2021-01-16 08:43:39
5207,439,3,1327,172,1499,5140,2021-01-16 07:42:52
5208,987,4,1007,130,1137,5141,2021-01-16 11:00:42
5209,389,3,697,90,787,5142,2021-01-16 14:24:21
5210,196,3,1127,146,1273,5143,2021-01-16 02:45:31
5211,555,2,798,103,901,5144,2021-01-16 10:48:28
5212,734,3,1127,146,1273,5145,2021-01-16 06:38:42
5213,447,2,429,55,484,5146,2021-01-16 06:02:55
5214,499,3,597,77,674,5147,2021-01-16 06:13:53
5215,78,2,928,120,1048,5148,2021-01-15 15:06:41
5216,314,3,888,115,1003,5149,2021-01-15 11:43:08
5217,710,3,428,55,483,5150,2021-01-15 16:54:28
5218,248,3,808,105,913,5151,2021-01-15 17:01:33
5219,412,3,888,115,1003,5152,2021-01-15 17:49:56
5220,656,2,898,116,1014,5153,2021-01-15 17:34:10
5221,806,3,478,62,540,5154,2021-01-15 16:35:43
5222,180,2,898,116,1014,5155,2021-01-16 10:13:27
5223,675,5,1425,185,1610,5156,2021-01-16 10:02:04
5224,311,4,1546,200,1746,5157,2021-01-16 09:30:34
5225,262,2,898,116,1014,5158,2021-01-16 12:47:10
5226,133,3,1127,146,1273,5159,2021-01-16 07:49:51
5227,397,3,1247,162,1409,5160,2021-01-16 09:47:45
5228,854,2,798,103,901,5161,2021-01-15 20:56:08
5229,94,3,647,84,731,5162,2021-01-16 03:26:07
5230,345,3,1327,172,1499,5163,2021-01-16 21:23:09
5231,753,2,528,68,596,5164,2021-01-16 14:09:55
5232,764,2,659,85,744,5165,2021-01-16 04:08:46
5233,931,3,997,129,1126,5166,2021-01-15 14:09:15
5234,402,3,608,79,687,5167,2021-01-15 07:34:08
5235,877,5,1725,224,1949,5168,2021-01-15 10:48:26
5236,464,2,698,90,788,5169,2021-01-15 10:40:28
5237,641,3,827,107,934,5170,2021-01-15 19:33:41
5238,971,1,149,19,168,5171,2021-01-15 22:22:14
5239,532,3,997,129,1126,5172,2021-01-16 00:40:16
5240,25,5,1556,202,1758,5173,2021-01-15 13:25:23
5241,126,3,597,77,674,5174,2021-01-15 18:49:00
5242,729,3,758,98,856,5175,2021-01-15 18:28:34
5243,271,3,478,62,540,5176,2021-01-15 20:14:01
5244,8,3,478,62,540,5177,2021-01-16 00:59:20
5245,395,3,1197,155,1352,5178,2021-01-16 02:01:33
5246,146,3,897,116,1013,5179,2021-01-15 04:37:28
5247,905,3,1127,146,1273,5180,2021-01-15 12:18:45
5248,588,2,598,77,675,5181,2021-01-15 03:16:35
5249,786,2,828,107,935,5182,2021-01-15 18:54:46
5250,307,3,1327,172,1499,5183,2021-01-16 01:26:28
5251,373,3,428,55,483,5184,2021-01-15 18:21:16
5252,690,2,598,77,675,5185,2021-01-15 18:38:27
5253,947,3,558,72,630,5186,2021-01-15 04:17:42
5254,190,5,1436,186,1622,5187,2021-01-15 12:56:54
5255,26,3,688,89,777,5188,2021-01-15 11:58:57
5256,529,3,747,97,844,5189,2021-01-16 05:02:46
5257,529,3,747,97,844,5189,2021-01-16 05:02:46
5258,360,3,697,90,787,5190,2021-01-16 04:12:51
5259,743,2,498,64,562,5191,2021-01-16 07:13:58
5260,114,6,1574,204,1778,5192,2021-01-16 10:38:03
5261,226,2,798,103,901,5193,2021-01-16 09:11:15
5262,250,2,459,59,518,5194,2021-01-16 01:00:53
5263,823,3,697,90,787,5195,2021-01-16 05:36:16
5264,447,3,847,110,957,5196,2021-01-15 05:47:39
5265,243,2,898,116,1014,5197,2021-01-15 11:32:00
5266,213,1,399,51,450,5198,2021-01-15 23:59:06
5267,452,3,1047,136,1183,5199,2021-01-16 04:20:07
5268,122,3,808,105,913,5200,2021-01-16 05:16:59
5269,612,3,1047,136,1183,5201,2021-01-15 20:47:27
5270,686,4,1426,185,1611,5202,2021-01-16 01:54:44
5271,223,3,608,79,687,5203,2021-01-16 03:29:43
5272,754,2,798,103,901,5204,2021-01-15 14:22:33
5273,174,2,698,90,788,5205,2021-01-15 05:14:47
5274,411,3,428,55,483,5206,2021-01-14 22:21:46
5275,668,2,429,55,484,5207,2021-01-16 08:01:55
5276,212,2,728,94,822,5208,2021-01-16 10:45:28
5277,577,2,498,64,562,5209,2021-01-16 08:26:58
5278,46,3,597,77,674,5210,2021-01-16 13:15:17
5279,305,2,828,107,935,5211,2021-01-16 16:12:25
5280,792,3,1047,136,1183,5212,2021-01-16 03:12:27
5281,677,2,798,103,901,5213,2021-01-16 11:50:49
5282,150,3,1027,133,1160,5214,2021-01-16 06:45:02
5283,828,3,658,85,743,5215,2021-01-16 07:25:17
5284,324,3,1027,133,1160,5216,2021-01-16 08:09:25
5285,624,2,598,77,675,5217,2021-01-15 15:08:18
5286,646,3,578,75,653,5218,2021-01-15 14:01:28
5287,783,3,697,90,787,5219,2021-01-15 18:16:24
5288,703,3,688,89,777,5220,2021-01-15 18:17:40
5289,892,3,1027,133,1160,5221,2021-01-15 18:27:30
5290,165,6,1575,204,1779,5222,2021-01-15 19:30:23
5291,35,4,1826,237,2063,5223,2021-01-15 16:43:19
5292,912,2,329,42,371,5224,2021-01-16 11:12:30
5293,730,3,758,98,856,5225,2021-01-16 12:13:18
5294,488,3,1047,136,1183,5226,2021-01-16 09:44:05
5295,227,2,898,116,1014,5227,2021-01-16 14:27:29
5296,107,1,99,12,111,5228,2021-01-16 07:55:54
5297,121,2,659,85,744,5229,2021-01-16 12:00:24
5298,321,2,748,97,845,5230,2021-01-15 23:39:15
5299,403,2,898,116,1014,5231,2021-01-16 06:11:08
5300,485,3,1027,133,1160,5232,2021-01-16 23:49:10
5301,10,3,847,110,957,5233,2021-01-16 16:50:21
5302,949,6,1844,239,2083,5234,2021-01-16 04:40:57
5303,860,2,598,77,675,5235,2021-01-15 14:40:07
5304,866,3,478,62,540,5236,2021-01-15 08:04:35
5305,153,3,947,123,1070,5237,2021-01-15 11:04:16
5306,598,3,608,79,687,5238,2021-01-15 12:45:12
5307,392,1,149,19,168,5239,2021-01-15 21:09:17
5308,507,5,1026,133,1159,5240,2021-01-16 00:33:11
5309,481,6,1635,212,1847,5241,2021-01-16 01:11:28
5310,252,2,598,77,675,5242,2021-01-15 14:52:12
5311,640,3,827,107,934,5243,2021-01-15 18:56:03
5312,120,1,399,51,450,5244,2021-01-15 19:55:31
5313,614,3,558,72,630,5245,2021-01-15 21:03:15
5314,240,3,1047,136,1183,5246,2021-01-16 01:59:16
5315,464,1,599,77,676,5247,2021-01-16 02:09:31
5316,187,3,428,55,483,5248,2021-01-15 05:50:48
5317,657,2,329,42,371,5249,2021-01-15 14:23:08
5318,118,3,1127,146,1273,5250,2021-01-15 04:16:36
5319,814,3,947,123,1070,5251,2021-01-15 20:12:44
5320,368,2,898,116,1014,5252,2021-01-16 04:03:38
5321,717,3,1047,136,1183,5253,2021-01-15 20:02:35
5322,254,3,558,72,630,5254,2021-01-15 21:03:38
5323,739,1,229,29,258,5255,2021-01-15 06:39:38
5324,206,3,558,72,630,5256,2021-01-15 14:50:08
5325,785,6,1855,241,2096,5257,2021-01-15 14:44:45
5326,922,2,429,55,484,5258,2021-01-16 06:05:25
5327,859,3,558,72,630,5259,2021-01-16 06:18:55
5328,730,1,499,64,563,5260,2021-01-16 06:19:53
5329,35,2,648,84,732,5261,2021-01-16 07:39:42
5330,713,5,1695,220,1915,5262,2021-01-16 11:20:08
5331,826,3,697,90,787,5263,2021-01-16 09:30:26
5332,109,3,658,85,743,5264,2021-01-16 02:28:44
5333,55,2,448,58,506,5265,2021-01-16 08:22:26
5334,222,2,748,97,845,5266,2021-01-15 08:31:01
5335,480,5,1576,204,1780,5267,2021-01-15 13:22:44
5336,497,2,498,64,562,5268,2021-01-16 02:31:07
5337,585,2,798,103,901,5269,2021-01-16 05:28:15
5338,690,3,827,107,934,5270,2021-01-16 05:26:40
5339,400,3,558,72,630,5271,2021-01-15 21:30:44
5340,584,3,697,90,787,5272,2021-01-16 03:18:11
5341,321,2,498,64,562,5273,2021-01-16 03:44:21
5342,161,3,747,97,844,5274,2021-01-15 14:54:39
5343,556,2,329,42,371,5275,2021-01-15 05:35:04
5344,571,2,798,103,901,5276,2021-01-14 23:30:19
5345,860,3,847,110,957,5277,2021-01-16 09:15:08
5346,509,3,1327,172,1499,5278,2021-01-16 11:46:46
5347,540,3,1047,136,1183,5279,2021-01-16 09:34:22
5348,777,3,727,94,821,5280,2021-01-16 15:21:46
5349,128,3,1027,133,1160,5281,2021-01-16 16:56:02
5350,756,2,698,90,788,5282,2021-01-16 03:34:58
5351,52,3,827,107,934,5283,2021-01-16 12:09:59
5352,894,2,329,42,371,5284,2021-01-16 08:03:43
5353,794,3,797,103,900,5285,2021-01-16 09:56:28
5354,77,6,1924,250,2174,5286,2021-01-16 10:49:28
5355,6,3,747,97,844,5287,2021-01-15 17:16:34
5356,848,3,608,79,687,5288,2021-01-15 16:07:01
5357,458,2,728,94,822,5289,2021-01-15 19:33:03
5358,186,1,99,12,111,5290,2021-01-15 20:36:59
5359,927,2,429,55,484,5291,2021-01-15 18:57:37
5360,568,3,478,62,540,5292,2021-01-15 20:27:02
5361,882,3,1047,136,1183,5293,2021-01-15 17:33:42
5362,226,1,699,90,789,5294,2021-01-16 12:59:31
5363,462,2,898,116,1014,5295,2021-01-16 12:19:39
5364,219,2,1098,142,1240,5296,2021-01-16 11:56:39
5365,305,2,659,85,744,5297,2021-01-16 16:15:55
5366,213,3,558,72,630,5298,2021-01-16 09:10:16
5367,871,3,847,110,957,5299,2021-01-16 12:00:56
5368,338,2,648,84,732,5300,2021-01-16 02:00:49
5369,457,1,299,38,337,5301,2021-01-16 07:40:21
5370,816,2,498,64,562,5302,2021-01-17 01:23:28
5371,683,3,727,94,821,5303,2021-01-16 16:50:39
5372,588,1,99,12,111,5304,2021-01-16 06:23:19
5373,743,1,699,90,789,5305,2021-01-15 14:52:33
5374,747,2,429,55,484,5306,2021-01-15 10:43:42
5375,288,3,558,72,630,5307,2021-01-15 12:57:11
5376,748,3,797,103,900,5308,2021-01-15 14:07:12
5377,714,3,758,98,856,5309,2021-01-15 22:54:44
5378,542,2,498,64,562,5310,2021-01-16 02:16:53
5379,939,3,1127,146,1273,5311,2021-01-16 01:37:42
5380,141,2,898,116,1014,5312,2021-01-15 15:05:21
5381,914,3,608,79,687,5313,2021-01-15 19:05:01
5382,174,2,898,116,1014,5314,2021-01-15 22:07:30
5383,703,2,1098,142,1240,5315,2021-01-15 23:30:30
5384,901,3,1327,172,1499,5316,2021-01-16 03:18:55
5385,486,2,498,64,562,5317,2021-01-16 02:39:47
5386,434,3,727,94,821,5318,2021-01-15 07:43:15
5387,192,3,428,55,483,5319,2021-01-15 15:25:01
5388,540,3,647,84,731,5320,2021-01-15 05:19:05
5389,876,2,329,42,371,5321,2021-01-15 20:54:26
5390,987,1,399,51,450,5322,2021-01-16 04:56:52
5391,235,3,808,105,913,5323,2021-01-15 22:47:56
5392,635,2,498,64,562,5324,2021-01-15 22:47:20
5393,670,2,698,90,788,5325,2021-01-15 07:15:47
5394,347,2,659,85,744,5326,2021-01-15 16:41:20
5395,150,3,558,72,630,5327,2021-01-15 16:27:35
5396,779,2,798,103,901,5328,2021-01-16 06:44:35
5397,956,2,898,116,1014,5329,2021-01-16 06:39:21
5398,641,5,1556,202,1758,5330,2021-01-16 08:01:25
5399,919,2,429,55,484,5331,2021-01-16 08:17:25
5400,221,3,727,94,821,5332,2021-01-16 11:32:05
5401,169,3,697,90,787,5333,2021-01-16 10:27:50
5402,649,3,947,123,1070,5334,2021-01-16 04:22:48
5403,372,5,2025,263,2288,5335,2021-01-16 10:24:58
5404,111,3,927,120,1047,5336,2021-01-15 09:18:10
5405,73,5,1506,195,1701,5337,2021-01-15 14:09:20
5406,990,2,598,77,675,5338,2021-01-16 04:43:36
5407,780,3,1127,146,1273,5339,2021-01-16 06:52:52
5408,119,4,1296,168,1464,5340,2021-01-16 06:25:40
5409,507,3,727,94,821,5341,2021-01-15 23:01:09
5410,464,5,1425,185,1610,5342,2021-01-16 05:22:36
5411,794,3,1127,146,1273,5343,2021-01-16 04:40:21
5412,481,3,1127,146,1273,5344,2021-01-15 15:05:41
5413,484,2,728,94,822,5345,2021-01-15 06:12:29
5414,643,3,1127,146,1273,5346,2021-01-15 01:50:12
5415,841,1,399,51,450,5347,2021-01-16 11:10:22
5416,842,2,498,64,562,5348,2021-01-16 11:57:57
5417,387,4,1157,150,1307,5349,2021-01-16 11:14:51
5418,254,2,698,90,788,5350,2021-01-16 15:52:45
5419,786,2,459,59,518,5351,2021-01-16 19:19:06
5420,196,3,1047,136,1183,5352,2021-01-16 05:33:25
5421,444,2,598,77,675,5353,2021-01-16 13:35:58
5422,211,2,698,90,788,5354,2021-01-16 09:27:16
5423,531,3,947,123,1070,5355,2021-01-16 11:03:59
5424,786,3,927,120,1047,5356,2021-01-16 11:54:02
5425,94,3,758,98,856,5357,2021-01-15 18:04:55
5426,537,3,927,120,1047,5358,2021-01-15 16:33:59
5427,747,3,597,77,674,5359,2021-01-15 21:08:46
5428,484,3,997,129,1126,5360,2021-01-15 21:24:33
5429,780,3,478,62,540,5361,2021-01-15 20:10:49
5430,263,3,428,55,483,5362,2021-01-15 20:58:53
5431,0,3,808,105,913,5363,2021-01-15 19:29:44
5432,980,2,429,55,484,5364,2021-01-16 13:43:19
5433,130,3,1197,155,1352,5365,2021-01-16 12:50:16
5434,201,5,1295,168,1463,5366,2021-01-16 14:05:43
5435,226,3,1027,133,1160,5367,2021-01-16 16:41:34
5436,535,2,598,77,675,5368,2021-01-16 10:22:02
5437,705,2,659,85,744,5369,2021-01-16 13:24:26
5438,985,3,697,90,787,5370,2021-01-16 02:39:43
5439,468,3,747,97,844,5371,2021-01-16 07:49:34
5440,266,2,329,42,371,5372,2021-01-17 03:33:10
5441,534,3,1127,146,1273,5373,2021-01-16 16:54:21
5442,195,3,658,85,743,5374,2021-01-16 09:07:02
5443,252,2,898,116,1014,5375,2021-01-15 16:19:06
5444,156,5,1106,143,1249,5376,2021-01-15 10:53:19
5445,428,2,329,42,371,5377,2021-01-15 14:59:13
5446,545,3,597,77,674,5378,2021-01-15 15:39:19
5447,413,3,428,55,483,5379,2021-01-16 00:42:12
5448,879,2,698,90,788,5380,2021-01-16 03:33:20
5449,977,2,698,90,788,5381,2021-01-16 04:19:33
5450,974,3,1327,172,1499,5382,2021-01-15 17:39:37
5451,160,3,1247,162,1409,5383,2021-01-15 20:33:10
5452,911,3,1327,172,1499,5384,2021-01-15 23:52:59
5453,256,3,727,94,821,5385,2021-01-16 01:14:21
5454,819,3,597,77,674,5386,2021-01-16 05:40:59
5455,977,3,608,79,687,5387,2021-01-16 03:35:46
5456,974,3,808,105,913,5388,2021-01-15 08:42:41
5457,441,3,947,123,1070,5389,2021-01-15 15:54:23
5458,331,2,1098,142,1240,5390,2021-01-15 07:53:05
5459,399,3,478,62,540,5391,2021-01-15 23:28:39
5460,676,2,548,71,619,5392,2021-01-16 05:59:39
5461,604,6,1635,212,1847,5393,2021-01-15 22:50:21
5462,665,2,898,116,1014,5394,2021-01-16 00:31:01
5463,752,2,528,68,596,5395,2021-01-15 08:28:27
5464,319,3,747,97,844,5396,2021-01-15 19:05:53
5465,504,3,1047,136,1183,5397,2021-01-15 16:53:28
5466,916,3,558,72,630,5398,2021-01-16 08:19:17
5467,128,6,1546,200,1746,5399,2021-01-16 07:08:19
5468,202,4,1146,148,1294,5400,2021-01-16 10:07:06
5469,403,2,459,59,518,5401,2021-01-16 08:52:43
5470,905,2,448,58,506,5402,2021-01-16 14:01:26
5471,711,3,1197,155,1352,5403,2021-01-16 12:21:12
5472,340,2,1098,142,1240,5404,2021-01-16 05:35:44
5473,563,3,747,97,844,5405,2021-01-16 10:25:23
5474,68,3,658,85,743,5406,2021-01-15 09:42:12
5475,967,3,1127,146,1273,5407,2021-01-15 15:52:14
5476,301,3,897,116,1013,5408,2021-01-16 05:51:16
5477,466,2,898,116,1014,5409,2021-01-16 07:17:18
5478,774,3,1197,155,1352,5410,2021-01-16 09:05:31
5479,938,3,1047,136,1183,5411,2021-01-15 23:09:35
5480,643,5,1755,228,1983,5412,2021-01-16 06:01:15
5481,184,3,578,75,653,5413,2021-01-16 06:05:19
5482,612,2,459,59,518,5414,2021-01-15 17:46:31
5483,474,3,827,107,934,5415,2021-01-15 07:24:44
5484,969,3,1127,146,1273,5416,2021-01-15 02:44:03
5485,837,3,897,116,1013,5417,2021-01-16 13:30:35
5486,956,2,1098,142,1240,5418,2021-01-16 13:29:36
5487,311,3,1047,136,1183,5419,2021-01-16 11:33:51
5488,76,3,1127,146,1273,5420,2021-01-16 16:01:30
5489,414,2,728,94,822,5421,2021-01-16 21:12:06
5490,475,3,1127,146,1273,5422,2021-01-16 07:47:05
5491,442,4,1296,168,1464,5423,2021-01-16 13:51:17
5492,109,3,558,72,630,5424,2021-01-16 11:21:01
5493,339,2,628,81,709,5425,2021-01-16 11:49:18
5494,299,2,798,103,901,5426,2021-01-16 12:28:13
5495,110,3,558,72,630,5427,2021-01-15 18:17:30
5496,989,3,727,94,821,5428,2021-01-15 17:49:08
5497,853,2,698,90,788,5429,2021-01-15 21:12:27
5498,626,2,598,77,675,5430,2021-01-15 23:06:19
5499,98,3,827,107,934,5431,2021-01-15 20:37:56
5500,995,3,827,107,934,5432,2021-01-15 21:48:37
5501,631,4,1526,198,1724,5433,2021-01-15 20:31:29
5502,40,4,1526,198,1724,5434,2021-01-16 14:55:45
5503,234,2,628,81,709,5435,2021-01-16 13:04:36
5504,530,2,1098,142,1240,5436,2021-01-16 15:31:59
5505,159,3,997,129,1126,5437,2021-01-16 17:19:30
5506,811,5,1306,169,1475,5438,2021-01-16 10:30:51
5507,199,2,659,85,744,5439,2021-01-16 15:43:39
5508,84,4,1396,181,1577,5440,2021-01-16 04:18:10
5509,84,4,1396,181,1577,5440,2021-01-16 04:18:10
5510,347,1,99,12,111,5441,2021-01-16 09:32:05
5511,818,2,898,116,1014,5442,2021-01-17 05:24:54
5512,442,2,898,116,1014,5443,2021-01-16 19:15:37
5513,913,3,528,68,596,5444,2021-01-16 11:48:00
5514,613,3,747,97,844,5445,2021-01-15 17:13:55
5515,176,3,847,110,957,5446,2021-01-15 11:23:29
5516,871,3,1127,146,1273,5447,2021-01-15 15:37:08
5517,457,3,1197,155,1352,5448,2021-01-15 16:21:43
5518,287,3,827,107,934,5449,2021-01-16 00:57:59
5519,606,2,698,90,788,5450,2021-01-16 04:02:34
5520,873,3,827,107,934,5451,2021-01-16 06:26:20
5521,283,4,946,122,1068,5452,2021-01-15 19:57:08
5522,968,3,1127,146,1273,5453,2021-01-15 22:26:49
5523,18,3,1047,136,1183,5454,2021-01-16 01:10:48
5524,10,3,747,97,844,5455,2021-01-16 02:40:45
5525,826,3,1247,162,1409,5456,2021-01-16 07:50:28
5526,126,2,598,77,675,5457,2021-01-16 05:27:50
5527,258,4,1276,165,1441,5458,2021-01-15 10:50:56
5528,69,3,597,77,674,5459,2021-01-15 16:11:31
5529,133,3,697,90,787,5460,2021-01-15 10:24:35
5530,117,2,898,116,1014,5461,2021-01-16 00:02:23
5531,748,4,1496,194,1690,5462,2021-01-16 06:50:46
5532,604,5,1545,200,1745,5463,2021-01-16 01:21:24
5533,474,2,598,77,675,5464,2021-01-16 01:38:56
5534,494,3,827,107,934,5465,2021-01-15 10:31:58
5535,572,3,747,97,844,5466,2021-01-15 20:25:15
5536,271,5,857,111,968,5467,2021-01-15 18:37:51
5537,782,2,598,77,675,5468,2021-01-16 08:58:12
5538,422,2,898,116,1014,5469,2021-01-16 09:53:01
5539,768,3,647,84,731,5470,2021-01-16 11:07:50
5540,2,6,2094,272,2366,5471,2021-01-16 09:29:28
5541,410,3,578,75,653,5472,2021-01-16 15:47:28
5542,95,3,897,116,1013,5473,2021-01-16 14:57:25
5543,362,3,608,79,687,5474,2021-01-16 06:54:30
5544,705,3,1047,136,1183,5475,2021-01-16 12:11:20
5545,153,2,898,116,1014,5476,2021-01-15 11:30:54
5546,25,3,888,115,1003,5477,2021-01-15 17:50:46
5547,228,4,1146,148,1294,5478,2021-01-16 06:34:21
5548,37,3,827,107,934,5479,2021-01-16 07:18:49
5549,801,3,727,94,821,5480,2021-01-16 10:51:51
5550,27,2,928,120,1048,5481,2021-01-16 01:26:57
5551,912,2,598,77,675,5482,2021-01-16 08:45:26
5552,212,3,1127,146,1273,5483,2021-01-16 06:18:52
5553,33,5,1026,133,1159,5484,2021-01-15 19:55:11
5554,741,3,797,103,900,5485,2021-01-15 10:09:45
5555,600,3,747,97,844,5486,2021-01-15 02:59:22
5556,249,3,827,107,934,5487,2021-01-16 13:41:25
5557,514,2,448,58,506,5488,2021-01-16 13:41:57
5558,849,2,548,71,619,5489,2021-01-16 13:23:16
5559,482,2,798,103,901,5490,2021-01-16 18:02:47
5560,883,3,727,94,821,5491,2021-01-16 22:17:01
5561,358,2,548,71,619,5492,2021-01-16 08:23:25
5562,384,2,659,85,744,5493,2021-01-16 14:21:07
5563,662,3,808,105,913,5494,2021-01-16 13:32:59
5564,463,2,1098,142,1240,5495,2021-01-16 14:04:02
5565,372,3,797,103,900,5496,2021-01-16 13:06:09
5566,482,3,647,84,731,5497,2021-01-15 20:43:21
5567,736,4,1227,159,1386,5498,2021-01-15 19:56:35
5568,336,2,329,42,371,5499,2021-01-15 23:33:36
5569,641,3,927,120,1047,5500,2021-01-16 01:32:29
5570,755,2,898,116,1014,5501,2021-01-15 21:55:10
5571,695,3,997,129,1126,5502,2021-01-16 00:20:25
5572,548,2,329,42,371,5503,2021-01-15 21:53:46
5573,603,4,1357,176,1533,5504,2021-01-16 16:52:24
5574,917,1,229,29,258,5505,2021-01-16 13:35:07
5575,281,3,1127,146,1273,5506,2021-01-16 18:06:13
5576,470,2,1098,142,1240,5507,2021-01-16 17:39:04
5577,780,3,608,79,687,5508,2021-01-16 11:32:17
5578,633,6,1644,213,1857,5509,2021-01-16 16:53:18
5579,655,2,598,77,675,5510,2021-01-16 05:45:15
5580,910,2,928,120,1048,5511,2021-01-16 04:55:34
5581,190,3,1047,136,1183,5512,2021-01-16 12:06:35
5582,975,3,697,90,787,5513,2021-01-17 05:45:33
5583,396,3,1027,133,1160,5514,2021-01-16 20:16:29
5584,323,6,1774,230,2004,5515,2021-01-16 12:13:47
5585,864,3,888,115,1003,5516,2021-01-15 17:58:00
5586,863,2,698,90,788,5517,2021-01-15 13:58:17
5587,194,3,847,110,957,5518,2021-01-15 16:46:03
5588,481,2,498,64,562,5519,2021-01-15 18:19:19
5589,370,5,1925,250,2175,5520,2021-01-16 02:22:59
5590,600,3,797,103,900,5521,2021-01-16 05:42:33
5591,732,2,429,55,484,5522,2021-01-16 08:17:57
5592,885,2,698,90,788,5523,2021-01-15 21:03:43
5593,782,5,1675,217,1892,5524,2021-01-15 22:58:27
5594,296,6,1125,146,1271,5525,2021-01-16 02:02:06
5595,162,3,1247,162,1409,5526,2021-01-16 04:33:22
5596,299,1,99,12,111,5527,2021-01-16 08:09:28
5597,344,5,1595,207,1802,5528,2021-01-16 07:01:59
5598,711,5,1525,198,1723,5529,2021-01-15 11:47:02
5599,254,2,798,103,901,5530,2021-01-15 16:14:46
5600,337,5,1445,187,1632,5531,2021-01-15 10:25:03
5601,15,2,798,103,901,5532,2021-01-16 00:03:38
5602,544,2,448,58,506,5533,2021-01-16 08:52:23
5603,180,3,1327,172,1499,5534,2021-01-16 03:12:33
5604,747,3,758,98,856,5535,2021-01-16 02:52:52
5605,235,3,608,79,687,5536,2021-01-15 12:49:02
5606,968,3,558,72,630,5537,2021-01-15 21:58:32
5607,875,3,428,55,483,5538,2021-01-15 18:41:20
5608,867,3,747,97,844,5539,2021-01-16 11:21:14
5609,498,3,697,90,787,5540,2021-01-16 12:29:42
5610,173,3,747,97,844,5541,2021-01-16 13:16:33
5611,587,1,99,12,111,5542,2021-01-16 10:13:10
5612,505,2,498,64,562,5543,2021-01-16 15:58:48
5613,586,5,2345,304,2649,5544,2021-01-16 15:05:02
5614,281,2,898,116,1014,5545,2021-01-16 08:34:44
5615,726,3,647,84,731,5546,2021-01-16 12:24:57
5616,198,3,927,120,1047,5547,2021-01-15 13:38:57
5617,919,3,947,123,1070,5548,2021-01-15 18:25:32
5618,105,2,498,64,562,5549,2021-01-16 07:29:14
5619,437,3,1197,155,1352,5550,2021-01-16 07:30:50
5620,289,2,598,77,675,5551,2021-01-16 12:55:35
5621,880,2,898,116,1014,5552,2021-01-16 04:13:02
5622,938,3,997,129,1126,5553,2021-01-16 09:56:26
5623,818,3,997,129,1126,5554,2021-01-16 06:56:53
5624,263,5,1186,154,1340,5555,2021-01-15 21:04:00
5625,5,3,528,68,596,5556,2021-01-15 11:32:37
5626,871,2,429,55,484,5557,2021-01-15 04:33:10
5627,537,6,1485,193,1678,5558,2021-01-16 16:00:09
5628,720,3,897,116,1013,5559,2021-01-16 15:55:21
5629,670,3,558,72,630,5560,2021-01-16 13:52:07
5630,373,3,647,84,731,5561,2021-01-16 20:42:02
5631,539,2,429,55,484,5562,2021-01-16 23:06:59
5632,732,3,947,123,1070,5563,2021-01-16 09:36:25
5633,448,2,429,55,484,5564,2021-01-16 16:12:57
5634,164,3,1127,146,1273,5565,2021-01-16 14:51:37
5635,251,3,997,129,1126,5566,2021-01-16 15:51:41
5636,344,3,847,110,957,5567,2021-01-16 14:41:59
5637,517,6,1555,202,1757,5568,2021-01-15 20:43:22
5638,919,3,1327,172,1499,5569,2021-01-15 20:25:46
5639,839,2,698,90,788,5570,2021-01-16 01:32:16
5640,598,6,1155,150,1305,5571,2021-01-16 02:29:09
5641,633,3,997,129,1126,5572,2021-01-16 00:12:46
5642,383,3,827,107,934,5573,2021-01-16 02:21:17
5643,598,3,947,123,1070,5574,2021-01-15 22:07:17
5644,157,3,1127,146,1273,5575,2021-01-16 18:17:41
5645,737,5,1026,133,1159,5576,2021-01-16 16:13:36
5646,987,3,997,129,1126,5577,2021-01-16 18:51:29
5647,824,3,608,79,687,5578,2021-01-16 18:50:46
5648,273,4,1127,146,1273,5579,2021-01-16 14:00:45
5649,264,3,697,90,787,5580,2021-01-16 17:03:09
5650,603,3,1197,155,1352,5581,2021-01-16 06:00:26
5651,67,1,229,29,258,5582,2021-01-16 07:35:18
5652,674,5,1586,206,1792,5583,2021-01-16 12:56:39
5653,247,3,688,89,777,5584,2021-01-17 07:02:23
5654,375,2,598,77,675,5585,2021-01-16 21:13:44
5655,276,2,429,55,484,5586,2021-01-16 13:28:40
5656,805,3,1327,172,1499,5587,2021-01-15 20:34:13
5657,326,4,1296,168,1464,5588,2021-01-15 14:15:16
5658,79,3,478,62,540,5589,2021-01-15 16:55:17
5659,682,2,598,77,675,5590,2021-01-15 20:48:40
5660,401,3,1127,146,1273,5591,2021-01-16 03:30:15
5661,426,2,798,103,901,5592,2021-01-16 06:50:32
5662,546,3,578,75,653,5593,2021-01-16 09:13:36
5663,682,3,528,68,596,5594,2021-01-15 21:33:50
5664,281,3,1027,133,1160,5595,2021-01-16 01:00:56
5665,794,2,659,85,744,5596,2021-01-16 04:48:08
5666,246,3,478,62,540,5597,2021-01-16 06:41:44
5667,377,3,478,62,540,5598,2021-01-16 10:07:01
5668,379,3,428,55,483,5599,2021-01-16 09:04:51
5669,125,2,598,77,675,5600,2021-01-15 14:01:58
5670,158,6,1524,198,1722,5601,2021-01-15 17:55:38
5671,257,3,997,129,1126,5602,2021-01-15 10:41:50
5672,937,3,1047,136,1183,5603,2021-01-16 01:31:55
5673,60,3,658,85,743,5604,2021-01-16 11:36:57
5674,512,2,1098,142,1240,5605,2021-01-16 05:40:44
5675,587,3,658,85,743,5606,2021-01-16 04:15:46
5676,996,4,1457,189,1646,5607,2021-01-15 15:17:46
5677,76,3,428,55,483,5608,2021-01-15 23:31:30
5678,108,3,578,75,653,5609,2021-01-15 19:51:57
5679,429,3,1027,133,1160,5610,2021-01-16 11:59:17
5680,777,3,1247,162,1409,5611,2021-01-16 14:00:48
5681,136,3,1127,146,1273,5612,2021-01-16 15:38:13
5682,985,5,1545,200,1745,5613,2021-01-16 11:58:43
5683,275,3,478,62,540,5614,2021-01-16 16:36:41
5684,495,3,947,123,1070,5615,2021-01-16 15:51:36
5685,393,3,597,77,674,5616,2021-01-16 09:06:19
5686,125,2,429,55,484,5617,2021-01-16 13:32:42
5687,838,3,608,79,687,5618,2021-01-15 16:05:26
5688,697,3,1197,155,1352,5619,2021-01-15 19:46:45
5689,925,3,997,129,1126,5620,2021-01-16 07:30:09
5690,350,3,578,75,653,5621,2021-01-16 09:38:01
5691,601,2,1098,142,1240,5622,2021-01-16 13:10:05
5692,175,2,698,90,788,5623,2021-01-16 05:05:38
5693,583,2,498,64,562,5624,2021-01-16 09:58:37
5694,403,5,1095,142,1237,5625,2021-01-16 07:50:12
5695,426,2,598,77,675,5626,2021-01-15 22:32:36
5696,1,3,927,120,1047,5627,2021-01-15 12:59:25
5697,243,5,1356,176,1532,5628,2021-01-15 05:13:07
5698,423,3,888,115,1003,5629,2021-01-16 16:24:02
5699,841,3,727,94,821,5630,2021-01-16 17:33:05
5700,778,3,528,68,596,5631,2021-01-16 14:32:12
5701,419,3,647,84,731,5632,2021-01-16 23:15:37
5702,634,3,747,97,844,5633,2021-01-16 23:53:41
5703,368,3,428,55,483,5634,2021-01-16 11:41:41
5704,937,3,927,120,1047,5635,2021-01-16 16:46:11
5705,0,3,608,79,687,5636,2021-01-16 16:47:41
5706,944,3,608,79,687,5637,2021-01-16 16:01:00
5707,88,2,728,94,822,5638,2021-01-16 16:23:19
5708,784,3,1127,146,1273,5639,2021-01-15 22:55:09
5709,922,3,827,107,934,5640,2021-01-15 22:20:40
5710,537,3,558,72,630,5641,2021-01-16 03:26:25
5711,395,5,1545,200,1745,5642,2021-01-16 04:09:47
5712,204,2,698,90,788,5643,2021-01-16 02:23:32
5713,171,3,578,75,653,5644,2021-01-16 03:32:21
5714,779,3,1127,146,1273,5645,2021-01-15 22:58:31
5715,594,3,1127,146,1273,5646,2021-01-16 20:28:20
5716,446,3,1047,136,1183,5647,2021-01-16 18:46:19
5717,513,3,1197,155,1352,5648,2021-01-16 19:53:14
5718,278,3,697,90,787,5649,2021-01-16 19:56:41
5719,921,3,997,129,1126,5650,2021-01-16 16:26:46
5720,719,3,1047,136,1183,5651,2021-01-16 18:09:35
5721,170,3,747,97,844,5652,2021-01-16 08:11:48
5722,918,3,578,75,653,5653,2021-01-16 07:45:16
5723,558,2,659,85,744,5654,2021-01-16 14:21:44
5724,22,2,329,42,371,5655,2021-01-17 09:30:35
5725,391,3,558,72,630,5656,2021-01-16 22:14:27
5726,516,5,1695,220,1915,5657,2021-01-16 14:07:04
5727,268,1,399,51,450,5658,2021-01-15 22:56:14
5728,984,2,798,103,901,5659,2021-01-15 14:53:30
5729,336,3,597,77,674,5660,2021-01-15 19:03:52
5730,584,1,399,51,450,5661,2021-01-15 22:04:30
5731,1,1,99,12,111,5662,2021-01-16 05:01:23
5732,798,3,797,103,900,5663,2021-01-16 07:45:34
5733,300,2,429,55,484,5664,2021-01-16 09:40:19
5734,241,3,808,105,913,5665,2021-01-15 23:25:24
5735,469,2,698,90,788,5666,2021-01-16 02:28:55
5736,172,3,747,97,844,5667,2021-01-16 06:41:17
5737,667,5,2055,267,2322,5668,2021-01-16 07:31:23
5738,696,6,1136,147,1283,5669,2021-01-16 12:48:00
5739,387,3,747,97,844,5670,2021-01-16 10:19:52
5740,95,2,898,116,1014,5671,2021-01-15 16:41:51
5741,323,3,558,72,630,5672,2021-01-15 19:45:17
5742,745,3,847,110,957,5673,2021-01-15 13:22:35
5743,50,3,608,79,687,5674,2021-01-16 03:00:19
5744,572,5,1545,200,1745,5675,2021-01-16 12:03:43
5745,249,5,957,124,1081,5676,2021-01-16 05:56:50
5746,626,5,1795,233,2028,5677,2021-01-16 06:22:06
5747,158,2,329,42,371,5678,2021-01-15 15:33:04
5748,530,3,827,107,934,5679,2021-01-16 00:53:35
5749,71,2,598,77,675,5680,2021-01-15 21:20:02
5750,169,3,1247,162,1409,5681,2021-01-16 13:14:48
5751,425,3,1327,172,1499,5682,2021-01-16 16:03:00
5752,194,2,659,85,744,5683,2021-01-16 16:07:55
5753,306,6,2215,287,2502,5684,2021-01-16 13:39:01
5754,549,2,798,103,901,5685,2021-01-16 17:10:57
5755,448,2,659,85,744,5686,2021-01-16 16:53:02
5756,473,5,1486,193,1679,5687,2021-01-16 09:40:13
5757,380,3,1247,162,1409,5688,2021-01-16 15:20:34
5758,277,5,1626,211,1837,5689,2021-01-15 16:41:03
5759,217,4,926,120,1046,5690,2021-01-15 22:08:54
5760,327,3,1047,136,1183,5691,2021-01-16 09:49:39
5761,246,3,1127,146,1273,5692,2021-01-16 11:20:30
5762,586,3,697,90,787,5693,2021-01-16 14:57:08
5763,422,3,1127,146,1273,5694,2021-01-16 06:00:21
5764,3,2,898,116,1014,5695,2021-01-16 11:18:58
5765,831,2,429,55,484,5696,2021-01-16 08:28:38
5766,6,2,598,77,675,5697,2021-01-16 00:48:10
5767,848,3,528,68,596,5698,2021-01-15 14:14:04
5768,499,3,827,107,934,5699,2021-01-15 07:21:40
5769,232,2,798,103,901,5700,2021-01-16 18:32:00
5770,485,6,1475,191,1666,5701,2021-01-16 18:36:35
5771,492,3,1197,155,1352,5702,2021-01-16 14:34:18
5772,176,2,748,97,845,5703,2021-01-17 00:25:58
5773,655,3,808,105,913,5704,2021-01-17 01:37:41
5774,350,3,927,120,1047,5705,2021-01-16 14:11:51
5775,345,2,898,116,1014,5706,2021-01-16 18:42:08
5776,375,2,698,90,788,5707,2021-01-16 18:05:42
5777,134,5,1195,155,1350,5708,2021-01-16 17:32:22
5778,45,2,429,55,484,5709,2021-01-16 18:22:12
5779,516,2,898,116,1014,5710,2021-01-16 00:10:55
5780,151,2,848,110,958,5711,2021-01-15 23:54:18
5781,675,3,608,79,687,5712,2021-01-16 05:07:45
5782,275,2,598,77,675,5713,2021-01-16 04:40:18
5783,17,3,1027,133,1160,5714,2021-01-16 04:26:27
5784,272,2,498,64,562,5715,2021-01-16 03:52:10
5785,321,3,827,107,934,5716,2021-01-15 23:58:48
5786,835,3,428,55,483,5717,2021-01-16 23:02:20
5787,524,3,1027,133,1160,5718,2021-01-16 21:04:36
5788,56,3,747,97,844,5719,2021-01-16 20:42:56
5789,320,3,808,105,913,5720,2021-01-16 20:12:18
5790,637,2,698,90,788,5721,2021-01-16 16:37:24
5791,785,2,898,116,1014,5722,2021-01-16 20:32:17
5792,692,1,499,64,563,5723,2021-01-16 10:11:00
5793,988,3,747,97,844,5724,2021-01-16 08:12:20
5794,584,4,1287,167,1454,5725,2021-01-16 14:37:36
5795,803,2,898,116,1014,5726,2021-01-17 10:28:50
5796,718,3,1047,136,1183,5727,2021-01-17 00:42:27
5797,195,3,1027,133,1160,5728,2021-01-16 15:43:45
5798,308,2,429,55,484,5729,2021-01-16 01:29:21
5799,614,3,578,75,653,5730,2021-01-15 15:27:17
5800,821,3,997,129,1126,5731,2021-01-15 21:41:03
5801,205,3,1247,162,1409,5732,2021-01-15 23:18:28
5802,539,1,399,51,450,5733,2021-01-16 06:36:20
5803,790,2,498,64,562,5734,2021-01-16 09:50:42
5804,495,4,977,127,1104,5735,2021-01-16 12:12:24
5805,495,4,977,127,1104,5735,2021-01-16 12:12:24
5806,921,1,99,12,111,5736,2021-01-15 23:39:09
5807,739,2,398,51,449,5737,2021-01-16 02:39:49
5808,801,3,608,79,687,5738,2021-01-16 08:27:34
5809,463,3,558,72,630,5739,2021-01-16 10:08:39
5810,835,5,1356,176,1532,5740,2021-01-16 14:55:21
5811,445,1,229,29,258,5741,2021-01-16 11:40:02
5812,823,3,997,129,1126,5742,2021-01-15 18:35:11
5813,126,3,697,90,787,5743,2021-01-15 21:34:09
5814,710,3,827,107,934,5744,2021-01-15 15:22:24
5815,710,3,827,107,934,5744,2021-01-15 15:22:24
5816,435,5,1056,137,1193,5745,2021-01-16 04:33:49
5817,858,3,827,107,934,5746,2021-01-16 14:12:31
5818,900,4,1396,181,1577,5747,2021-01-16 06:03:34
5819,545,3,947,123,1070,5748,2021-01-16 08:41:41
5820,540,1,699,90,789,5749,2021-01-15 18:19:24
5821,289,3,1247,162,1409,5750,2021-01-16 02:23:21
5822,491,3,827,107,934,5751,2021-01-15 22:23:18
5823,309,2,898,116,1014,5752,2021-01-16 14:05:43
5824,954,2,429,55,484,5753,2021-01-16 16:30:02
5825,385,3,688,89,777,5754,2021-01-16 18:20:25
5826,426,3,1127,146,1273,5755,2021-01-16 16:05:44
5827,522,3,997,129,1126,5756,2021-01-16 19:27:42
5828,62,3,697,90,787,5757,2021-01-16 19:17:56
5829,30,3,647,84,731,5758,2021-01-16 11:34:46
5830,831,2,598,77,675,5759,2021-01-16 16:49:28
5831,179,6,2044,265,2309,5760,2021-01-15 17:02:43
5832,949,3,758,98,856,5761,2021-01-16 00:38:11
5833,198,1,299,38,337,5762,2021-01-16 10:38:00
5834,480,3,697,90,787,5763,2021-01-16 12:15:38
5835,790,2,648,84,732,5764,2021-01-16 15:53:05
5836,19,4,957,124,1081,5765,2021-01-16 07:33:26
5837,842,3,647,84,731,5766,2021-01-16 11:31:05
5838,989,5,1206,156,1362,5767,2021-01-16 10:19:21
5839,757,3,428,55,483,5768,2021-01-16 02:00:13
5840,793,3,808,105,913,5769,2021-01-15 14:31:16
5841,780,2,659,85,744,5770,2021-01-15 08:58:10
5842,320,2,628,81,709,5771,2021-01-16 19:39:14
5843,795,3,428,55,483,5772,2021-01-16 20:12:48
5844,347,2,698,90,788,5773,2021-01-16 15:00:35
5845,19,2,898,116,1014,5774,2021-01-17 03:05:42
5846,553,3,1047,136,1183,5775,2021-01-17 04:03:01
5847,496,3,597,77,674,5776,2021-01-16 16:27:16
5848,43,3,478,62,540,5777,2021-01-16 18:55:22
5849,543,3,578,75,653,5778,2021-01-16 20:49:12
5850,220,3,747,97,844,5779,2021-01-16 18:47:00
5851,608,2,698,90,788,5780,2021-01-16 18:49:16
5852,997,2,898,116,1014,5781,2021-01-16 01:22:31
5853,538,2,648,84,732,5782,2021-01-16 01:18:08
5854,116,2,598,77,675,5783,2021-01-16 06:56:07
5855,648,3,1247,162,1409,5784,2021-01-16 06:13:17
5856,671,3,888,115,1003,5785,2021-01-16 05:57:08
5857,941,3,927,120,1047,5786,2021-01-16 06:15:41
5858,175,3,997,129,1126,5787,2021-01-16 00:01:41
5859,749,3,1047,136,1183,5788,2021-01-17 00:52:48
5860,328,3,558,72,630,5789,2021-01-16 23:10:21
5861,934,2,698,90,788,5790,2021-01-16 21:48:13
5862,394,2,898,116,1014,5791,2021-01-16 22:04:38
5863,230,2,1098,142,1240,5792,2021-01-16 16:42:10
5864,824,2,659,85,744,5793,2021-01-16 21:01:58
5865,66,3,697,90,787,5794,2021-01-16 12:27:10
5866,66,3,697,90,787,5794,2021-01-16 12:27:10
5867,537,2,448,58,506,5795,2021-01-16 10:08:29
5868,23,2,798,103,901,5796,2021-01-16 16:27:19
5869,768,2,898,116,1014,5797,2021-01-17 10:54:49
5870,868,3,797,103,900,5798,2021-01-17 02:27:39
5871,75,2,498,64,562,5799,2021-01-16 17:14:59
5872,260,6,1555,202,1757,5800,2021-01-16 02:57:29
5873,357,3,997,129,1126,5801,2021-01-15 17:30:19
5874,406,3,747,97,844,5802,2021-01-15 22:51:59
5875,893,6,2254,293,2547,5803,2021-01-16 00:30:32
5876,93,3,797,103,900,5804,2021-01-16 08:23:42
5877,593,2,648,84,732,5805,2021-01-16 11:32:42
5878,752,5,1495,194,1689,5806,2021-01-16 12:21:09
5879,343,3,758,98,856,5807,2021-01-16 14:25:10
5880,542,3,858,111,969,5808,2021-01-15 23:39:51
5881,930,2,598,77,675,5809,2021-01-16 04:23:12
5882,702,1,149,19,168,5810,2021-01-16 11:00:51
5883,456,3,997,129,1126,5811,2021-01-16 12:13:53
5884,261,2,898,116,1014,5812,2021-01-16 15:10:25
5885,965,2,1098,142,1240,5813,2021-01-16 13:40:25
5886,113,2,429,55,484,5814,2021-01-15 20:13:39
5887,140,6,1255,163,1418,5815,2021-01-15 23:44:13
5888,805,3,808,105,913,5816,2021-01-15 16:27:04
5889,774,3,1047,136,1183,5817,2021-01-15 17:29:10
5890,492,1,149,19,168,5818,2021-01-16 05:23:24
5891,786,3,997,129,1126,5819,2021-01-16 16:26:59
5892,41,1,599,77,676,5820,2021-01-16 06:17:36
5893,151,5,1217,158,1375,5821,2021-01-16 09:57:25
5894,799,5,1986,258,2244,5822,2021-01-15 19:31:43
5895,27,2,898,116,1014,5823,2021-01-16 03:54:05
5896,140,2,898,116,1014,5824,2021-01-16 00:07:50
5897,762,3,1327,172,1499,5825,2021-01-16 15:25:46
5898,271,2,498,64,562,5826,2021-01-16 17:30:05
5899,12,2,898,116,1014,5827,2021-01-16 21:05:18
5900,158,3,808,105,913,5828,2021-01-16 17:00:02
5901,223,5,1425,185,1610,5829,2021-01-16 21:24:32
5902,417,3,688,89,777,5830,2021-01-16 21:39:14
5903,239,3,927,120,1047,5831,2021-01-16 12:14:55
5904,140,6,1305,169,1474,5832,2021-01-16 19:20:01
5905,526,4,1396,181,1577,5833,2021-01-15 18:54:16
5906,602,2,329,42,371,5834,2021-01-16 01:34:12
5907,881,2,1098,142,1240,5835,2021-01-16 12:33:39
5908,936,3,697,90,787,5836,2021-01-16 12:28:23
5909,383,2,548,71,619,5837,2021-01-16 17:41:07
5910,237,3,658,85,743,5838,2021-01-16 09:57:50
5911,638,2,748,97,845,5839,2021-01-16 12:00:16
5912,617,3,808,105,913,5840,2021-01-16 11:26:33
5913,335,3,1047,136,1183,5841,2021-01-16 03:21:08
5914,679,3,1247,162,1409,5842,2021-01-15 14:32:08
5915,135,4,1726,224,1950,5843,2021-01-15 10:36:11
5916,135,4,1726,224,1950,5843,2021-01-15 10:36:11
5917,436,3,797,103,900,5844,2021-01-16 22:11:51
5918,462,3,558,72,630,5845,2021-01-16 22:16:38
5919,731,3,997,129,1126,5846,2021-01-16 16:16:57
5920,83,3,528,68,596,5847,2021-01-17 05:26:52
5921,460,3,697,90,787,5848,2021-01-17 06:04:51
5922,33,3,747,97,844,5849,2021-01-16 19:02:20
5923,583,3,947,123,1070,5850,2021-01-16 19:09:46
5924,81,5,1245,161,1406,5851,2021-01-16 21:51:59
5925,526,3,747,97,844,5852,2021-01-16 19:11:19
5926,63,2,698,90,788,5853,2021-01-16 20:13:05
5927,839,3,897,116,1013,5854,2021-01-16 02:43:57
5928,874,3,558,72,630,5855,2021-01-16 03:28:21
5929,992,2,459,59,518,5856,2021-01-16 08:41:47
5930,346,2,628,81,709,5857,2021-01-16 08:49:14
5931,214,4,1057,137,1194,5858,2021-01-16 06:03:02
5932,146,2,329,42,371,5859,2021-01-16 07:07:52
5933,68,3,478,62,540,5860,2021-01-16 00:50:59
5934,354,3,428,55,483,5861,2021-01-17 01:53:17
5935,136,3,897,116,1013,5862,2021-01-16 23:30:08
5936,957,3,947,123,1070,5863,2021-01-16 22:24:24
5937,856,3,997,129,1126,5864,2021-01-16 22:05:17
5938,726,3,797,103,900,5865,2021-01-16 17:35:17
5939,767,3,897,116,1013,5866,2021-01-16 21:02:09
5940,899,2,429,55,484,5867,2021-01-16 14:20:42
5941,819,5,1645,213,1858,5868,2021-01-16 14:40:53
5942,174,2,459,59,518,5869,2021-01-16 12:04:58
5943,521,3,428,55,483,5870,2021-01-16 19:06:43
5944,218,3,558,72,630,5871,2021-01-17 11:07:15
5945,716,1,149,19,168,5872,2021-01-17 04:42:52
5946,353,3,888,115,1003,5873,2021-01-16 18:56:18
5947,986,4,1626,211,1837,5874,2021-01-16 03:43:26
5948,177,2,898,116,1014,5875,2021-01-15 19:41:11
5949,2,3,1027,133,1160,5876,2021-01-16 01:23:08
5950,215,3,688,89,777,5877,2021-01-16 02:24:20
5951,578,3,478,62,540,5878,2021-01-16 09:06:27
5952,747,3,1327,172,1499,5879,2021-01-16 12:09:38
5953,545,3,1247,162,1409,5880,2021-01-16 12:33:12
5954,771,3,688,89,777,5881,2021-01-16 16:39:05
5955,115,2,498,64,562,5882,2021-01-15 23:42:13
5956,588,3,927,120,1047,5883,2021-01-16 06:06:23
5957,938,1,99,12,111,5884,2021-01-16 12:02:54
5958,666,3,428,55,483,5885,2021-01-16 12:57:25
5959,915,3,528,68,596,5886,2021-01-16 17:17:45
5960,952,3,1047,136,1183,5887,2021-01-16 14:34:30
5961,512,3,927,120,1047,5888,2021-01-15 22:34:17
5962,360,3,697,90,787,5889,2021-01-16 00:55:06
5963,18,3,658,85,743,5890,2021-01-15 19:09:24
5964,773,1,499,64,563,5891,2021-01-15 18:19:36
5965,26,3,797,103,900,5892,2021-01-16 06:54:06
5966,199,3,927,120,1047,5893,2021-01-16 16:49:03
5967,19,3,597,77,674,5894,2021-01-16 07:43:04
5968,366,4,1596,207,1803,5895,2021-01-16 10:41:53
5969,60,3,1047,136,1183,5896,2021-01-15 20:23:40
5970,303,3,747,97,844,5897,2021-01-16 05:01:46
5971,799,3,747,97,844,5898,2021-01-16 02:01:19
5972,721,2,598,77,675,5899,2021-01-16 17:14:12
5973,258,2,898,116,1014,5900,2021-01-16 20:06:38
5974,617,2,698,90,788,5901,2021-01-16 22:38:14
5975,521,2,459,59,518,5902,2021-01-16 17:18:48
5976,456,3,647,84,731,5903,2021-01-16 23:14:19
5977,783,2,598,77,675,5904,2021-01-17 00:14:54
5978,934,3,608,79,687,5905,2021-01-16 13:26:44
5979,768,2,698,90,788,5906,2021-01-16 20:00:21
5980,151,1,149,19,168,5907,2021-01-15 19:25:57
5981,704,5,1745,226,1971,5908,2021-01-16 04:17:54
5982,954,2,728,94,822,5909,2021-01-16 14:57:16
5983,877,3,997,129,1126,5910,2021-01-16 14:32:08
5984,441,5,1545,200,1745,5911,2021-01-16 18:15:59
5985,316,6,1774,230,2004,5912,2021-01-16 10:53:21
5986,713,2,429,55,484,5913,2021-01-16 12:48:37
5987,868,3,1027,133,1160,5914,2021-01-16 14:03:43
5988,876,2,748,97,845,5915,2021-01-16 05:47:39
5989,343,3,888,115,1003,5916,2021-01-15 16:27:38
5990,514,1,149,19,168,5917,2021-01-15 11:41:38
5991,68,3,1047,136,1183,5918,2021-01-15 11:21:08
5992,436,4,796,103,899,5919,2021-01-16 23:49:40
5993,808,2,798,103,901,5920,2021-01-16 22:28:02
5994,91,2,598,77,675,5921,2021-01-16 18:51:25
5995,80,2,898,116,1014,5922,2021-01-17 06:57:42
5996,948,3,827,107,934,5923,2021-01-17 08:31:15
5997,524,3,688,89,777,5924,2021-01-16 20:50:16
5998,308,3,888,115,1003,5925,2021-01-16 19:28:04
5999,308,3,888,115,1003,5925,2021-01-16 19:28:04
6000,984,3,1047,136,1183,5926,2021-01-17 00:24:38
6001,939,3,747,97,844,5927,2021-01-16 20:00:00
6002,444,3,1047,136,1183,5928,2021-01-16 21:46:02
6003,635,3,758,98,856,5929,2021-01-16 03:48:41
6004,995,3,997,129,1126,5930,2021-01-16 05:41:41
6005,585,2,659,85,744,5931,2021-01-16 09:44:30
6006,483,3,808,105,913,5932,2021-01-16 10:10:36
6007,404,2,329,42,371,5933,2021-01-16 07:33:08
6008,514,3,758,98,856,5934,2021-01-16 08:09:25
6009,547,3,1327,172,1499,5935,2021-01-16 02:04:31
6010,185,2,628,81,709,5936,2021-01-17 03:40:34
6011,468,3,997,129,1126,5937,2021-01-17 01:48:35
6012,902,3,847,110,957,5938,2021-01-16 23:34:52
6013,663,3,658,85,743,5939,2021-01-16 23:37:15
6014,300,2,1098,142,1240,5940,2021-01-16 18:51:09
6015,881,3,1127,146,1273,5941,2021-01-16 21:06:22
6016,587,5,1755,228,1983,5942,2021-01-16 16:06:56
6017,514,3,747,97,844,5943,2021-01-16 15:56:14
6018,334,2,798,103,901,5944,2021-01-16 14:23:49
6019,948,3,608,79,687,5945,2021-01-16 20:06:27
6020,367,3,747,97,844,5946,2021-01-17 12:51:26
6021,248,3,697,90,787,5947,2021-01-17 05:54:49
6022,562,2,429,55,484,5948,2021-01-16 19:05:19
6023,515,5,1237,160,1397,5949,2021-01-16 04:13:37
6024,560,2,798,103,901,5950,2021-01-15 20:28:33
6025,162,3,927,120,1047,5951,2021-01-16 01:39:53
6026,411,4,1946,252,2198,5952,2021-01-16 03:17:27
6027,736,2,748,97,845,5953,2021-01-16 11:18:11
6028,120,3,808,105,913,5954,2021-01-16 14:22:40
6029,485,5,1695,220,1915,5955,2021-01-16 14:48:14
6030,268,5,1406,182,1588,5956,2021-01-16 18:34:51
6031,774,3,997,129,1126,5957,2021-01-16 00:36:27
6032,253,2,598,77,675,5958,2021-01-16 08:51:27
6033,774,3,758,98,856,5959,2021-01-16 13:53:13
6034,519,2,1098,142,1240,5960,2021-01-16 12:58:19
6035,107,3,688,89,777,5961,2021-01-16 18:05:21
6036,438,3,658,85,743,5962,2021-01-16 16:48:02
6037,390,1,229,29,258,5963,2021-01-16 00:42:46
6038,673,3,1047,136,1183,5964,2021-01-16 03:02:32
6039,720,2,459,59,518,5965,2021-01-15 20:31:24
6040,286,1,499,64,563,5966,2021-01-15 20:44:19
6041,773,5,2225,289,2514,5967,2021-01-16 07:56:54
6042,519,2,329,42,371,5968,2021-01-16 16:50:33
6043,318,2,848,110,958,5969,2021-01-16 07:55:37
6044,348,3,1197,155,1352,5970,2021-01-16 11:26:12
6045,702,3,947,123,1070,5971,2021-01-15 21:26:32
6046,243,5,1456,189,1645,5972,2021-01-16 06:20:12
6047,956,2,429,55,484,5973,2021-01-16 04:03:28
6048,346,2,659,85,744,5974,2021-01-16 19:06:47
6049,491,5,1137,147,1284,5975,2021-01-16 21:32:35
6050,311,3,997,129,1126,5976,2021-01-17 00:29:38
6051,831,2,329,42,371,5977,2021-01-16 18:55:15
6052,351,3,688,89,777,5978,2021-01-16 23:14:29
6053,594,3,1027,133,1160,5979,2021-01-17 01:23:39
6054,330,2,329,42,371,5980,2021-01-16 15:45:16
6055,102,1,399,51,450,5981,2021-01-16 20:50:54
6056,865,1,299,38,337,5982,2021-01-15 20:05:01
6057,532,1,699,90,789,5983,2021-01-16 04:54:31
6058,752,3,827,107,934,5984,2021-01-16 15:13:26
6059,684,3,647,84,731,5985,2021-01-16 16:27:20
6060,437,3,658,85,743,5986,2021-01-16 20:46:18
6061,775,2,598,77,675,5987,2021-01-16 11:09:20
6062,667,1,399,51,450,5988,2021-01-16 14:44:45
6063,888,2,898,116,1014,5989,2021-01-16 16:00:00
6064,873,1,499,64,563,5990,2021-01-16 06:39:42
6065,67,3,1047,136,1183,5991,2021-01-15 18:02:26
6066,12,2,459,59,518,5992,2021-01-15 13:49:49
6067,862,3,558,72,630,5993,2021-01-15 12:28:04
6068,724,3,597,77,674,5994,2021-01-17 01:42:59
6069,95,3,747,97,844,5995,2021-01-17 00:06:08
6070,128,2,798,103,901,5996,2021-01-16 18:58:13
6071,105,4,877,114,991,5997,2021-01-17 09:15:08
6072,569,3,727,94,821,5998,2021-01-17 10:44:23
6073,755,2,659,85,744,5999,2021-01-16 21:18:32
6074,189,2,698,90,788,6000,2021-01-16 22:07:59
6075,549,3,847,110,957,6001,2021-01-16 20:31:13
6076,196,3,1027,133,1160,6002,2021-01-17 01:05:51
6077,233,2,898,116,1014,6003,2021-01-16 22:31:33
6078,926,2,798,103,901,6004,2021-01-17 00:18:15
6079,752,3,1197,155,1352,6005,2021-01-16 04:29:41
6080,670,3,888,115,1003,6006,2021-01-16 07:43:30
6081,989,3,827,107,934,6007,2021-01-16 11:12:57
6082,133,3,808,105,913,6008,2021-01-16 10:23:38
6083,204,2,598,77,675,6009,2021-01-16 07:34:04
6084,690,6,1644,213,1857,6010,2021-01-16 10:06:26
6085,869,3,1127,146,1273,6011,2021-01-16 03:52:15
6086,491,3,847,110,957,6012,2021-01-17 04:57:26
6087,360,3,897,116,1013,6013,2021-01-17 02:27:53
6088,968,5,1725,224,1949,6014,2021-01-16 23:56:55
6089,920,3,808,105,913,6015,2021-01-17 01:37:15
6090,136,1,229,29,258,6016,2021-01-16 21:20:27
6091,931,3,697,90,787,6017,2021-01-16 22:03:04
6092,463,2,898,116,1014,6018,2021-01-16 18:45:02
6093,558,3,688,89,777,6019,2021-01-16 17:09:36
6094,100,3,727,94,821,6020,2021-01-16 16:26:41
6095,486,3,1197,155,1352,6021,2021-01-16 20:23:17
6096,845,3,428,55,483,6022,2021-01-17 14:58:18
6097,535,2,828,107,935,6023,2021-01-17 06:26:30
6098,476,3,697,90,787,6024,2021-01-16 19:55:44
6099,317,2,698,90,788,6025,2021-01-16 04:46:40
6100,573,4,1326,172,1498,6026,2021-01-15 22:48:05
6101,573,4,1326,172,1498,6026,2021-01-15 22:48:05
6102,926,2,459,59,518,6027,2021-01-16 02:05:04
6103,348,3,808,105,913,6028,2021-01-16 05:22:09
6104,876,3,528,68,596,6029,2021-01-16 12:17:15
6105,538,3,578,75,653,6030,2021-01-16 14:47:30
6106,771,3,947,123,1070,6031,2021-01-16 16:26:08
6107,203,5,1106,143,1249,6032,2021-01-16 19:35:43
6108,43,2,848,110,958,6033,2021-01-16 03:08:00
6109,900,3,528,68,596,6034,2021-01-16 10:12:45
6110,900,3,528,68,596,6034,2021-01-16 10:12:45
6111,31,1,399,51,450,6035,2021-01-16 15:41:12
6112,484,2,329,42,371,6036,2021-01-16 15:03:41
6113,739,2,598,77,675,6037,2021-01-16 18:05:21
6114,30,3,528,68,596,6038,2021-01-16 19:23:04
6115,14,3,997,129,1126,6039,2021-01-16 02:45:40
6116,2,3,528,68,596,6040,2021-01-16 04:25:00
6117,933,2,528,68,596,6041,2021-01-15 21:04:32
6118,455,3,927,120,1047,6042,2021-01-15 22:00:40
6119,546,2,459,59,518,6043,2021-01-16 08:08:33
6120,486,5,1256,163,1419,6044,2021-01-16 18:12:59
6121,906,2,548,71,619,6045,2021-01-16 09:56:34
6122,578,3,827,107,934,6046,2021-01-16 13:19:20
6123,650,2,548,71,619,6047,2021-01-15 23:10:28
6124,49,2,429,55,484,6048,2021-01-16 07:39:47
6125,345,2,898,116,1014,6049,2021-01-16 06:44:53
6126,920,3,1127,146,1273,6050,2021-01-16 21:13:40
6127,352,2,598,77,675,6051,2021-01-16 23:40:14
6128,685,3,1327,172,1499,6052,2021-01-17 01:12:58
6129,30,3,927,120,1047,6053,2021-01-16 19:34:29
6130,982,2,698,90,788,6054,2021-01-17 01:32:25
6131,272,2,459,59,518,6055,2021-01-17 02:28:55
6132,267,2,698,90,788,6056,2021-01-16 16:22:31
6133,718,3,658,85,743,6057,2021-01-16 22:41:14
6134,5,1,399,51,450,6058,2021-01-15 21:25:03
6135,130,3,558,72,630,6059,2021-01-16 06:36:42
6136,801,3,528,68,596,6060,2021-01-16 17:23:15
6137,329,2,748,97,845,6061,2021-01-16 18:42:22
6138,579,2,459,59,518,6062,2021-01-16 23:14:37
6139,45,4,1177,153,1330,6063,2021-01-16 12:23:06
6140,738,3,927,120,1047,6064,2021-01-16 17:25:56
6141,544,3,528,68,596,6065,2021-01-16 16:06:52
6142,543,3,747,97,844,6066,2021-01-16 06:44:22
6143,742,3,827,107,934,6067,2021-01-15 19:39:26
6144,689,3,747,97,844,6068,2021-01-15 15:56:05
6145,107,3,558,72,630,6069,2021-01-15 12:32:13
6146,50,2,498,64,562,6070,2021-01-17 04:04:41
6147,399,3,558,72,630,6071,2021-01-17 02:52:23
6148,135,2,1098,142,1240,6072,2021-01-16 20:24:29
6149,937,2,459,59,518,6073,2021-01-17 11:26:11
6150,35,3,597,77,674,6074,2021-01-17 13:11:51
6151,369,3,808,105,913,6075,2021-01-17 00:03:24
6152,813,4,1726,224,1950,6076,2021-01-16 23:07:00
6153,435,2,898,116,1014,6077,2021-01-16 21:25:00
6154,208,3,658,85,743,6078,2021-01-17 02:14:24
6155,617,2,698,90,788,6079,2021-01-16 22:44:48
6156,365,3,927,120,1047,6080,2021-01-17 01:04:33
6157,468,3,897,116,1013,6081,2021-01-16 04:50:44
6158,417,3,947,123,1070,6082,2021-01-16 07:47:30
6159,468,2,1098,142,1240,6083,2021-01-16 11:38:27
6160,872,3,827,107,934,6084,2021-01-16 12:16:25
6161,761,5,1295,168,1463,6085,2021-01-16 09:06:50
6162,428,3,558,72,630,6086,2021-01-16 12:09:30
6163,124,2,498,64,562,6087,2021-01-16 05:45:36
6164,250,5,1925,250,2175,6088,2021-01-17 05:23:32
6165,239,2,498,64,562,6089,2021-01-17 05:11:48
6166,343,4,1346,174,1520,6090,2021-01-17 00:57:32
6167,540,3,888,115,1003,6091,2021-01-17 04:04:30
6168,98,2,698,90,788,6092,2021-01-16 23:04:25
6169,678,2,498,64,562,6093,2021-01-16 23:33:26
6170,926,1,99,12,111,6094,2021-01-16 20:48:28
6171,738,3,808,105,913,6095,2021-01-16 18:33:45
6172,916,2,1098,142,1240,6096,2021-01-16 18:28:18
6173,975,6,2124,276,2400,6097,2021-01-16 22:18:52
6174,887,3,1247,162,1409,6098,2021-01-17 16:14:24
6175,487,1,99,12,111,6099,2021-01-17 07:19:09
6176,500,3,827,107,934,6100,2021-01-16 21:25:00
6177,200,2,898,116,1014,6101,2021-01-16 06:05:10
6178,30,3,997,129,1126,6102,2021-01-16 01:04:53
6179,261,3,927,120,1047,6103,2021-01-16 01:08:29
6180,573,3,597,77,674,6104,2021-01-16 02:55:20
6181,717,2,498,64,562,6105,2021-01-16 05:25:32
6182,688,3,827,107,934,6106,2021-01-16 14:48:58
6183,441,3,1127,146,1273,6107,2021-01-16 16:05:22
6184,541,3,927,120,1047,6108,2021-01-16 18:14:05
6185,298,5,1845,239,2084,6109,2021-01-16 22:02:55
6186,152,4,1426,185,1611,6110,2021-01-16 04:33:19
6187,888,3,727,94,821,6111,2021-01-16 11:11:23
6188,94,2,598,77,675,6112,2021-01-16 12:53:36
6189,765,3,897,116,1013,6113,2021-01-16 15:56:48
6190,176,6,1805,234,2039,6114,2021-01-16 16:39:35
6191,534,2,798,103,901,6115,2021-01-16 18:42:18
6192,957,2,329,42,371,6116,2021-01-16 20:53:53
6193,69,3,827,107,934,6117,2021-01-16 04:11:17
6194,478,3,727,94,821,6118,2021-01-16 06:02:17
6195,417,2,748,97,845,6119,2021-01-15 21:45:37
6196,84,5,1925,250,2175,6120,2021-01-16 00:34:17
6197,551,5,1306,169,1475,6121,2021-01-16 10:05:08
6198,153,2,898,116,1014,6122,2021-01-16 19:21:48
6199,99,3,1127,146,1273,6123,2021-01-16 10:58:43
6200,996,2,898,116,1014,6124,2021-01-16 15:29:37
6201,634,3,1047,136,1183,6125,2021-01-16 01:47:19
6202,514,3,528,68,596,6126,2021-01-16 09:46:49
6203,870,2,429,55,484,6127,2021-01-16 07:51:16
6204,377,6,1955,254,2209,6128,2021-01-16 23:49:56
6205,69,2,698,90,788,6129,2021-01-17 01:46:17
6206,229,3,827,107,934,6130,2021-01-17 01:41:02
6207,584,3,688,89,777,6131,2021-01-16 21:33:21
6208,944,3,558,72,630,6132,2021-01-17 03:58:44
6209,709,3,758,98,856,6133,2021-01-17 03:48:54
6210,269,5,1217,158,1375,6134,2021-01-16 17:43:57
6211,437,5,1775,230,2005,6135,2021-01-16 22:54:27
6212,681,3,997,129,1126,6136,2021-01-15 22:04:36
6213,931,6,1275,165,1440,6137,2021-01-16 07:13:09
6214,429,5,1456,189,1645,6138,2021-01-16 18:34:57
6215,336,3,1127,146,1273,6139,2021-01-16 20:18:09
6216,352,2,429,55,484,6140,2021-01-16 23:15:00
6217,151,2,459,59,518,6141,2021-01-16 12:56:46
6218,331,2,498,64,562,6142,2021-01-16 19:14:37
6219,441,3,558,72,630,6143,2021-01-16 17:41:39
6220,805,2,329,42,371,6144,2021-01-16 07:42:59
6221,566,3,758,98,856,6145,2021-01-15 20:30:06
6222,83,6,1405,182,1587,6146,2021-01-15 17:14:12
6223,676,3,578,75,653,6147,2021-01-15 12:47:54
6224,132,3,608,79,687,6148,2021-01-17 06:42:25
6225,685,3,847,110,957,6149,2021-01-17 03:37:59
6226,761,2,498,64,562,6150,2021-01-16 21:41:59
6227,982,5,1955,254,2209,6151,2021-01-17 12:16:10
6228,152,3,1247,162,1409,6152,2021-01-17 15:48:14
6229,438,3,727,94,821,6153,2021-01-17 00:03:30
6230,627,2,548,71,619,6154,2021-01-16 23:16:42
6231,376,1,699,90,789,6155,2021-01-16 21:37:03
6232,878,3,647,84,731,6156,2021-01-17 03:30:11
6233,931,2,598,77,675,6157,2021-01-16 23:47:41
6234,689,3,827,107,934,6158,2021-01-17 03:37:20
6235,663,3,558,72,630,6159,2021-01-16 05:16:45
6236,929,3,1247,162,1409,6160,2021-01-16 10:06:48
6237,767,2,459,59,518,6161,2021-01-16 12:00:38
6238,833,3,1247,162,1409,6162,2021-01-16 14:22:35
6239,598,2,498,64,562,6163,2021-01-16 10:13:40
6240,477,2,429,55,484,6164,2021-01-16 12:20:38
6241,382,2,898,116,1014,6165,2021-01-16 06:13:57
6242,127,3,997,129,1126,6166,2021-01-17 07:30:22
6243,629,2,659,85,744,6167,2021-01-17 06:56:24
6244,449,3,558,72,630,6168,2021-01-17 01:03:40
6245,399,2,898,116,1014,6169,2021-01-17 06:36:32
6246,950,5,1056,137,1193,6170,2021-01-16 23:28:27
6247,432,3,927,120,1047,6171,2021-01-17 01:42:17
6248,62,3,478,62,540,6172,2021-01-16 22:36:19
6249,344,2,628,81,709,6173,2021-01-16 19:21:08
6250,764,3,747,97,844,6174,2021-01-16 18:46:42
6251,886,1,229,29,258,6175,2021-01-17 00:00:42
6252,647,3,558,72,630,6176,2021-01-17 18:25:20
6253,717,3,888,115,1003,6177,2021-01-17 08:47:30
6254,821,2,798,103,901,6178,2021-01-16 23:09:12
6255,810,1,149,19,168,6179,2021-01-16 06:24:51
6256,286,3,897,116,1013,6180,2021-01-16 03:51:27
6257,285,3,608,79,687,6181,2021-01-16 03:27:26
6258,29,2,429,55,484,6182,2021-01-16 05:31:35
6259,377,3,558,72,630,6183,2021-01-16 07:14:23
6260,599,5,1525,198,1723,6184,2021-01-16 16:06:34
6261,172,3,997,129,1126,6185,2021-01-16 16:39:20
6262,41,3,1047,136,1183,6186,2021-01-16 19:58:35
6263,403,2,598,77,675,6187,2021-01-16 23:34:35
6264,744,3,528,68,596,6188,2021-01-16 05:46:11
6265,86,2,1098,142,1240,6189,2021-01-16 13:20:52
6266,67,2,898,116,1014,6190,2021-01-16 15:35:17
6267,823,2,429,55,484,6191,2021-01-16 17:13:34
6268,223,6,1675,217,1892,6192,2021-01-16 17:34:59
6269,88,3,1327,172,1499,6193,2021-01-16 21:21:01
6270,804,3,578,75,653,6194,2021-01-16 23:30:25
6271,693,3,578,75,653,6195,2021-01-16 06:54:41
6272,540,5,1725,224,1949,6196,2021-01-16 08:28:01
6273,656,5,1695,220,1915,6197,2021-01-15 23:47:00
6274,551,2,459,59,518,6198,2021-01-16 02:56:13
6275,0,5,1376,178,1554,6199,2021-01-16 11:13:46
6276,961,3,1127,146,1273,6200,2021-01-16 20:05:58
6277,152,5,1575,204,1779,6201,2021-01-16 11:12:35
6278,650,3,558,72,630,6202,2021-01-16 16:17:09
6279,334,2,698,90,788,6203,2021-01-16 02:59:34
6280,608,1,229,29,258,6204,2021-01-16 10:29:25
6281,340,3,658,85,743,6205,2021-01-16 09:50:59
6282,781,3,747,97,844,6206,2021-01-17 01:05:25
6283,380,2,429,55,484,6207,2021-01-17 03:25:54
6284,605,3,847,110,957,6208,2021-01-17 03:20:57
6285,106,2,459,59,518,6209,2021-01-16 22:54:56
6286,130,2,928,120,1048,6210,2021-01-17 04:29:06
6287,371,2,698,90,788,6211,2021-01-17 05:26:33
6288,570,2,928,120,1048,6212,2021-01-16 18:37:52
6289,850,3,697,90,787,6213,2021-01-17 00:45:25
6290,457,6,1694,220,1914,6214,2021-01-15 22:27:15
6291,717,3,997,129,1126,6215,2021-01-16 09:46:26
6292,184,3,608,79,687,6216,2021-01-16 20:09:47
6293,176,2,498,64,562,6217,2021-01-16 22:58:10
6294,387,2,598,77,675,6218,2021-01-17 00:05:17
6295,958,3,428,55,483,6219,2021-01-16 15:19:16
6296,326,5,1855,241,2096,6220,2021-01-16 21:35:42
6297,296,2,459,59,518,6221,2021-01-16 18:00:42
6298,625,3,808,105,913,6222,2021-01-16 10:21:39
6299,712,3,478,62,540,6223,2021-01-15 21:14:09
6300,974,3,747,97,844,6224,2021-01-15 18:58:59
6301,54,2,659,85,744,6225,2021-01-15 14:00:29
6302,528,3,827,107,934,6226,2021-01-17 07:07:21
6303,81,3,947,123,1070,6227,2021-01-17 04:41:50
6304,819,3,658,85,743,6228,2021-01-16 22:50:08
6305,955,5,1786,232,2018,6229,2021-01-17 14:36:41
6306,457,3,1197,155,1352,6230,2021-01-17 17:24:09
6307,575,4,807,104,911,6231,2021-01-17 00:35:10
6308,923,2,459,59,518,6232,2021-01-16 23:51:17
6309,34,3,1127,146,1273,6233,2021-01-16 22:15:45
6310,86,3,927,120,1047,6234,2021-01-17 04:31:22
6311,760,3,797,103,900,6235,2021-01-17 01:55:19
6312,86,4,1407,182,1589,6236,2021-01-17 05:58:40
6313,539,3,1127,146,1273,6237,2021-01-16 07:13:55
6314,911,3,1127,146,1273,6238,2021-01-16 10:28:26
6315,667,2,329,42,371,6239,2021-01-16 12:26:50
6316,879,2,798,103,901,6240,2021-01-16 16:59:58
6317,464,3,747,97,844,6241,2021-01-16 11:02:04
6318,497,2,659,85,744,6242,2021-01-16 14:01:04
6319,844,3,747,97,844,6243,2021-01-16 07:21:53
6320,519,3,608,79,687,6244,2021-01-17 07:39:09
6321,267,3,1047,136,1183,6245,2021-01-17 07:30:48
6322,361,3,647,84,731,6246,2021-01-17 03:09:47
6323,346,3,747,97,844,6247,2021-01-17 06:38:53
6324,155,3,1027,133,1160,6248,2021-01-17 00:23:16
6325,362,3,578,75,653,6249,2021-01-17 02:43:43
6326,159,5,1656,215,1871,6250,2021-01-16 22:53:40
6327,377,2,628,81,709,6251,2021-01-16 20:43:12
6328,880,3,847,110,957,6252,2021-01-16 19:07:47
6329,566,3,997,129,1126,6253,2021-01-17 02:29:44
6330,106,3,647,84,731,6254,2021-01-17 20:28:14
6331,481,3,697,90,787,6255,2021-01-17 09:30:41
6332,521,2,798,103,901,6256,2021-01-16 23:18:36
6333,628,3,808,105,913,6257,2021-01-16 07:37:42
6334,3,3,1027,133,1160,6258,2021-01-16 05:37:17
6335,695,3,797,103,900,6259,2021-01-16 04:28:08
6336,112,3,428,55,483,6260,2021-01-16 07:18:56
6337,517,3,658,85,743,6261,2021-01-16 08:20:23
6338,977,2,329,42,371,6262,2021-01-16 17:32:08
6339,715,2,598,77,675,6263,2021-01-16 18:49:38
6340,268,3,558,72,630,6264,2021-01-16 21:25:44
6341,634,3,1127,146,1273,6265,2021-01-17 02:00:28
6342,638,3,658,85,743,6266,2021-01-16 07:28:31
6343,668,2,329,42,371,6267,2021-01-16 14:50:42
6344,893,4,1726,224,1950,6268,2021-01-16 17:50:48
6345,16,3,578,75,653,6269,2021-01-16 18:14:55
6346,354,2,498,64,562,6270,2021-01-16 17:58:46
6347,396,6,1555,202,1757,6271,2021-01-16 22:49:59
6348,547,3,897,116,1013,6272,2021-01-17 00:37:57
6349,58,3,1197,155,1352,6273,2021-01-16 08:53:16
6350,889,2,898,116,1014,6274,2021-01-16 10:29:38
6351,661,2,798,103,901,6275,2021-01-16 01:43:41
6352,747,6,1006,130,1136,6276,2021-01-16 04:39:54
6353,747,6,1006,130,1136,6276,2021-01-16 04:39:54
6354,63,3,727,94,821,6277,2021-01-16 11:53:58
6355,770,3,797,103,900,6278,2021-01-16 20:57:04
6356,312,3,927,120,1047,6279,2021-01-16 11:15:59
6357,550,3,847,110,957,6280,2021-01-16 18:04:09
6358,435,3,747,97,844,6281,2021-01-16 04:38:59
6359,501,3,1047,136,1183,6282,2021-01-16 11:57:25
6360,412,2,659,85,744,6283,2021-01-16 10:34:03
6361,347,3,827,107,934,6284,2021-01-17 02:20:30
6362,208,5,1756,228,1984,6285,2021-01-17 05:51:12
6363,404,3,658,85,743,6286,2021-01-17 04:11:07
6364,995,3,597,77,674,6287,2021-01-17 00:45:44
6365,143,5,937,121,1058,6288,2021-01-17 07:06:26
6366,986,3,888,115,1003,6289,2021-01-17 07:54:41
6367,260,3,697,90,787,6290,2021-01-16 19:36:56
6368,604,3,1247,162,1409,6291,2021-01-17 02:47:07
6369,904,3,927,120,1047,6292,2021-01-15 23:25:44
6370,853,2,1098,142,1240,6293,2021-01-16 11:31:15
6371,47,3,797,103,900,6294,2021-01-16 21:29:54
6372,212,3,758,98,856,6295,2021-01-16 23:34:18
6373,556,2,698,90,788,6296,2021-01-17 01:01:44
6374,340,2,798,103,901,6297,2021-01-16 16:45:16
6375,884,2,659,85,744,6298,2021-01-16 22:25:28
6376,15,6,1305,169,1474,6299,2021-01-16 18:59:32
6377,971,3,847,110,957,6300,2021-01-16 11:37:33
6378,792,3,697,90,787,6301,2021-01-15 22:49:13
6379,525,5,1795,233,2028,6302,2021-01-15 21:17:42
6380,612,2,1098,142,1240,6303,2021-01-15 16:41:22
6381,777,3,428,55,483,6304,2021-01-17 09:16:36
6382,663,3,727,94,821,6305,2021-01-17 07:02:04
6383,696,2,598,77,675,6306,2021-01-16 23:40:10
6384,86,5,1945,252,2197,6307,2021-01-17 14:57:03
6385,909,3,1047,136,1183,6308,2021-01-17 19:42:32
6386,601,2,659,85,744,6309,2021-01-17 02:15:19
6387,191,3,1047,136,1183,6310,2021-01-17 01:57:59
6388,580,3,897,116,1013,6311,2021-01-17 01:00:26
6389,876,3,428,55,483,6312,2021-01-17 06:13:08
6390,118,3,997,129,1126,6313,2021-01-17 02:00:51
6391,433,2,498,64,562,6314,2021-01-17 06:57:26
6392,868,2,1098,142,1240,6315,2021-01-16 07:25:45
6393,510,3,428,55,483,6316,2021-01-16 10:34:43
6394,218,5,1376,178,1554,6317,2021-01-16 14:20:22
6395,593,6,1485,193,1678,6318,2021-01-16 18:20:54
6396,265,2,798,103,901,6319,2021-01-16 11:07:04
6397,567,3,727,94,821,6320,2021-01-16 16:06:40
6398,758,3,847,110,957,6321,2021-01-16 08:33:37
6399,266,3,997,129,1126,6322,2021-01-17 10:24:02
6400,558,1,149,19,168,6323,2021-01-17 09:22:11
6401,784,2,798,103,901,6324,2021-01-17 04:32:53
6402,860,3,1127,146,1273,6325,2021-01-17 08:54:03
6403,81,3,897,116,1013,6326,2021-01-17 02:32:23
6404,695,2,459,59,518,6327,2021-01-17 03:58:16
6405,16,3,847,110,957,6328,2021-01-16 23:13:56
6406,742,3,847,110,957,6329,2021-01-16 21:03:47
6407,41,2,628,81,709,6330,2021-01-16 21:51:29
6408,874,1,699,90,789,6331,2021-01-17 05:12:06
6409,743,1,229,29,258,6332,2021-01-17 20:53:01
6410,250,1,499,64,563,6333,2021-01-17 10:04:46
6411,588,3,808,105,913,6334,2021-01-16 23:57:51
6412,833,3,827,107,934,6335,2021-01-16 08:05:32
6413,461,2,798,103,901,6336,2021-01-16 07:02:11
6414,404,2,429,55,484,6337,2021-01-16 06:13:37
6415,266,4,1046,135,1181,6338,2021-01-16 09:49:24
6416,390,2,1098,142,1240,6339,2021-01-16 10:46:38
6417,490,2,798,103,901,6340,2021-01-16 18:07:18
6418,660,1,499,64,563,6341,2021-01-16 20:31:43
6419,297,5,1625,211,1836,6342,2021-01-17 00:07:03
6420,587,2,659,85,744,6343,2021-01-17 04:20:29
6421,990,2,1098,142,1240,6344,2021-01-16 08:56:51
6422,362,5,1825,237,2062,6345,2021-01-16 15:12:01
6423,429,3,847,110,957,6346,2021-01-16 18:56:40
6424,944,3,597,77,674,6347,2021-01-16 19:23:38
6425,185,3,727,94,821,6348,2021-01-16 20:44:14
6426,561,3,647,84,731,6349,2021-01-16 23:10:21
6427,410,1,149,19,168,6350,2021-01-17 03:03:12
6428,781,4,1526,198,1724,6351,2021-01-16 10:51:29
6429,527,3,827,107,934,6352,2021-01-16 12:56:31
6430,767,3,428,55,483,6353,2021-01-16 02:39:51
6431,629,3,727,94,821,6354,2021-01-16 07:05:29
6432,177,3,688,89,777,6355,2021-01-16 06:32:17
6433,389,3,697,90,787,6356,2021-01-16 12:18:47
6434,548,2,1098,142,1240,6357,2021-01-16 22:29:13
6435,478,3,608,79,687,6358,2021-01-16 11:25:34
6436,226,2,329,42,371,6359,2021-01-16 19:50:11
6437,137,3,927,120,1047,6360,2021-01-16 06:50:49
6438,520,2,429,55,484,6361,2021-01-16 12:15:54
6439,516,2,498,64,562,6362,2021-01-16 13:13:14
6440,21,3,997,129,1126,6363,2021-01-17 03:10:49
6441,5,5,1775,230,2005,6364,2021-01-17 05:51:18
6442,275,2,459,59,518,6365,2021-01-17 06:28:17
6443,22,3,808,105,913,6366,2021-01-17 03:25:59
6444,44,3,558,72,630,6367,2021-01-17 09:43:56
6445,282,2,598,77,675,6368,2021-01-17 07:56:03
6446,70,3,1127,146,1273,6369,2021-01-16 20:17:23
6447,68,3,608,79,687,6370,2021-01-17 05:07:59
6448,589,2,598,77,675,6371,2021-01-16 01:53:28
6449,532,3,847,110,957,6372,2021-01-16 11:37:38
6450,532,3,847,110,957,6372,2021-01-16 11:37:38
6451,500,5,1256,163,1419,6373,2021-01-16 22:22:13
6452,316,2,498,64,562,6374,2021-01-17 01:36:01
6453,961,2,898,116,1014,6375,2021-01-17 02:46:34
6454,452,2,698,90,788,6376,2021-01-16 17:36:37
6455,354,1,99,12,111,6377,2021-01-17 00:16:52
6456,795,1,99,12,111,6378,2021-01-16 20:27:01
6457,465,2,598,77,675,6379,2021-01-16 13:38:36
6458,634,3,847,110,957,6380,2021-01-15 23:28:55
6459,99,3,1127,146,1273,6381,2021-01-15 23:25:21
6460,847,2,898,116,1014,6382,2021-01-15 16:43:41
6461,211,3,1127,146,1273,6383,2021-01-17 11:12:05
6462,570,3,558,72,630,6384,2021-01-17 09:45:24
6463,244,1,229,29,258,6385,2021-01-17 01:42:10
6464,756,3,997,129,1126,6386,2021-01-17 17:31:44
6465,98,3,827,107,934,6387,2021-01-17 22:00:42
6466,146,2,329,42,371,6388,2021-01-17 04:16:35
6467,274,2,429,55,484,6389,2021-01-17 02:48:35
6468,567,3,688,89,777,6390,2021-01-17 02:52:25
6469,573,1,599,77,676,6391,2021-01-17 08:14:12
6470,343,3,697,90,787,6392,2021-01-17 04:08:23
6471,345,3,1127,146,1273,6393,2021-01-17 08:38:33
6472,63,2,429,55,484,6394,2021-01-16 08:14:43
6473,516,3,758,98,856,6395,2021-01-16 13:13:07
6474,666,2,598,77,675,6396,2021-01-16 15:42:07
6475,708,2,798,103,901,6397,2021-01-16 20:47:11
6476,588,2,1098,142,1240,6398,2021-01-16 13:11:16
6477,83,3,647,84,731,6399,2021-01-16 16:43:02
6478,112,3,697,90,787,6400,2021-01-16 11:04:45
6479,666,2,628,81,709,6401,2021-01-17 10:48:04
6480,666,2,628,81,709,6401,2021-01-17 10:48:04
6481,527,3,578,75,653,6402,2021-01-17 10:50:54
6482,668,3,827,107,934,6403,2021-01-17 06:42:19
6483,924,3,847,110,957,6404,2021-01-17 10:35:55
6484,84,3,1127,146,1273,6405,2021-01-17 03:29:33
6485,331,1,149,19,168,6406,2021-01-17 05:46:13
6486,126,3,1197,155,1352,6407,2021-01-16 23:41:07
6487,107,5,1206,156,1362,6408,2021-01-16 23:26:09
6488,118,1,149,19,168,6409,2021-01-16 22:23:34
6489,951,2,659,85,744,6410,2021-01-17 06:44:08
6490,0,3,1127,146,1273,6411,2021-01-17 21:56:34
6491,160,5,1945,252,2197,6412,2021-01-17 11:22:14
6492,304,6,2354,306,2660,6413,2021-01-17 01:13:04
6493,606,2,329,42,371,6414,2021-01-16 08:47:09
6494,542,3,747,97,844,6415,2021-01-16 09:11:45
6495,303,2,798,103,901,6416,2021-01-16 07:36:41
6496,317,3,827,107,934,6417,2021-01-16 10:47:00
6497,265,5,926,120,1046,6418,2021-01-16 11:25:25
6498,432,3,997,129,1126,6419,2021-01-16 19:00:30
6499,0,5,1845,239,2084,6420,2021-01-16 23:16:23
6500,577,3,597,77,674,6421,2021-01-17 02:05:46
6501,516,2,598,77,675,6422,2021-01-17 06:27:11
6502,829,2,898,116,1014,6423,2021-01-16 10:19:30
6503,951,2,598,77,675,6424,2021-01-16 16:41:12
6504,713,4,1077,140,1217,6425,2021-01-16 20:02:32
6505,831,3,797,103,900,6426,2021-01-16 21:46:56
6506,61,3,1127,146,1273,6427,2021-01-16 22:00:32
6507,901,3,997,129,1126,6428,2021-01-17 00:10:23
6508,484,2,528,68,596,6429,2021-01-17 05:41:40
6509,929,3,647,84,731,6430,2021-01-16 13:28:50
6510,85,3,1127,146,1273,6431,2021-01-16 15:01:16
6511,232,2,598,77,675,6432,2021-01-16 05:05:43
6512,150,2,748,97,845,6433,2021-01-16 09:11:53
6513,324,3,827,107,934,6434,2021-01-16 07:21:41
6514,268,3,1127,146,1273,6435,2021-01-16 12:46:28
6515,56,3,558,72,630,6436,2021-01-17 00:01:34
6516,212,3,747,97,844,6437,2021-01-16 12:18:01
6517,80,2,898,116,1014,6438,2021-01-16 20:09:23
6518,738,3,847,110,957,6439,2021-01-16 07:25:29
6519,252,3,947,123,1070,6440,2021-01-16 14:03:44
6520,255,3,688,89,777,6441,2021-01-16 14:06:04
6521,312,2,798,103,901,6442,2021-01-17 04:59:15
6522,560,3,697,90,787,6443,2021-01-17 06:02:24
6523,684,3,1127,146,1273,6444,2021-01-17 07:15:47
6524,661,3,1197,155,1352,6445,2021-01-17 06:02:52
6525,127,2,329,42,371,6446,2021-01-17 10:29:11
6526,102,3,797,103,900,6447,2021-01-17 08:01:03
6527,411,3,927,120,1047,6448,2021-01-16 21:01:27
6528,769,2,848,110,958,6449,2021-01-17 06:19:51
6529,84,3,1127,146,1273,6450,2021-01-16 04:39:28
6530,200,2,798,103,901,6451,2021-01-16 13:48:56
6531,991,3,1247,162,1409,6452,2021-01-16 13:37:10
6532,278,2,1098,142,1240,6453,2021-01-16 23:17:19
6533,116,3,558,72,630,6454,2021-01-17 03:07:20
6534,802,3,947,123,1070,6455,2021-01-17 05:21:31
6535,821,3,897,116,1013,6456,2021-01-16 18:16:13
6536,928,3,647,84,731,6457,2021-01-17 01:37:44
6537,878,2,598,77,675,6458,2021-01-16 20:43:48
6538,85,2,498,64,562,6459,2021-01-16 13:58:08
6539,696,5,1126,146,1272,6460,2021-01-16 01:04:33
6540,276,4,577,75,652,6461,2021-01-16 01:11:40
6541,981,3,428,55,483,6462,2021-01-15 17:10:43
6542,664,1,399,51,450,6463,2021-01-17 11:46:23
6543,897,3,847,110,957,6464,2021-01-17 11:06:29
6544,376,3,727,94,821,6465,2021-01-17 04:04:45
6545,860,2,628,81,709,6466,2021-01-17 18:01:20
6546,8,3,558,72,630,6467,2021-01-17 23:36:37
6547,786,3,528,68,596,6468,2021-01-17 07:00:51
6548,416,3,1127,146,1273,6469,2021-01-17 03:57:59
6549,273,3,478,62,540,6470,2021-01-17 03:31:19
6550,650,3,428,55,483,6471,2021-01-17 09:52:10
6551,38,3,1127,146,1273,6472,2021-01-17 04:21:50
6552,329,1,99,12,111,6473,2021-01-17 11:11:35
6553,820,3,597,77,674,6474,2021-01-16 09:45:49
6554,934,3,578,75,653,6475,2021-01-16 15:18:15
6555,937,3,927,120,1047,6476,2021-01-16 17:30:11
6556,596,4,1457,189,1646,6477,2021-01-16 22:48:30
6557,705,3,597,77,674,6478,2021-01-16 14:34:04
6558,403,3,1327,172,1499,6479,2021-01-16 17:20:15
6559,261,2,1098,142,1240,6480,2021-01-16 11:26:09
6560,91,3,1047,136,1183,6481,2021-01-17 12:57:25
6561,571,2,598,77,675,6482,2021-01-17 13:14:06
6562,695,3,947,123,1070,6483,2021-01-17 12:44:05
6563,925,2,598,77,675,6484,2021-01-17 09:01:27
6564,961,3,647,84,731,6485,2021-01-17 12:19:30
6565,336,3,808,105,913,6486,2021-01-17 06:02:06
6566,860,2,659,85,744,6487,2021-01-17 06:46:39
6567,860,2,659,85,744,6487,2021-01-17 06:46:39
6568,834,1,99,12,111,6488,2021-01-17 00:49:08
6569,720,2,498,64,562,6489,2021-01-17 00:19:23
6570,960,2,698,90,788,6490,2021-01-16 23:40:09
6571,560,3,847,110,957,6491,2021-01-17 08:50:50
6572,553,2,728,94,822,6492,2021-01-17 22:36:46
6573,960,2,698,90,788,6493,2021-01-17 13:43:21
6574,723,3,647,84,731,6494,2021-01-17 02:10:52
6575,562,2,598,77,675,6495,2021-01-16 09:57:23
6576,324,2,798,103,901,6496,2021-01-16 09:50:45
6577,662,3,658,85,743,6497,2021-01-16 09:57:06
6578,575,3,558,72,630,6498,2021-01-16 13:03:31
6579,514,2,898,116,1014,6499,2021-01-16 13:41:42
6580,778,3,927,120,1047,6500,2021-01-16 19:27:31
6581,629,3,927,120,1047,6501,2021-01-16 23:17:30
6582,133,2,459,59,518,6502,2021-01-17 02:21:39
6583,832,3,658,85,743,6503,2021-01-17 08:59:47
6584,457,3,747,97,844,6504,2021-01-16 10:45:35
6585,560,3,558,72,630,6505,2021-01-16 16:51:58
6586,758,3,428,55,483,6506,2021-01-16 21:09:48
6587,197,3,947,123,1070,6507,2021-01-16 22:07:53
6588,587,3,827,107,934,6508,2021-01-16 23:13:08
6589,892,6,1405,182,1587,6509,2021-01-17 02:45:56
6590,725,3,1247,162,1409,6510,2021-01-17 06:02:14
6591,553,5,2025,263,2288,6511,2021-01-16 14:31:36
6592,762,3,647,84,731,6512,2021-01-16 17:09:57
6593,404,2,898,116,1014,6513,2021-01-16 07:18:18
6594,664,2,459,59,518,6514,2021-01-16 10:05:17
6595,57,3,847,110,957,6515,2021-01-16 07:37:25
6596,139,2,329,42,371,6516,2021-01-16 12:54:17
6597,126,3,1127,146,1273,6517,2021-01-17 02:17:04
6598,933,2,1098,142,1240,6518,2021-01-16 12:24:47
6599,690,3,808,105,913,6519,2021-01-16 22:15:14
6600,472,3,608,79,687,6520,2021-01-16 09:04:36
6601,957,3,747,97,844,6521,2021-01-16 15:15:03
6602,273,3,608,79,687,6522,2021-01-16 16:06:50
6603,633,2,898,116,1014,6523,2021-01-17 07:30:05
6604,599,5,2055,267,2322,6524,2021-01-17 06:12:35
6605,277,3,1127,146,1273,6525,2021-01-17 09:43:50
6606,531,2,628,81,709,6526,2021-01-17 06:52:07
6607,82,3,747,97,844,6527,2021-01-17 11:38:19
6608,572,3,997,129,1126,6528,2021-01-17 09:53:35
6609,416,3,558,72,630,6529,2021-01-16 22:18:39
6610,459,3,797,103,900,6530,2021-01-17 06:42:40
6611,472,4,1396,181,1577,6531,2021-01-16 05:01:07
6612,62,3,478,62,540,6532,2021-01-16 15:56:32
6613,262,3,1327,172,1499,6533,2021-01-16 14:20:10
6614,95,3,1327,172,1499,6534,2021-01-16 23:44:28
6615,215,2,329,42,371,6535,2021-01-17 03:20:17
6616,90,2,659,85,744,6536,2021-01-17 05:54:16
6617,53,3,797,103,900,6537,2021-01-16 20:03:00
6618,663,4,1487,193,1680,6538,2021-01-17 03:11:29
6619,582,1,149,19,168,6539,2021-01-16 23:08:02
6620,214,2,898,116,1014,6540,2021-01-16 15:34:18
6621,246,2,598,77,675,6541,2021-01-16 02:46:20
6622,345,3,1247,162,1409,6542,2021-01-16 02:00:07
6623,274,4,1426,185,1611,6543,2021-01-15 19:42:24
6624,322,3,558,72,630,6544,2021-01-17 11:50:57
6625,15,3,1247,162,1409,6545,2021-01-17 13:32:15
6626,384,3,697,90,787,6546,2021-01-17 05:17:48
6627,306,3,827,107,934,6547,2021-01-17 18:22:42
6628,472,4,1346,174,1520,6548,2021-01-18 02:07:16
6629,824,3,428,55,483,6549,2021-01-17 08:48:56
6630,635,5,1295,168,1463,6550,2021-01-17 04:12:26
6631,951,3,608,79,687,6551,2021-01-17 05:25:06
6632,711,3,747,97,844,6552,2021-01-17 12:28:13
6633,179,4,1246,161,1407,6553,2021-01-17 06:34:28
6634,943,3,597,77,674,6554,2021-01-17 12:23:43
6635,272,3,1047,136,1183,6555,2021-01-16 11:22:03
6636,704,1,699,90,789,6556,2021-01-16 18:00:41
6637,255,3,888,115,1003,6557,2021-01-16 20:14:21
6638,255,3,888,115,1003,6557,2021-01-16 20:14:21
6639,270,1,229,29,258,6558,2021-01-17 00:35:54
6640,960,3,528,68,596,6559,2021-01-16 14:43:18
6641,405,5,1455,189,1644,6560,2021-01-16 19:00:07
6642,840,2,429,55,484,6561,2021-01-16 13:51:34
6643,463,4,1496,194,1690,6562,2021-01-17 15:36:48
6644,997,3,758,98,856,6563,2021-01-17 15:49:41
6645,997,3,758,98,856,6563,2021-01-17 15:49:41
6646,412,2,598,77,675,6564,2021-01-17 14:20:13
6647,701,3,1047,136,1183,6565,2021-01-17 10:45:50
6648,409,3,1047,136,1183,6566,2021-01-17 14:18:49
6649,409,3,1047,136,1183,6566,2021-01-17 14:18:49
6650,627,2,659,85,744,6567,2021-01-17 08:16:11
6651,664,3,888,115,1003,6568,2021-01-17 07:25:40
6652,217,2,728,94,822,6569,2021-01-17 07:15:20
6653,119,2,429,55,484,6570,2021-01-17 01:06:27
6654,439,3,1047,136,1183,6571,2021-01-17 02:29:37
6655,950,3,1047,136,1183,6572,2021-01-17 01:29:14
6656,196,5,907,117,1024,6573,2021-01-17 09:45:30
6657,771,3,827,107,934,6574,2021-01-17 22:36:51
6658,348,3,1127,146,1273,6575,2021-01-17 15:53:57
6659,145,3,747,97,844,6576,2021-01-17 03:59:06
6660,687,3,597,77,674,6577,2021-01-16 11:20:35
6661,917,2,698,90,788,6578,2021-01-16 12:13:47
6662,810,3,1047,136,1183,6579,2021-01-16 10:00:45
6663,983,3,1047,136,1183,6580,2021-01-16 15:31:15
6664,752,2,598,77,675,6581,2021-01-16 14:46:13
6665,712,3,1327,172,1499,6582,2021-01-16 21:26:11
6666,628,4,1446,187,1633,6583,2021-01-16 23:40:34
6667,719,2,598,77,675,6584,2021-01-17 03:21:29
6668,965,3,1027,133,1160,6585,2021-01-17 11:41:24
6669,115,3,608,79,687,6586,2021-01-16 11:52:20
6670,904,3,827,107,934,6587,2021-01-16 17:14:54
6671,27,3,797,103,900,6588,2021-01-16 23:53:39
6672,541,2,898,116,1014,6589,2021-01-16 23:59:18
6673,824,4,1646,213,1859,6590,2021-01-17 01:48:08
6674,599,3,1247,162,1409,6591,2021-01-17 05:14:35
6675,211,3,847,110,957,6592,2021-01-17 07:15:47
6676,873,2,1098,142,1240,6593,2021-01-16 15:55:08
6677,691,3,697,90,787,6594,2021-01-16 19:24:10
6678,132,2,798,103,901,6595,2021-01-16 09:33:00
6679,513,3,997,129,1126,6596,2021-01-16 11:21:19
6680,370,3,888,115,1003,6597,2021-01-16 09:05:16
6681,220,3,597,77,674,6598,2021-01-16 15:10:53
6682,754,3,758,98,856,6599,2021-01-17 03:56:42
6683,500,6,1674,217,1891,6600,2021-01-16 13:20:09
6684,362,5,1845,239,2084,6601,2021-01-16 23:41:10
6685,791,2,898,116,1014,6602,2021-01-16 10:12:20
6686,414,3,528,68,596,6603,2021-01-16 17:48:16
6687,526,2,1098,142,1240,6604,2021-01-16 17:18:30
6688,422,3,1047,136,1183,6605,2021-01-17 07:49:29
6689,319,2,898,116,1014,6606,2021-01-17 07:06:06
6690,19,5,1356,176,1532,6607,2021-01-17 12:21:27
6691,440,3,478,62,540,6608,2021-01-17 08:24:17
6692,32,3,747,97,844,6609,2021-01-17 14:14:55
6693,667,3,597,77,674,6610,2021-01-17 10:00:07
6694,955,3,1247,162,1409,6611,2021-01-16 23:49:30
6695,481,2,698,90,788,6612,2021-01-17 06:58:58
6696,849,2,459,59,518,6613,2021-01-16 05:07:17
6697,651,1,99,12,111,6614,2021-01-16 16:04:20
6698,501,5,1695,220,1915,6615,2021-01-16 16:17:19
6699,904,3,428,55,483,6616,2021-01-17 00:47:49
6700,602,5,1925,250,2175,6617,2021-01-17 05:15:23
6701,65,3,528,68,596,6618,2021-01-17 06:49:01
6702,785,3,647,84,731,6619,2021-01-16 22:40:53
6703,786,6,2054,267,2321,6620,2021-01-17 03:56:33
6704,789,4,1346,174,1520,6621,2021-01-17 00:02:13
6705,271,3,688,89,777,6622,2021-01-16 16:38:27
6706,285,3,1127,146,1273,6623,2021-01-16 05:30:24
6707,156,2,429,55,484,6624,2021-01-16 02:06:47
6708,758,3,578,75,653,6625,2021-01-15 20:59:21
6709,810,5,1156,150,1306,6626,2021-01-17 12:36:51
6710,730,5,1645,213,1858,6627,2021-01-17 15:36:08
6711,415,3,808,105,913,6628,2021-01-17 05:30:51
6712,112,2,698,90,788,6629,2021-01-17 19:14:43
6713,481,3,558,72,630,6630,2021-01-18 03:40:54
6714,490,2,698,90,788,6631,2021-01-17 11:10:14
6715,39,3,697,90,787,6632,2021-01-17 04:41:59
6716,488,3,697,90,787,6633,2021-01-17 07:13:26
6717,532,2,628,81,709,6634,2021-01-17 14:41:15
6718,962,2,898,116,1014,6635,2021-01-17 07:26:17
6719,456,3,1197,155,1352,6636,2021-01-17 13:47:39
6720,746,2,598,77,675,6637,2021-01-16 13:18:39
6721,328,2,698,90,788,6638,2021-01-16 20:31:20
6722,890,3,847,110,957,6639,2021-01-16 22:15:17
6723,612,2,898,116,1014,6640,2021-01-16 22:58:11
6724,521,3,1197,155,1352,6641,2021-01-17 00:59:13
6725,886,1,99,12,111,6642,2021-01-16 16:25:51
6726,999,3,597,77,674,6643,2021-01-16 19:04:36
6727,697,2,828,107,935,6644,2021-01-16 16:16:04
6728,613,4,1626,211,1837,6645,2021-01-17 17:50:16
6729,237,3,1197,155,1352,6646,2021-01-17 16:04:49
6730,884,2,459,59,518,6647,2021-01-17 16:35:14
6731,281,2,698,90,788,6648,2021-01-17 16:52:02
6732,386,6,1855,241,2096,6649,2021-01-17 13:00:28
6733,603,3,697,90,787,6650,2021-01-17 14:43:51
6734,609,1,299,38,337,6651,2021-01-17 15:57:53
6735,983,3,758,98,856,6652,2021-01-17 10:39:09
6736,957,2,898,116,1014,6653,2021-01-17 09:22:25
6737,790,3,1047,136,1183,6654,2021-01-17 08:00:45
6738,719,5,1345,174,1519,6655,2021-01-17 02:26:47
6739,898,3,758,98,856,6656,2021-01-17 02:45:58
6740,588,3,578,75,653,6657,2021-01-17 02:26:40
6741,565,3,888,115,1003,6658,2021-01-17 12:25:18
6742,170,3,528,68,596,6659,2021-01-18 00:14:26
6743,284,3,478,62,540,6660,2021-01-17 16:05:06
6744,820,3,1027,133,1160,6661,2021-01-17 05:52:38
6745,299,2,598,77,675,6662,2021-01-16 13:25:36
6746,155,3,528,68,596,6663,2021-01-16 12:45:52
6747,465,2,459,59,518,6664,2021-01-16 11:25:42
6748,896,4,1846,239,2085,6665,2021-01-16 15:50:13
6749,32,3,608,79,687,6666,2021-01-16 15:30:30
6750,309,5,1586,206,1792,6667,2021-01-16 22:05:07
6751,820,3,827,107,934,6668,2021-01-17 00:12:14
6752,258,3,688,89,777,6669,2021-01-17 03:54:08
6753,193,4,1396,181,1577,6670,2021-01-17 14:25:31
6754,742,1,499,64,563,6671,2021-01-16 14:04:45
6755,436,3,797,103,900,6672,2021-01-16 17:28:41
6756,716,2,798,103,901,6673,2021-01-17 01:47:47
6757,259,2,329,42,371,6674,2021-01-17 01:40:25
6758,740,3,1197,155,1352,6675,2021-01-17 02:28:56
6759,941,2,898,116,1014,6676,2021-01-17 06:48:48
6760,478,3,688,89,777,6677,2021-01-17 09:47:26
6761,498,3,478,62,540,6678,2021-01-16 16:09:56
6762,171,2,459,59,518,6679,2021-01-16 19:40:13
6763,983,2,598,77,675,6680,2021-01-16 12:00:50
6764,398,3,827,107,934,6681,2021-01-16 13:23:46
6765,37,2,848,110,958,6682,2021-01-16 09:49:56
6766,332,3,797,103,900,6683,2021-01-16 16:40:52
6767,942,3,927,120,1047,6684,2021-01-17 06:16:14
6768,717,2,659,85,744,6685,2021-01-16 14:52:49
6769,911,2,648,84,732,6686,2021-01-17 01:29:14
6770,490,3,597,77,674,6687,2021-01-16 10:43:48
6771,969,3,647,84,731,6688,2021-01-16 18:20:48
6772,582,2,1098,142,1240,6689,2021-01-16 19:06:45
6773,197,3,428,55,483,6690,2021-01-17 08:23:28
6774,750,6,2044,265,2309,6691,2021-01-17 08:39:45
6775,88,3,1197,155,1352,6692,2021-01-17 12:49:30
6776,86,3,1027,133,1160,6693,2021-01-17 09:17:55
6777,627,3,927,120,1047,6694,2021-01-17 15:04:40
6778,53,3,897,116,1013,6695,2021-01-17 11:49:09
6779,125,3,558,72,630,6696,2021-01-17 01:03:20
6780,93,3,927,120,1047,6697,2021-01-17 09:17:39
6781,127,2,448,58,506,6698,2021-01-16 05:23:35
6782,428,3,1197,155,1352,6699,2021-01-16 16:41:53
6783,836,3,1247,162,1409,6700,2021-01-16 17:29:36
6784,765,3,1247,162,1409,6701,2021-01-17 03:13:08
6785,686,3,758,98,856,6702,2021-01-17 05:20:16
6786,641,3,888,115,1003,6703,2021-01-17 07:10:24
6787,715,6,1725,224,1949,6704,2021-01-17 00:58:26
6788,59,1,149,19,168,6705,2021-01-17 04:42:45
6789,231,3,428,55,483,6706,2021-01-17 01:17:58
6790,231,3,827,107,934,6707,2021-01-16 18:04:00
6791,857,3,1197,155,1352,6708,2021-01-16 05:41:59
6792,579,3,847,110,957,6709,2021-01-16 02:38:21
6793,760,2,1098,142,1240,6710,2021-01-15 23:39:53
6794,895,1,229,29,258,6711,2021-01-17 15:02:34
6795,705,3,1027,133,1160,6712,2021-01-17 16:31:00
6796,451,3,1047,136,1183,6713,2021-01-17 07:48:42
6797,469,2,659,85,744,6714,2021-01-17 21:59:49
6798,300,3,1327,172,1499,6715,2021-01-18 04:28:18
6799,785,2,329,42,371,6716,2021-01-17 13:15:24
6800,731,2,329,42,371,6717,2021-01-17 05:46:31
6801,283,2,429,55,484,6718,2021-01-17 08:11:37
6802,499,3,558,72,630,6719,2021-01-17 16:52:58
6803,751,2,598,77,675,6720,2021-01-17 09:55:59
6804,925,3,658,85,743,6721,2021-01-17 13:51:29
6805,22,2,659,85,744,6722,2021-01-16 13:29:39
6806,815,3,478,62,540,6723,2021-01-16 22:08:31
6807,805,2,828,107,935,6724,2021-01-17 00:26:11
6808,798,3,697,90,787,6725,2021-01-16 23:51:46
6809,132,3,888,115,1003,6726,2021-01-17 02:05:27
6810,225,3,1047,136,1183,6727,2021-01-16 18:35:00
6811,18,3,1127,146,1273,6728,2021-01-16 19:54:24
6812,410,2,659,85,744,6729,2021-01-16 16:31:42
6813,924,3,578,75,653,6730,2021-01-17 19:49:09
6814,641,5,1695,220,1915,6731,2021-01-17 18:41:51
6815,332,3,747,97,844,6732,2021-01-17 17:47:55
6816,324,2,498,64,562,6733,2021-01-17 17:41:47
6817,480,3,1127,146,1273,6734,2021-01-17 15:04:34
6818,19,3,997,129,1126,6735,2021-01-17 15:37:18
6819,524,3,1047,136,1183,6736,2021-01-17 18:10:43
6820,470,3,727,94,821,6737,2021-01-17 10:56:01
6821,295,3,1047,136,1183,6738,2021-01-17 11:06:07
6822,382,3,1047,136,1183,6739,2021-01-17 10:32:24
6823,943,3,897,116,1013,6740,2021-01-17 03:30:27
6824,878,3,727,94,821,6741,2021-01-17 03:22:53
6825,488,3,997,129,1126,6742,2021-01-17 03:04:07
6826,801,2,698,90,788,6743,2021-01-17 14:19:04
6827,240,2,498,64,562,6744,2021-01-18 02:28:18
6828,768,3,608,79,687,6745,2021-01-17 18:15:51
6829,541,3,597,77,674,6746,2021-01-17 06:25:59
6830,553,3,1127,146,1273,6747,2021-01-16 13:51:14
6831,237,2,628,81,709,6748,2021-01-16 14:59:38
6832,820,2,698,90,788,6749,2021-01-16 13:37:37
6833,245,3,997,129,1126,6750,2021-01-16 16:43:10
6834,997,2,498,64,562,6751,2021-01-16 17:40:39
6835,702,3,697,90,787,6752,2021-01-17 00:18:14
6836,344,3,747,97,844,6753,2021-01-17 01:50:18
6837,386,3,428,55,483,6754,2021-01-17 04:10:24
6838,551,2,928,120,1048,6755,2021-01-17 15:36:18
6839,691,3,747,97,844,6756,2021-01-16 14:28:17
6840,267,3,947,123,1070,6757,2021-01-16 18:41:12
6841,140,3,1127,146,1273,6758,2021-01-17 03:15:05
6842,899,6,1175,152,1327,6759,2021-01-17 01:46:40
6843,382,3,697,90,787,6760,2021-01-17 03:04:54
6844,635,2,659,85,744,6761,2021-01-17 07:05:30
6845,211,3,1127,146,1273,6762,2021-01-17 11:12:38
6846,274,3,1127,146,1273,6763,2021-01-16 17:45:34
6847,269,6,1555,202,1757,6764,2021-01-16 20:25:24
6848,678,3,597,77,674,6765,2021-01-16 14:45:32
6849,348,3,827,107,934,6766,2021-01-16 15:54:06
6850,679,3,888,115,1003,6767,2021-01-16 09:51:04
6851,310,2,498,64,562,6768,2021-01-16 17:15:41
6852,704,3,608,79,687,6769,2021-01-17 08:35:49
6853,681,4,987,128,1115,6770,2021-01-16 15:41:11
6854,855,3,797,103,900,6771,2021-01-17 03:04:22
6855,668,3,827,107,934,6772,2021-01-16 13:27:44
6856,444,4,1396,181,1577,6773,2021-01-16 18:41:25
6857,205,3,597,77,674,6774,2021-01-16 21:28:57
6858,152,3,597,77,674,6775,2021-01-17 09:40:29
6859,786,3,747,97,844,6776,2021-01-17 08:46:54
6860,496,3,727,94,821,6777,2021-01-17 15:18:27
6861,544,3,697,90,787,6778,2021-01-17 09:25:48
6862,987,5,1645,213,1858,6779,2021-01-17 15:21:04
6863,584,3,1127,146,1273,6780,2021-01-17 14:01:56
6864,134,3,688,89,777,6781,2021-01-17 01:06:55
6865,325,3,1247,162,1409,6782,2021-01-17 11:45:09
6866,619,3,1197,155,1352,6783,2021-01-16 05:29:57
6867,218,1,99,12,111,6784,2021-01-16 19:09:15
6868,743,2,898,116,1014,6785,2021-01-16 19:19:37
6869,946,3,658,85,743,6786,2021-01-17 04:41:27
6870,531,2,798,103,901,6787,2021-01-17 05:22:59
6871,666,3,747,97,844,6788,2021-01-17 09:04:07
6872,310,2,698,90,788,6789,2021-01-17 03:05:39
6873,707,1,99,12,111,6790,2021-01-17 07:16:14
6874,837,3,758,98,856,6791,2021-01-17 01:24:59
6875,356,3,558,72,630,6792,2021-01-16 19:15:36
6876,367,3,808,105,913,6793,2021-01-16 06:35:13
6877,106,3,927,120,1047,6794,2021-01-16 03:57:55
6878,452,5,1525,198,1723,6795,2021-01-16 01:24:36
6879,614,2,798,103,901,6796,2021-01-17 17:47:04
6880,810,3,608,79,687,6797,2021-01-17 16:41:38
6881,399,3,1047,136,1183,6798,2021-01-17 09:04:54
6882,738,2,459,59,518,6799,2021-01-17 23:22:08
6883,337,3,658,85,743,6800,2021-01-18 05:13:03
6884,419,3,597,77,674,6801,2021-01-17 15:53:11
6885,0,3,947,123,1070,6802,2021-01-17 06:51:21
6886,954,3,897,116,1013,6803,2021-01-17 09:59:03
6887,83,2,498,64,562,6804,2021-01-17 18:30:44
6888,929,3,827,107,934,6805,2021-01-17 11:18:51
6889,63,3,697,90,787,6806,2021-01-17 15:55:05
6890,821,4,1826,237,2063,6807,2021-01-16 15:18:23
6891,84,3,897,116,1013,6808,2021-01-17 00:25:43
6892,579,2,598,77,675,6809,2021-01-17 01:19:08
6893,173,2,459,59,518,6810,2021-01-17 01:58:19
6894,5,3,758,98,856,6811,2021-01-17 03:56:00
6895,587,3,478,62,540,6812,2021-01-16 20:58:16
6896,956,3,478,62,540,6813,2021-01-16 20:31:24
6897,250,3,1127,146,1273,6814,2021-01-16 17:34:24
6898,65,3,697,90,787,6815,2021-01-17 20:34:12
6899,966,3,597,77,674,6816,2021-01-17 19:26:43
6900,707,3,647,84,731,6817,2021-01-17 20:01:58
6901,78,6,1655,215,1870,6818,2021-01-17 18:25:17
6902,829,3,808,105,913,6819,2021-01-17 16:17:12
6903,419,1,499,64,563,6820,2021-01-17 17:04:02
6904,31,3,797,103,900,6821,2021-01-17 19:46:19
6905,640,2,798,103,901,6822,2021-01-17 12:26:12
6906,505,1,149,19,168,6823,2021-01-17 11:52:31
6907,546,3,1327,172,1499,6824,2021-01-17 11:06:11
6908,228,3,478,62,540,6825,2021-01-17 05:04:45
6909,836,2,698,90,788,6826,2021-01-17 04:57:00
6910,679,1,299,38,337,6827,2021-01-17 04:27:05
6911,772,3,808,105,913,6828,2021-01-17 14:49:59
6912,216,3,1047,136,1183,6829,2021-01-18 03:27:32
6913,107,2,698,90,788,6830,2021-01-17 18:56:14
6914,262,5,1087,141,1228,6831,2021-01-17 08:41:30
6915,732,3,747,97,844,6832,2021-01-16 14:11:25
6916,283,3,847,110,957,6833,2021-01-16 15:30:11
6917,161,2,659,85,744,6834,2021-01-16 15:38:07
6918,760,2,548,71,619,6835,2021-01-16 16:46:56
6919,76,5,1595,207,1802,6836,2021-01-16 18:45:33
6920,95,3,1047,136,1183,6837,2021-01-17 00:46:40
6921,686,2,429,55,484,6838,2021-01-17 02:17:09
6922,426,3,1047,136,1183,6839,2021-01-17 04:21:27
6923,966,3,658,85,743,6840,2021-01-17 18:13:56
6924,700,3,797,103,900,6841,2021-01-16 14:53:39
6925,78,3,888,115,1003,6842,2021-01-16 19:41:40
6926,458,3,697,90,787,6843,2021-01-17 05:52:12
6927,488,6,1375,178,1553,6844,2021-01-17 04:32:27
6928,434,2,698,90,788,6845,2021-01-17 05:27:16
6929,874,2,798,103,901,6846,2021-01-17 07:57:12
6930,829,3,608,79,687,6847,2021-01-17 13:05:34
6931,62,4,1507,195,1702,6848,2021-01-16 19:27:55
6932,105,3,1327,172,1499,6849,2021-01-16 21:26:49
6933,795,2,598,77,675,6850,2021-01-16 17:02:00
6934,115,1,149,19,168,6851,2021-01-16 18:18:17
6935,972,3,747,97,844,6852,2021-01-16 10:09:33
6936,226,1,499,64,563,6853,2021-01-16 18:59:40
6937,552,3,927,120,1047,6854,2021-01-17 09:30:41
6938,643,2,798,103,901,6855,2021-01-16 16:34:35
6939,550,2,548,71,619,6856,2021-01-17 04:12:17
6940,600,4,1396,181,1577,6857,2021-01-16 13:38:35
6941,700,3,578,75,653,6858,2021-01-16 19:36:02
6942,472,5,1395,181,1576,6859,2021-01-16 22:39:53
6943,677,3,608,79,687,6860,2021-01-17 11:06:14
6944,825,6,1205,156,1361,6861,2021-01-17 10:56:26
6945,138,2,429,55,484,6862,2021-01-17 16:28:24
6946,787,2,798,103,901,6863,2021-01-17 11:42:30
6947,979,3,1047,136,1183,6864,2021-01-17 17:13:37
6948,188,3,1047,136,1183,6865,2021-01-17 14:32:00
6949,63,2,659,85,744,6866,2021-01-17 01:44:28
6950,401,2,429,55,484,6867,2021-01-17 13:03:48
6951,495,2,598,77,675,6868,2021-01-16 07:31:13
6952,760,3,827,107,934,6869,2021-01-16 19:10:29
6953,234,3,697,90,787,6870,2021-01-16 19:35:51
6954,775,3,578,75,653,6871,2021-01-17 06:59:19
6955,906,3,797,103,900,6872,2021-01-17 06:21:45
6956,568,3,478,62,540,6873,2021-01-17 10:53:22
6957,345,3,528,68,596,6874,2021-01-17 03:48:28
6958,444,6,1624,211,1835,6875,2021-01-17 08:54:42
6959,59,2,598,77,675,6876,2021-01-17 02:17:39
6960,944,3,827,107,934,6877,2021-01-16 21:00:14
6961,284,3,888,115,1003,6878,2021-01-16 07:40:19
6962,562,3,808,105,913,6879,2021-01-16 06:23:35
6963,395,2,1098,142,1240,6880,2021-01-16 02:39:44
6964,736,2,898,116,1014,6881,2021-01-17 18:30:25
6965,102,2,459,59,518,6882,2021-01-17 18:16:03
6966,188,5,937,121,1058,6883,2021-01-17 11:31:07
6967,359,3,947,123,1070,6884,2021-01-18 00:24:00
6968,371,1,499,64,563,6885,2021-01-18 05:36:22
6969,6,3,1047,136,1183,6886,2021-01-17 15:55:59
6970,768,3,558,72,630,6887,2021-01-17 07:02:10
6971,701,4,1646,213,1859,6888,2021-01-17 10:53:13
6972,420,3,997,129,1126,6889,2021-01-17 20:56:56
6973,254,2,598,77,675,6890,2021-01-17 13:25:15
6974,176,6,1744,226,1970,6891,2021-01-17 18:11:42
6975,571,3,697,90,787,6892,2021-01-16 17:07:37
6976,237,2,628,81,709,6893,2021-01-17 01:40:55
6977,301,3,697,90,787,6894,2021-01-17 01:46:54
6978,923,2,798,103,901,6895,2021-01-17 04:26:58
6979,617,2,898,116,1014,6896,2021-01-17 04:49:38
6980,632,2,1098,142,1240,6897,2021-01-16 22:31:47
6981,703,3,658,85,743,6898,2021-01-16 20:41:56
6982,464,3,558,72,630,6899,2021-01-16 18:54:34
6983,174,3,578,75,653,6900,2021-01-17 22:24:19
6984,579,3,1127,146,1273,6901,2021-01-17 21:29:17
6985,297,6,1086,141,1227,6902,2021-01-17 22:04:34
6986,726,3,1127,146,1273,6903,2021-01-17 20:08:39
6987,403,5,1495,194,1689,6904,2021-01-17 18:08:39
6988,990,2,329,42,371,6905,2021-01-17 18:32:12
6989,261,3,697,90,787,6906,2021-01-17 21:01:37
6990,779,4,1346,174,1520,6907,2021-01-17 14:50:35
6991,92,3,897,116,1013,6908,2021-01-17 12:20:52
6992,650,2,659,85,744,6909,2021-01-17 12:08:22
6993,52,1,499,64,563,6910,2021-01-17 05:35:47
6994,159,3,897,116,1013,6911,2021-01-17 06:26:14
6995,915,3,847,110,957,6912,2021-01-17 06:03:29
6996,640,3,1047,136,1183,6913,2021-01-17 15:08:22
6997,314,2,498,64,562,6914,2021-01-18 04:53:43
6998,211,5,1376,178,1554,6915,2021-01-17 19:27:25
6999,455,5,1895,246,2141,6916,2021-01-17 11:11:17
7000,603,5,1017,132,1149,6917,2021-01-16 14:51:33
7001,842,3,997,129,1126,6918,2021-01-16 15:37:06
7002,301,3,1127,146,1273,6919,2021-01-16 16:20:17
7003,677,3,827,107,934,6920,2021-01-16 19:22:49
7004,438,6,1186,154,1340,6921,2021-01-16 20:38:57
7005,43,3,688,89,777,6922,2021-01-17 01:46:12
7006,134,6,1505,195,1700,6923,2021-01-17 04:16:03
7007,489,3,688,89,777,6924,2021-01-17 05:41:44
7008,566,3,927,120,1047,6925,2021-01-17 20:38:55
7009,4,3,797,103,900,6926,2021-01-16 15:40:07
7010,577,2,329,42,371,6927,2021-01-16 19:52:33
7011,200,4,1296,168,1464,6928,2021-01-17 06:31:48
7012,150,2,798,103,901,6929,2021-01-17 06:15:17
7013,932,3,947,123,1070,6930,2021-01-17 07:17:45
7014,338,3,927,120,1047,6931,2021-01-17 09:02:59
7015,727,2,698,90,788,6932,2021-01-17 15:41:22
7016,759,3,927,120,1047,6933,2021-01-16 21:31:30
7017,941,3,578,75,653,6934,2021-01-16 22:45:25
7018,517,3,747,97,844,6935,2021-01-16 18:53:14
7019,948,3,647,84,731,6936,2021-01-16 18:48:35
7020,673,2,598,77,675,6937,2021-01-16 11:11:23
7021,617,3,558,72,630,6938,2021-01-16 19:13:01
7022,753,6,1724,224,1948,6939,2021-01-17 09:38:08
7023,5,2,798,103,901,6940,2021-01-16 18:34:19
7024,569,6,1935,251,2186,6941,2021-01-17 04:43:34
7025,163,1,149,19,168,6942,2021-01-16 16:24:06
7026,874,3,997,129,1126,6943,2021-01-16 21:25:28
7027,175,2,329,42,371,6944,2021-01-16 23:30:42
7028,344,3,797,103,900,6945,2021-01-17 13:27:10
7029,122,3,827,107,934,6946,2021-01-17 12:48:04
7030,871,6,1874,243,2117,6947,2021-01-17 18:31:54
7031,130,4,1357,176,1533,6948,2021-01-17 13:19:18
7032,47,3,558,72,630,6949,2021-01-17 19:56:21
7033,311,2,429,55,484,6950,2021-01-17 15:19:07
7034,71,3,647,84,731,6951,2021-01-17 04:24:47
7035,924,3,997,129,1126,6952,2021-01-17 13:25:01
7036,302,2,598,77,675,6953,2021-01-16 09:21:20
7037,511,3,947,123,1070,6954,2021-01-16 19:52:06
7038,857,3,597,77,674,6955,2021-01-16 22:02:13
7039,956,2,329,42,371,6956,2021-01-17 07:12:55
7040,584,3,747,97,844,6957,2021-01-17 08:40:58
7041,138,3,947,123,1070,6958,2021-01-17 11:34:13
7042,207,3,1247,162,1409,6959,2021-01-17 04:30:50
7043,160,3,558,72,630,6960,2021-01-17 10:49:48
7044,122,3,1247,162,1409,6961,2021-01-17 04:26:08
7045,464,3,827,107,934,6962,2021-01-16 23:24:18
7046,708,3,1127,146,1273,6963,2021-01-16 08:10:22
7047,138,2,698,90,788,6964,2021-01-16 06:59:44
7048,669,3,897,116,1013,6965,2021-01-16 03:23:26
7049,26,3,897,116,1013,6966,2021-01-17 20:20:31
7050,280,2,698,90,788,6967,2021-01-17 19:34:47
7051,321,3,947,123,1070,6968,2021-01-17 12:28:00
7052,600,5,1456,189,1645,6969,2021-01-18 02:37:52
7053,745,3,797,103,900,6970,2021-01-18 07:48:36
7054,742,2,429,55,484,6971,2021-01-17 17:26:42
7055,109,3,647,84,731,6972,2021-01-17 07:52:51
7056,900,3,747,97,844,6973,2021-01-17 10:57:17
7057,543,3,1047,136,1183,6974,2021-01-17 22:17:43
7058,801,2,429,55,484,6975,2021-01-17 13:25:19
7059,124,3,747,97,844,6976,2021-01-17 19:35:52
7060,844,3,997,129,1126,6977,2021-01-16 19:39:32
7061,623,6,1744,226,1970,6978,2021-01-17 02:44:06
7062,329,2,928,120,1048,6979,2021-01-17 02:16:45
7063,692,3,897,116,1013,6980,2021-01-17 07:02:43
7064,479,3,608,79,687,6981,2021-01-17 05:36:43
7065,644,5,1256,163,1419,6982,2021-01-17 00:14:10
7066,445,3,997,129,1126,6983,2021-01-16 20:47:34
7067,345,3,558,72,630,6984,2021-01-16 20:23:25
7068,698,3,1047,136,1183,6985,2021-01-18 00:18:02
7069,793,3,727,94,821,6986,2021-01-18 00:00:16
7070,169,2,898,116,1014,6987,2021-01-17 22:44:17
7071,620,3,747,97,844,6988,2021-01-17 20:17:39
7072,172,3,608,79,687,6989,2021-01-17 19:54:28
7073,855,3,747,97,844,6990,2021-01-17 19:03:17
7074,990,3,647,84,731,6991,2021-01-17 21:35:28
7075,325,2,1098,142,1240,6992,2021-01-17 16:54:30
7076,338,3,697,90,787,6993,2021-01-17 14:03:55
7077,903,2,659,85,744,6994,2021-01-17 14:08:46
7078,481,3,758,98,856,6995,2021-01-17 07:54:15
7079,478,2,659,85,744,6996,2021-01-17 07:38:13
7080,606,3,558,72,630,6997,2021-01-17 08:07:43
7081,907,4,1046,135,1181,6998,2021-01-17 17:29:28
7082,727,3,1197,155,1352,6999,2021-01-18 05:33:02
7083,197,2,429,55,484,7000,2021-01-17 21:30:14
7084,932,5,1317,171,1488,7001,2021-01-17 13:10:19
7085,289,2,498,64,562,7002,2021-01-16 14:52:50
7086,140,2,459,59,518,7003,2021-01-16 16:30:07
7087,791,3,1197,155,1352,7004,2021-01-16 17:56:18
7088,401,4,987,128,1115,7005,2021-01-16 20:01:03
7089,860,3,827,107,934,7006,2021-01-16 22:01:24
7090,90,1,149,19,168,7007,2021-01-17 02:22:56
7091,410,3,758,98,856,7008,2021-01-17 05:34:53
7092,929,5,1395,181,1576,7009,2021-01-17 06:36:28
7093,880,3,797,103,900,7010,2021-01-17 22:44:27
7094,117,3,727,94,821,7011,2021-01-16 16:45:50
7095,807,6,1894,246,2140,7012,2021-01-16 22:37:47
7096,170,2,648,84,732,7013,2021-01-17 07:28:09
7097,653,3,827,107,934,7014,2021-01-17 06:49:59
7098,715,2,928,120,1048,7015,2021-01-17 08:11:12
7099,713,3,688,89,777,7016,2021-01-17 10:34:29
7100,565,3,1127,146,1273,7017,2021-01-17 18:22:56
7101,573,2,798,103,901,7018,2021-01-17 00:03:29
7102,231,3,947,123,1070,7019,2021-01-16 23:49:29
7103,609,4,727,94,821,7020,2021-01-16 18:58:48
7104,205,2,1098,142,1240,7021,2021-01-16 21:31:22
7105,232,3,1027,133,1160,7022,2021-01-16 12:12:24
7106,605,3,1027,133,1160,7023,2021-01-16 20:09:49
7107,567,3,1197,155,1352,7024,2021-01-17 11:57:03
7108,285,3,1047,136,1183,7025,2021-01-16 18:57:31
7109,164,3,897,116,1013,7026,2021-01-17 05:07:59
7110,678,3,478,62,540,7027,2021-01-16 17:30:13
7111,288,2,1098,142,1240,7028,2021-01-16 23:58:34
7112,901,3,558,72,630,7029,2021-01-17 00:42:57
7113,991,3,1047,136,1183,7030,2021-01-17 14:31:23
7114,44,3,558,72,630,7031,2021-01-17 15:25:20
7115,97,2,1098,142,1240,7032,2021-01-17 18:41:48
7116,544,2,698,90,788,7033,2021-01-17 15:09:19
7117,321,2,498,64,562,7034,2021-01-17 20:17:22
7118,355,3,697,90,787,7035,2021-01-17 15:21:17
7119,642,5,1775,230,2005,7036,2021-01-17 05:58:00
7120,247,3,697,90,787,7037,2021-01-17 16:05:14
7121,550,3,608,79,687,7038,2021-01-16 10:16:35
7122,91,3,1047,136,1183,7039,2021-01-16 21:20:02
7123,364,2,498,64,562,7040,2021-01-16 22:19:19
7124,166,1,229,29,258,7041,2021-01-17 09:10:02
7125,945,3,558,72,630,7042,2021-01-17 09:18:48
7126,573,2,898,116,1014,7043,2021-01-17 12:52:45
7127,706,3,647,84,731,7044,2021-01-17 06:45:51
7128,698,3,608,79,687,7045,2021-01-17 11:30:36
7129,638,3,1127,146,1273,7046,2021-01-17 04:47:43
7130,824,3,658,85,743,7047,2021-01-17 00:05:44
7131,665,3,658,85,743,7048,2021-01-16 10:11:24
7132,754,2,598,77,675,7049,2021-01-16 09:14:41
7133,23,2,898,116,1014,7050,2021-01-16 06:04:32
7134,242,3,727,94,821,7051,2021-01-17 21:14:15
7135,670,3,558,72,630,7052,2021-01-17 22:00:40
7136,117,2,898,116,1014,7053,2021-01-17 12:55:55
7137,406,3,827,107,934,7054,2021-01-18 03:41:53
7138,230,2,329,42,371,7055,2021-01-18 08:24:32
7139,753,2,429,55,484,7056,2021-01-17 18:44:46
7140,673,5,1456,189,1645,7057,2021-01-17 08:43:24
7141,21,1,149,19,168,7058,2021-01-17 10:59:40
7142,157,2,498,64,562,7059,2021-01-17 23:19:09
7143,901,3,827,107,934,7060,2021-01-17 16:06:07
7144,344,2,429,55,484,7061,2021-01-17 21:45:23
7145,133,2,698,90,788,7062,2021-01-16 19:54:53
7146,99,4,1646,213,1859,7063,2021-01-17 04:52:33
7147,769,5,1186,154,1340,7064,2021-01-17 02:57:42
7148,415,2,598,77,675,7065,2021-01-17 08:00:22
7149,361,3,558,72,630,7066,2021-01-17 06:55:02
7150,78,2,598,77,675,7067,2021-01-17 02:33:29
7151,32,4,987,128,1115,7068,2021-01-16 22:26:52
7152,943,3,997,129,1126,7069,2021-01-16 22:24:32
7153,69,4,1096,142,1238,7070,2021-01-18 01:26:17
7154,911,5,1536,199,1735,7071,2021-01-18 00:27:24
7155,884,1,299,38,337,7072,2021-01-18 00:45:37
7156,560,3,758,98,856,7073,2021-01-17 22:32:56
7157,884,2,598,77,675,7074,2021-01-17 20:27:05
7158,529,5,1376,178,1554,7075,2021-01-17 21:22:56
7159,156,5,1017,132,1149,7076,2021-01-17 23:05:51
7160,299,3,697,90,787,7077,2021-01-17 17:33:01
7161,163,3,997,129,1126,7078,2021-01-17 15:18:21
7162,183,3,747,97,844,7079,2021-01-17 15:39:37
7163,72,3,1127,146,1273,7080,2021-01-17 09:06:08
7164,800,5,1056,137,1193,7081,2021-01-17 07:56:44
7165,840,2,429,55,484,7082,2021-01-17 10:19:02
7166,966,6,1575,204,1779,7083,2021-01-17 19:10:40
7167,166,2,498,64,562,7084,2021-01-18 08:08:47
7168,951,2,498,64,562,7085,2021-01-17 21:32:08
7169,627,2,459,59,518,7086,2021-01-17 14:35:00
7170,584,3,827,107,934,7087,2021-01-16 15:02:57
7171,67,3,808,105,913,7088,2021-01-16 17:53:41
7172,758,2,798,103,901,7089,2021-01-16 18:50:50
7173,508,3,578,75,653,7090,2021-01-16 21:15:39
7174,153,3,428,55,483,7091,2021-01-17 00:46:53
7175,89,3,1047,136,1183,7092,2021-01-17 04:32:59
7176,289,3,888,115,1003,7093,2021-01-17 05:46:28
7177,325,6,1474,191,1665,7094,2021-01-17 08:02:39
7178,287,3,888,115,1003,7095,2021-01-17 23:12:55
7179,92,2,459,59,518,7096,2021-01-16 17:54:44
7180,770,2,459,59,518,7097,2021-01-17 01:03:38
7181,375,5,1126,146,1272,7098,2021-01-17 08:34:49
7182,467,2,329,42,371,7099,2021-01-17 07:59:50
7183,479,2,598,77,675,7100,2021-01-17 10:32:24
7184,304,3,1127,146,1273,7101,2021-01-17 12:28:53
7185,558,5,1406,182,1588,7102,2021-01-17 19:19:06
7186,79,3,997,129,1126,7103,2021-01-17 00:47:18
7187,769,3,1127,146,1273,7104,2021-01-17 00:29:17
7188,677,2,448,58,506,7105,2021-01-16 19:06:50
7189,579,5,1345,174,1519,7106,2021-01-16 21:39:26
7190,501,4,1157,150,1307,7107,2021-01-16 13:20:57
7191,393,5,1706,221,1927,7108,2021-01-16 22:01:29
7192,989,5,1245,161,1406,7109,2021-01-17 14:40:25
7193,943,3,997,129,1126,7110,2021-01-16 19:33:20
7194,563,3,578,75,653,7111,2021-01-17 06:47:09
7195,438,2,598,77,675,7112,2021-01-16 18:35:05
7196,288,2,329,42,371,7113,2021-01-17 00:49:22
7197,639,3,847,110,957,7114,2021-01-17 01:27:14
7198,579,3,578,75,653,7115,2021-01-17 16:02:12
7199,797,3,747,97,844,7116,2021-01-17 16:34:41
7200,379,3,608,79,687,7117,2021-01-17 19:24:23
7201,586,2,329,42,371,7118,2021-01-17 17:22:29
7202,373,3,947,123,1070,7119,2021-01-17 20:54:00
7203,752,3,558,72,630,7120,2021-01-17 16:24:37
7204,59,3,997,129,1126,7121,2021-01-17 06:41:21
7205,789,2,698,90,788,7122,2021-01-17 16:37:17
7206,401,2,698,90,788,7123,2021-01-16 12:28:34
7207,752,3,1047,136,1183,7124,2021-01-17 00:04:34
7208,629,3,758,98,856,7125,2021-01-16 22:41:41
7209,557,5,1575,204,1779,7126,2021-01-17 10:34:26
7210,441,2,1098,142,1240,7127,2021-01-17 10:15:43
7211,990,3,1158,150,1308,7128,2021-01-17 12:54:26
7212,129,3,528,68,596,7129,2021-01-17 06:46:56
7213,512,3,747,97,844,7130,2021-01-17 12:37:57
7214,620,3,688,89,777,7131,2021-01-17 07:07:03
7215,655,5,1745,226,1971,7132,2021-01-17 02:25:58
7216,773,3,597,77,674,7133,2021-01-16 12:55:21
7217,561,3,558,72,630,7134,2021-01-16 10:25:01
7218,273,6,2154,280,2434,7135,2021-01-16 07:45:23
7219,768,3,528,68,596,7136,2021-01-17 22:59:39
7220,330,3,528,68,596,7137,2021-01-17 23:20:43
7221,484,6,1225,159,1384,7138,2021-01-17 14:59:23
7222,618,3,1197,155,1352,7139,2021-01-18 05:49:59
7223,889,2,798,103,901,7140,2021-01-18 09:45:44
7224,636,6,1285,167,1452,7141,2021-01-17 21:22:00
7225,110,3,578,75,653,7142,2021-01-17 09:20:24
7226,274,5,1825,237,2062,7143,2021-01-17 12:02:24
7227,296,5,1356,176,1532,7144,2021-01-18 00:47:47
7228,334,3,797,103,900,7145,2021-01-17 16:45:48
7229,195,2,598,77,675,7146,2021-01-17 23:45:58
7230,920,3,1047,136,1183,7147,2021-01-16 21:15:59
7231,474,1,399,51,450,7148,2021-01-17 05:14:08
7232,105,3,478,62,540,7149,2021-01-17 05:07:31
7233,713,3,1047,136,1183,7150,2021-01-17 10:40:24
7234,513,2,659,85,744,7151,2021-01-17 08:53:17
7235,808,2,459,59,518,7152,2021-01-17 04:08:58
7236,485,2,329,42,371,7153,2021-01-17 00:57:47
7237,117,2,459,59,518,7154,2021-01-16 23:21:21
7238,750,3,428,55,483,7155,2021-01-18 03:39:52
7239,255,2,448,58,506,7156,2021-01-18 01:01:58
7240,872,3,747,97,844,7157,2021-01-18 01:35:12
7241,23,3,747,97,844,7158,2021-01-18 00:38:04
7242,76,3,808,105,913,7159,2021-01-17 20:35:27
7243,819,3,428,55,483,7160,2021-01-17 22:05:32
7244,506,2,898,116,1014,7161,2021-01-18 01:15:34
7245,2,3,608,79,687,7162,2021-01-17 19:31:23
7246,548,3,1327,172,1499,7163,2021-01-17 17:11:30
7247,392,2,429,55,484,7164,2021-01-17 17:46:25
7248,806,6,1225,159,1384,7165,2021-01-17 11:12:24
7249,806,6,1225,159,1384,7165,2021-01-17 11:12:24
7250,316,2,598,77,675,7166,2021-01-17 10:28:21
7251,924,3,688,89,777,7167,2021-01-17 12:27:23
7252,109,2,798,103,901,7168,2021-01-17 21:36:54
7253,546,3,727,94,821,7169,2021-01-18 08:12:37
7254,910,2,659,85,744,7170,2021-01-18 00:09:09
7255,864,2,628,81,709,7171,2021-01-17 16:47:57
7256,561,3,808,105,913,7172,2021-01-16 15:08:43
7257,562,2,628,81,709,7173,2021-01-16 19:38:46
7258,947,2,459,59,518,7174,2021-01-16 20:38:24
7259,200,5,1356,176,1532,7175,2021-01-16 21:30:54
7260,864,6,1305,169,1474,7176,2021-01-17 03:24:07
7261,924,3,747,97,844,7177,2021-01-17 06:07:46
7262,848,3,697,90,787,7178,2021-01-17 06:55:33
7263,673,2,659,85,744,7179,2021-01-17 08:48:12
7264,663,3,997,129,1126,7180,2021-01-18 01:55:12
7265,130,3,1327,172,1499,7181,2021-01-16 18:05:27
7266,455,3,947,123,1070,7182,2021-01-17 01:35:24
7267,773,3,827,107,934,7183,2021-01-17 09:47:32
7268,149,3,1327,172,1499,7184,2021-01-17 08:19:56
7269,978,3,558,72,630,7185,2021-01-17 12:26:33
7270,264,2,698,90,788,7186,2021-01-17 14:50:44
7271,111,2,329,42,371,7187,2021-01-17 21:43:44
7272,421,2,1098,142,1240,7188,2021-01-17 01:14:15
7273,367,3,758,98,856,7189,2021-01-17 01:22:52
7274,226,2,898,116,1014,7190,2021-01-16 21:22:34
7275,722,1,399,51,450,7191,2021-01-16 22:12:13
7276,309,2,1098,142,1240,7192,2021-01-16 14:20:17
7277,60,2,659,85,744,7193,2021-01-16 22:50:33
7278,872,2,898,116,1014,7194,2021-01-17 15:24:48
7279,121,3,758,98,856,7195,2021-01-16 20:03:02
7280,294,2,798,103,901,7196,2021-01-17 09:32:10
7281,53,2,429,55,484,7197,2021-01-16 18:43:04
7282,167,3,1197,155,1352,7198,2021-01-17 02:05:05
7283,951,2,459,59,518,7199,2021-01-17 02:37:12
7284,4,3,808,105,913,7200,2021-01-17 18:10:01
7285,642,3,997,129,1126,7201,2021-01-17 17:15:17
7286,105,2,748,97,845,7202,2021-01-17 20:43:26
7287,482,3,558,72,630,7203,2021-01-17 17:27:10
7288,630,2,828,107,935,7204,2021-01-17 22:21:07
7289,965,3,697,90,787,7205,2021-01-17 18:31:47
7290,600,3,927,120,1047,7206,2021-01-17 07:14:41
7291,469,3,747,97,844,7207,2021-01-17 18:12:26
7292,825,3,428,55,483,7208,2021-01-16 12:34:52
7293,279,3,647,84,731,7209,2021-01-17 00:06:25
7294,257,3,428,55,483,7210,2021-01-17 01:24:00
7295,906,4,926,120,1046,7211,2021-01-17 12:30:49
7296,183,3,797,103,900,7212,2021-01-17 12:49:17
7297,513,5,1595,207,1802,7213,2021-01-17 14:22:47
7298,803,3,1127,146,1273,7214,2021-01-17 08:02:23
7299,226,2,898,116,1014,7215,2021-01-17 14:02:14
7300,116,2,429,55,484,7216,2021-01-17 08:43:17
7301,226,2,659,85,744,7217,2021-01-17 02:55:05
7302,137,3,428,55,483,7218,2021-01-16 13:36:05
7303,104,2,329,42,371,7219,2021-01-16 12:35:26
7304,133,2,498,64,562,7220,2021-01-16 08:13:24
7305,740,3,747,97,844,7221,2021-01-18 00:16:57
7306,348,1,229,29,258,7222,2021-01-17 23:47:53
7307,397,1,499,64,563,7223,2021-01-17 15:35:09
7308,338,4,1196,155,1351,7224,2021-01-18 06:38:41
7309,769,3,1247,162,1409,7225,2021-01-18 12:07:13
7310,968,5,1326,172,1498,7226,2021-01-17 22:38:51
7311,29,3,647,84,731,7227,2021-01-17 12:01:05
7312,365,3,558,72,630,7228,2021-01-17 13:46:52
7313,824,2,598,77,675,7229,2021-01-18 01:06:25
7314,698,2,698,90,788,7230,2021-01-17 19:04:37
7315,15,3,888,115,1003,7231,2021-01-18 01:02:03
7316,593,3,797,103,900,7232,2021-01-16 22:28:53
7317,113,3,1047,136,1183,7233,2021-01-17 07:13:32
7318,927,5,1175,152,1327,7234,2021-01-17 05:35:29
7319,800,4,977,127,1104,7235,2021-01-17 11:49:45
7320,272,2,459,59,518,7236,2021-01-17 09:31:04
7321,65,3,428,55,483,7237,2021-01-17 05:47:23
7322,46,3,827,107,934,7238,2021-01-17 01:11:13
7323,174,3,1197,155,1352,7239,2021-01-17 01:34:09
7324,767,1,299,38,337,7240,2021-01-18 05:41:24
7325,924,4,1276,165,1441,7241,2021-01-18 03:18:44
7326,11,3,797,103,900,7242,2021-01-18 02:19:11
7327,606,3,997,129,1126,7243,2021-01-18 02:59:54
7328,274,3,808,105,913,7244,2021-01-17 22:51:16
7329,978,2,659,85,744,7245,2021-01-18 00:00:46
7330,28,2,429,55,484,7246,2021-01-18 04:01:25
7331,979,3,797,103,900,7247,2021-01-17 20:45:35
7332,591,3,478,62,540,7248,2021-01-17 19:48:52
7333,899,2,1098,142,1240,7249,2021-01-17 18:18:31
7334,514,2,598,77,675,7250,2021-01-17 13:48:01
7335,541,3,1027,133,1160,7251,2021-01-17 13:06:55
7336,824,3,947,123,1070,7252,2021-01-17 12:28:46
7337,189,3,608,79,687,7253,2021-01-17 14:31:47
7338,941,3,697,90,787,7254,2021-01-18 00:00:29
7339,934,3,578,75,653,7255,2021-01-18 08:50:57
7340,903,2,498,64,562,7256,2021-01-18 02:44:54
7341,977,1,149,19,168,7257,2021-01-17 16:57:47
7342,450,3,558,72,630,7258,2021-01-16 17:17:50
7343,443,2,598,77,675,7259,2021-01-16 20:12:07
7344,254,2,598,77,675,7260,2021-01-16 21:05:28
7345,13,3,1327,172,1499,7261,2021-01-16 22:27:31
7346,800,2,748,97,845,7262,2021-01-17 04:51:28
7347,435,3,1047,136,1183,7263,2021-01-17 06:44:56
7348,407,5,1556,202,1758,7264,2021-01-17 08:59:15
7349,661,3,1027,133,1160,7265,2021-01-17 10:21:02
7350,995,3,747,97,844,7266,2021-01-18 04:38:22
7351,288,3,1327,172,1499,7267,2021-01-16 19:54:23
7352,717,3,1327,172,1499,7268,2021-01-17 02:30:24
7353,38,5,1395,181,1576,7269,2021-01-17 11:09:20
7354,45,3,428,55,483,7270,2021-01-17 09:21:10
7355,241,3,1327,172,1499,7271,2021-01-17 14:06:22
7356,659,3,1127,146,1273,7272,2021-01-17 16:55:30
7357,609,3,747,97,844,7273,2021-01-17 21:50:12
7358,676,2,598,77,675,7274,2021-01-17 02:27:28
7359,405,2,659,85,744,7275,2021-01-17 02:41:55
7360,799,2,698,90,788,7276,2021-01-16 23:08:53
7361,623,3,1327,172,1499,7277,2021-01-16 22:14:18
7362,276,3,597,77,674,7278,2021-01-16 16:18:15
7363,708,3,897,116,1013,7279,2021-01-17 01:17:24
7364,966,3,827,107,934,7280,2021-01-17 15:26:50
7365,691,3,1247,162,1409,7281,2021-01-16 21:16:16
7366,407,3,997,129,1126,7282,2021-01-17 12:01:15
7367,579,2,898,116,1014,7283,2021-01-16 19:40:22
7368,646,3,797,103,900,7284,2021-01-17 04:00:27
7369,8,5,987,128,1115,7285,2021-01-17 04:35:06
7370,474,6,1615,209,1824,7286,2021-01-17 20:02:52
7371,769,2,598,77,675,7287,2021-01-17 18:38:41
7372,106,2,898,116,1014,7288,2021-01-17 21:06:57
7373,154,3,747,97,844,7289,2021-01-17 18:16:50
7374,689,2,848,110,958,7290,2021-01-17 23:46:18
7375,262,3,1127,146,1273,7291,2021-01-17 20:43:30
7376,418,3,1127,146,1273,7292,2021-01-17 08:24:57
7377,652,3,927,120,1047,7293,2021-01-17 18:40:25
7378,266,3,688,89,777,7294,2021-01-16 14:45:18
7379,268,3,827,107,934,7295,2021-01-17 00:28:22
7380,527,3,1047,136,1183,7296,2021-01-17 03:13:58
7381,660,3,697,90,787,7297,2021-01-17 13:45:05
7382,847,3,528,68,596,7298,2021-01-17 15:32:05
7383,886,3,747,97,844,7299,2021-01-17 15:55:14
7384,639,3,688,89,777,7300,2021-01-17 08:03:16
7385,430,3,827,107,934,7301,2021-01-17 14:31:32
7386,469,3,1127,146,1273,7302,2021-01-17 09:44:54
7387,115,3,658,85,743,7303,2021-01-17 05:18:13
7388,110,3,888,115,1003,7304,2021-01-16 14:24:34
7389,0,4,1126,146,1272,7305,2021-01-16 15:05:53
7390,180,3,697,90,787,7306,2021-01-16 10:30:55
7391,22,2,498,64,562,7307,2021-01-18 01:03:33
7392,292,3,927,120,1047,7308,2021-01-18 02:06:33
7393,996,3,797,103,900,7309,2021-01-17 16:27:03
7394,577,3,997,129,1126,7310,2021-01-18 06:52:40
7395,708,3,827,107,934,7311,2021-01-18 13:21:26
7396,326,3,697,90,787,7312,2021-01-18 00:03:20
7397,894,2,329,42,371,7313,2021-01-17 14:06:59
7398,922,2,698,90,788,7314,2021-01-17 15:13:49
7399,201,3,647,84,731,7315,2021-01-18 03:51:08
7400,270,3,888,115,1003,7316,2021-01-17 19:20:00
7401,193,1,299,38,337,7317,2021-01-18 03:19:39
7402,353,2,459,59,518,7318,2021-01-16 22:50:53
7403,401,4,1296,168,1464,7319,2021-01-17 07:18:13
7404,354,3,1247,162,1409,7320,2021-01-17 07:47:14
7405,790,3,558,72,630,7321,2021-01-17 14:36:02
7406,900,3,847,110,957,7322,2021-01-17 10:27:02
7407,247,2,798,103,901,7323,2021-01-17 06:14:52
7408,790,5,1395,181,1576,7324,2021-01-17 03:12:39
7409,922,3,1027,133,1160,7325,2021-01-17 03:42:27
7410,682,5,1126,146,1272,7326,2021-01-18 07:10:56
7411,971,3,558,72,630,7327,2021-01-18 03:38:37
7412,349,2,798,103,901,7328,2021-01-18 04:08:15
7413,584,1,229,29,258,7329,2021-01-18 04:14:41
7414,204,3,697,90,787,7330,2021-01-18 01:25:50
7415,509,3,1027,133,1160,7331,2021-01-18 01:08:54
7416,430,3,1127,146,1273,7332,2021-01-18 05:56:27
7417,58,4,1257,163,1420,7333,2021-01-17 22:31:11
7418,232,3,847,110,957,7334,2021-01-17 22:01:51
7419,530,3,688,89,777,7335,2021-01-17 18:23:34
7420,242,3,927,120,1047,7336,2021-01-17 14:40:21
7421,558,1,149,19,168,7337,2021-01-17 14:07:14
7422,214,4,1346,174,1520,7338,2021-01-17 14:08:59
7423,415,3,697,90,787,7339,2021-01-17 15:46:54
7424,122,2,598,77,675,7340,2021-01-18 00:13:15
7425,688,5,1645,213,1858,7341,2021-01-18 10:30:57
7426,425,2,828,107,935,7342,2021-01-18 03:53:57
7427,329,3,808,105,913,7343,2021-01-17 18:33:46
7428,530,3,747,97,844,7344,2021-01-16 19:40:00
7429,299,3,688,89,777,7345,2021-01-16 22:31:48
7430,14,6,1874,243,2117,7346,2021-01-16 23:05:55
7431,964,3,528,68,596,7347,2021-01-16 23:26:15
7432,808,2,498,64,562,7348,2021-01-17 05:43:15
7433,418,3,1327,172,1499,7349,2021-01-17 07:26:30
7434,308,3,697,90,787,7350,2021-01-17 11:13:21
7435,927,2,748,97,845,7351,2021-01-17 11:08:30
7436,195,3,1327,172,1499,7352,2021-01-18 07:04:02
7437,639,3,597,77,674,7353,2021-01-16 21:08:52
7438,14,3,827,107,934,7354,2021-01-17 05:00:51
7439,504,5,1417,184,1601,7355,2021-01-17 13:17:19
7440,790,3,697,90,787,7356,2021-01-17 10:19:54
7441,845,2,898,116,1014,7357,2021-01-17 15:07:33
7442,718,2,798,103,901,7358,2021-01-17 17:59:53
7443,33,2,498,64,562,7359,2021-01-17 22:32:58
7444,931,2,448,58,506,7360,2021-01-17 04:51:43
7445,917,3,1127,146,1273,7361,2021-01-17 03:35:04
7446,480,3,1097,142,1239,7362,2021-01-16 23:57:33
7447,910,5,1286,167,1453,7363,2021-01-17 00:13:09
7448,688,2,698,90,788,7364,2021-01-16 18:28:12
7449,357,5,1625,211,1836,7365,2021-01-17 02:26:54
7450,34,3,947,123,1070,7366,2021-01-17 17:41:44
7451,939,1,599,77,676,7367,2021-01-16 21:34:16
7452,304,4,1156,150,1306,7368,2021-01-17 12:52:27
7453,784,2,459,59,518,7369,2021-01-16 20:11:16
7454,504,2,598,77,675,7370,2021-01-17 04:33:45
7455,996,4,1326,172,1498,7371,2021-01-17 04:43:23
7456,701,3,1327,172,1499,7372,2021-01-17 20:39:32
7457,858,6,1644,213,1857,7373,2021-01-17 20:39:15
7458,434,3,578,75,653,7374,2021-01-17 22:43:56
7459,54,3,827,107,934,7375,2021-01-17 18:57:12
7460,487,3,1197,155,1352,7376,2021-01-18 00:38:56
7461,434,2,329,42,371,7377,2021-01-17 23:08:54
7462,628,2,1098,142,1240,7378,2021-01-17 09:03:30
7463,634,2,459,59,518,7379,2021-01-17 20:16:15
7464,553,3,827,107,934,7380,2021-01-16 16:40:05
7465,142,3,847,110,957,7381,2021-01-17 02:57:39
7466,413,3,888,115,1003,7382,2021-01-17 03:19:17
7467,182,3,847,110,957,7383,2021-01-17 14:39:39
7468,442,6,1355,176,1531,7384,2021-01-17 16:26:40
7469,205,2,648,84,732,7385,2021-01-17 17:56:59
7470,22,3,428,55,483,7386,2021-01-17 08:20:47
7471,309,3,747,97,844,7387,2021-01-17 14:41:13
7472,280,2,498,64,562,7388,2021-01-17 10:56:43
7473,889,3,578,75,653,7389,2021-01-17 06:35:35
7474,493,3,888,115,1003,7390,2021-01-16 16:13:06
7475,471,3,1197,155,1352,7391,2021-01-16 15:43:43
7476,617,2,598,77,675,7392,2021-01-16 11:30:51
7477,103,4,1126,146,1272,7393,2021-01-18 03:10:15
7478,134,3,688,89,777,7394,2021-01-18 02:37:14
7479,710,2,1098,142,1240,7395,2021-01-17 18:38:11
7480,304,2,329,42,371,7396,2021-01-18 08:58:01
7481,849,3,658,85,743,7397,2021-01-18 14:08:02
7482,569,2,598,77,675,7398,2021-01-18 00:05:56
7483,32,3,747,97,844,7399,2021-01-17 16:28:24
7484,384,3,1247,162,1409,7400,2021-01-17 15:22:46
7485,581,3,847,110,957,7401,2021-01-18 05:22:20
7486,161,1,399,51,450,7402,2021-01-17 19:35:42
7487,771,4,996,129,1125,7403,2021-01-18 04:14:52
7488,581,2,498,64,562,7404,2021-01-16 23:27:10
7489,529,5,1645,213,1858,7405,2021-01-17 08:16:26
7490,166,3,1047,136,1183,7406,2021-01-17 08:48:20
7491,434,2,459,59,518,7407,2021-01-17 16:43:38
7492,203,2,828,107,935,7408,2021-01-17 12:19:27
7493,606,3,947,123,1070,7409,2021-01-17 09:01:24
7494,784,3,1047,136,1183,7410,2021-01-17 03:59:11
7495,755,5,1875,243,2118,7411,2021-01-17 04:23:18
7496,360,1,599,77,676,7412,2021-01-18 09:54:46
7497,426,5,1106,143,1249,7413,2021-01-18 03:47:29
7498,325,1,229,29,258,7414,2021-01-18 05:37:00
7499,241,3,697,90,787,7415,2021-01-18 06:14:47
7500,232,2,598,77,675,7416,2021-01-18 02:09:28
7501,330,3,847,110,957,7417,2021-01-18 01:59:59
7502,260,3,1327,172,1499,7418,2021-01-18 07:50:48
7503,301,3,827,107,934,7419,2021-01-18 00:38:57
7504,540,3,947,123,1070,7420,2021-01-17 23:16:10
7505,168,3,1197,155,1352,7421,2021-01-17 21:10:12
7506,629,3,1047,136,1183,7422,2021-01-17 17:03:46
7507,803,2,628,81,709,7423,2021-01-17 15:54:57
7508,346,3,997,129,1126,7424,2021-01-17 16:44:23
7509,7,2,1098,142,1240,7425,2021-01-17 17:39:43
7510,852,3,697,90,787,7426,2021-01-18 02:15:43
7511,321,1,499,64,563,7427,2021-01-18 11:16:37
7512,863,3,558,72,630,7428,2021-01-18 05:12:04
7513,12,3,528,68,596,7429,2021-01-17 19:37:22
7514,89,3,1047,136,1183,7430,2021-01-16 21:13:54
7515,837,3,478,62,540,7431,2021-01-17 00:12:52
7516,111,3,1247,162,1409,7432,2021-01-17 00:00:17
7517,535,2,628,81,709,7433,2021-01-17 00:45:30
7518,539,2,798,103,901,7434,2021-01-17 07:24:24
7519,102,6,2244,291,2535,7435,2021-01-17 08:21:53
7520,875,2,498,64,562,7436,2021-01-17 13:28:46
7521,367,2,659,85,744,7437,2021-01-17 13:38:36
7522,966,3,947,123,1070,7438,2021-01-18 09:30:12
7523,7,2,1098,142,1240,7439,2021-01-16 21:48:49
7524,927,2,898,116,1014,7440,2021-01-17 06:59:32
7525,146,2,329,42,371,7441,2021-01-17 14:17:27
7526,542,2,598,77,675,7442,2021-01-17 13:00:03
7527,450,3,797,103,900,7443,2021-01-17 17:35:17
7528,71,3,888,115,1003,7444,2021-01-17 19:22:41
7529,816,5,1825,237,2062,7445,2021-01-18 01:09:07
7530,772,4,1157,150,1307,7446,2021-01-17 06:20:41
7531,798,2,598,77,675,7447,2021-01-17 04:28:50
7532,900,3,727,94,821,7448,2021-01-17 02:02:09
7533,854,2,798,103,901,7449,2021-01-17 01:24:38
7534,121,3,697,90,787,7450,2021-01-16 19:28:20
7535,693,1,599,77,676,7451,2021-01-17 03:32:30
7536,262,2,429,55,484,7452,2021-01-17 19:15:52
7537,536,3,578,75,653,7453,2021-01-16 22:26:14
7538,383,2,329,42,371,7454,2021-01-17 14:21:49
7539,920,2,528,68,596,7455,2021-01-16 21:57:19
7540,761,3,758,98,856,7456,2021-01-17 07:03:46
7541,277,2,798,103,901,7457,2021-01-17 06:39:49
7542,67,3,897,116,1013,7458,2021-01-17 23:25:58
7543,63,2,429,55,484,7459,2021-01-17 23:00:06
7544,85,5,2225,289,2514,7460,2021-01-18 00:36:43
7545,527,3,897,116,1013,7461,2021-01-17 19:34:02
7546,350,3,888,115,1003,7462,2021-01-18 02:03:31
7547,474,3,1047,136,1183,7463,2021-01-18 01:12:37
7548,969,4,927,120,1047,7464,2021-01-17 10:10:05
7549,969,4,927,120,1047,7464,2021-01-17 10:10:05
7550,883,2,329,42,371,7465,2021-01-17 20:29:05
7551,507,2,598,77,675,7466,2021-01-16 19:01:25
7552,627,5,1406,182,1588,7467,2021-01-17 04:24:26
7553,692,3,808,105,913,7468,2021-01-17 05:10:51
7554,959,3,808,105,913,7469,2021-01-17 15:20:38
7555,142,3,827,107,934,7470,2021-01-17 16:54:37
7556,453,2,528,68,596,7471,2021-01-17 19:15:02
7557,641,3,947,123,1070,7472,2021-01-17 08:24:05
7558,797,5,1545,200,1745,7473,2021-01-17 15:45:32
7559,892,2,898,116,1014,7474,2021-01-17 11:24:53
7560,901,3,597,77,674,7475,2021-01-17 09:05:22
7561,413,3,578,75,653,7476,2021-01-16 17:04:56
7562,533,5,826,107,933,7477,2021-01-16 15:46:39
7563,102,3,597,77,674,7478,2021-01-16 14:12:23
7564,441,3,888,115,1003,7479,2021-01-18 03:54:45
7565,864,3,1047,136,1183,7480,2021-01-18 03:06:08
7566,797,5,1186,154,1340,7481,2021-01-17 18:41:23
7567,407,3,997,129,1126,7482,2021-01-18 10:23:26
7568,406,5,857,111,968,7483,2021-01-18 14:29:03
7569,540,2,659,85,744,7484,2021-01-18 01:31:39
7570,755,2,459,59,518,7485,2021-01-17 19:02:15
7571,62,3,827,107,934,7486,2021-01-17 15:30:29
7572,387,2,598,77,675,7487,2021-01-18 06:23:18
7573,999,2,459,59,518,7488,2021-01-17 22:18:02
7574,12,3,1127,146,1273,7489,2021-01-18 04:53:13
7575,906,2,598,77,675,7490,2021-01-17 01:14:32
7576,229,3,1247,162,1409,7491,2021-01-17 10:24:39
7577,371,2,898,116,1014,7492,2021-01-17 09:07:12
7578,13,1,499,64,563,7493,2021-01-17 16:56:34
7579,573,3,647,84,731,7494,2021-01-17 14:16:56
7580,745,3,478,62,540,7495,2021-01-17 09:07:05
7581,309,3,558,72,630,7496,2021-01-17 05:53:26
7582,25,1,599,77,676,7497,2021-01-17 06:53:13
7583,86,3,808,105,913,7498,2021-01-18 12:19:18
7584,516,6,1685,219,1904,7499,2021-01-18 06:26:45
7585,298,5,1586,206,1792,7500,2021-01-18 07:23:19
7586,749,3,1047,136,1183,7501,2021-01-18 07:03:43
7587,723,2,598,77,675,7502,2021-01-18 04:44:10
7588,860,3,1197,155,1352,7503,2021-01-18 04:34:52
7589,598,3,647,84,731,7504,2021-01-18 08:10:19
7590,23,2,498,64,562,7505,2021-01-18 01:34:02
7591,273,3,747,97,844,7506,2021-01-18 01:42:39
7592,43,3,658,85,743,7507,2021-01-17 22:06:42
7593,896,3,658,85,743,7508,2021-01-17 17:53:35
7594,221,3,478,62,540,7509,2021-01-17 17:31:11
7595,859,3,697,90,787,7510,2021-01-17 18:04:34
7596,329,3,827,107,934,7511,2021-01-17 18:30:33
7597,936,2,598,77,675,7512,2021-01-18 04:36:05
7598,263,2,1098,142,1240,7513,2021-01-18 12:06:15
7599,617,2,698,90,788,7514,2021-01-18 05:19:10
7600,379,3,558,72,630,7515,2021-01-17 20:55:11
7601,471,3,647,84,731,7516,2021-01-16 22:41:23
7602,712,3,997,129,1126,7517,2021-01-17 00:47:12
7603,68,2,598,77,675,7518,2021-01-17 00:17:43
7604,386,5,1706,221,1927,7519,2021-01-17 03:06:11
7605,357,3,1047,136,1183,7520,2021-01-17 09:35:18
7606,628,3,847,110,957,7521,2021-01-17 10:53:17
7607,408,3,697,90,787,7522,2021-01-17 15:28:24
7608,718,2,548,71,619,7523,2021-01-17 14:14:17
7609,707,3,428,55,483,7524,2021-01-18 10:49:15
7610,298,6,1494,194,1688,7525,2021-01-17 00:27:10
7611,157,3,1197,155,1352,7526,2021-01-17 08:24:33
7612,667,3,827,107,934,7527,2021-01-17 16:53:23
7613,965,2,798,103,901,7528,2021-01-17 15:42:41
7614,651,3,927,120,1047,7529,2021-01-17 18:12:19
7615,55,3,827,107,934,7530,2021-01-17 21:25:32
7616,808,3,897,116,1013,7531,2021-01-18 02:50:46
7617,321,3,1047,136,1183,7532,2021-01-17 07:32:14
7618,557,2,329,42,371,7533,2021-01-17 05:29:50
7619,886,1,599,77,676,7534,2021-01-17 02:17:55
7620,899,2,659,85,744,7535,2021-01-17 03:38:37
7621,445,2,1098,142,1240,7536,2021-01-16 22:06:10
7622,808,2,798,103,901,7537,2021-01-17 06:13:03
7623,23,3,997,129,1126,7538,2021-01-17 20:44:28
7624,701,3,697,90,787,7539,2021-01-16 23:22:40
7625,0,3,827,107,934,7540,2021-01-17 14:35:49
7626,470,2,498,64,562,7541,2021-01-16 22:40:48
7627,309,2,898,116,1014,7542,2021-01-17 09:36:35
7628,183,3,827,107,934,7543,2021-01-17 07:26:57
7629,270,2,598,77,675,7544,2021-01-18 01:48:38
7630,824,3,1127,146,1273,7545,2021-01-18 01:43:49
7631,898,3,608,79,687,7546,2021-01-18 02:32:24
7632,68,3,827,107,934,7547,2021-01-17 22:18:48
7633,936,6,1494,194,1688,7548,2021-01-18 04:18:14
7634,740,5,956,124,1080,7549,2021-01-18 03:03:24
7635,653,3,827,107,934,7550,2021-01-17 12:32:21
7636,11,3,1327,172,1499,7551,2021-01-17 10:13:38
7637,533,3,1047,136,1183,7552,2021-01-17 21:56:32
7638,486,3,1327,172,1499,7553,2021-01-16 19:27:28
7639,9,4,1726,224,1950,7554,2021-01-17 04:25:47
7640,610,2,498,64,562,7555,2021-01-17 06:17:26
7641,502,3,558,72,630,7556,2021-01-17 17:06:33
7642,689,2,598,77,675,7557,2021-01-17 17:02:50
7643,437,2,898,116,1014,7558,2021-01-17 20:49:15
7644,787,2,898,116,1014,7559,2021-01-17 08:34:52
7645,683,3,1027,133,1160,7560,2021-01-17 17:34:54
7646,344,3,927,120,1047,7561,2021-01-17 14:00:26
7647,143,3,558,72,630,7562,2021-01-17 10:23:53
7648,338,6,1824,237,2061,7563,2021-01-16 19:09:31
7649,404,4,1326,172,1498,7564,2021-01-16 18:10:46
7650,356,2,498,64,562,7565,2021-01-16 15:00:33
7651,69,5,1925,250,2175,7566,2021-01-18 06:01:40
7652,70,2,1098,142,1240,7567,2021-01-18 05:41:36
7653,985,3,808,105,913,7568,2021-01-17 21:23:25
7654,532,3,888,115,1003,7569,2021-01-18 10:43:40
7655,839,3,827,107,934,7570,2021-01-18 15:35:54
7656,334,5,1825,237,2062,7571,2021-01-18 02:24:52
7657,560,3,827,107,934,7572,2021-01-17 21:02:19
7658,316,6,1824,237,2061,7573,2021-01-17 17:47:19
7659,528,3,997,129,1126,7574,2021-01-18 06:49:57
7660,379,3,927,120,1047,7575,2021-01-18 00:33:38
7661,131,2,659,85,744,7576,2021-01-18 05:33:01
7662,958,2,548,71,619,7577,2021-01-17 01:48:50
7663,859,6,1086,141,1227,7578,2021-01-17 12:17:41
7664,190,6,1455,189,1644,7579,2021-01-17 10:11:58
7665,509,5,1356,176,1532,7580,2021-01-17 17:35:00
7666,370,3,888,115,1003,7581,2021-01-17 16:18:06
7667,717,2,598,77,675,7582,2021-01-17 10:17:01
7668,737,3,558,72,630,7583,2021-01-17 07:23:52
7669,731,3,747,97,844,7584,2021-01-17 08:58:42
7670,426,3,697,90,787,7585,2021-01-18 14:23:15
7671,55,2,459,59,518,7586,2021-01-18 07:58:03
7672,801,5,1106,143,1249,7587,2021-01-18 09:30:18
7673,199,3,727,94,821,7588,2021-01-18 07:24:59
7674,828,3,1247,162,1409,7589,2021-01-18 05:00:50
7675,702,2,798,103,901,7590,2021-01-18 05:27:12
7676,438,3,827,107,934,7591,2021-01-18 09:13:06
7677,226,2,448,58,506,7592,2021-01-18 04:14:27
7678,136,6,1774,230,2004,7593,2021-01-18 01:48:58
7679,577,3,1047,136,1183,7594,2021-01-17 23:00:36
7680,518,3,688,89,777,7595,2021-01-17 20:32:06
7681,344,2,798,103,901,7596,2021-01-17 20:02:08
7682,568,3,947,123,1070,7597,2021-01-17 19:14:57
7683,466,3,478,62,540,7598,2021-01-17 18:44:46
7684,351,3,578,75,653,7599,2021-01-18 07:01:32
7685,446,3,1047,136,1183,7600,2021-01-18 13:00:49
7686,648,4,957,124,1081,7601,2021-01-18 06:43:23
7687,346,3,997,129,1126,7602,2021-01-17 22:32:09
7688,0,3,697,90,787,7603,2021-01-16 23:57:15
7689,580,3,428,55,483,7604,2021-01-17 03:06:00
7690,662,2,598,77,675,7605,2021-01-17 01:17:11
7691,493,2,598,77,675,7606,2021-01-17 03:41:48
7692,292,3,478,62,540,7607,2021-01-17 11:28:48
7693,687,2,598,77,675,7608,2021-01-17 13:13:48
7694,998,2,598,77,675,7609,2021-01-17 17:06:16
7695,847,3,578,75,653,7610,2021-01-17 16:22:29
7696,731,3,688,89,777,7611,2021-01-18 11:45:40
7697,218,1,699,90,789,7612,2021-01-17 01:07:13
7698,299,2,598,77,675,7613,2021-01-17 09:28:02
7699,282,2,1098,142,1240,7614,2021-01-17 17:30:13
7700,202,2,598,77,675,7615,2021-01-17 16:20:58
7701,915,3,997,129,1126,7616,2021-01-17 19:23:38
7702,516,1,499,64,563,7617,2021-01-17 21:56:15
7703,927,3,827,107,934,7618,2021-01-18 04:01:44
7704,793,2,429,55,484,7619,2021-01-17 08:00:27
7705,4,3,827,107,934,7620,2021-01-17 06:09:37
7706,237,2,598,77,675,7621,2021-01-17 03:13:09
7707,771,3,1047,136,1183,7622,2021-01-17 05:25:37
7708,198,3,758,98,856,7623,2021-01-17 00:43:44
7709,542,5,1186,154,1340,7624,2021-01-17 08:54:44
7710,546,3,528,68,596,7625,2021-01-17 21:16:56
7711,928,3,697,90,787,7626,2021-01-17 01:53:57
7712,7,3,747,97,844,7627,2021-01-17 14:37:23
7713,362,3,697,90,787,7628,2021-01-16 23:38:55
7714,684,3,888,115,1003,7629,2021-01-17 10:08:10
7715,97,5,1045,135,1180,7630,2021-01-17 08:52:37
7716,439,2,628,81,709,7631,2021-01-18 04:05:03
7717,622,2,598,77,675,7632,2021-01-18 03:40:29
7718,608,3,697,90,787,7633,2021-01-18 04:45:45
7719,98,3,1247,162,1409,7634,2021-01-17 23:29:15
7720,182,3,1027,133,1160,7635,2021-01-18 04:47:07
7721,403,2,598,77,675,7636,2021-01-18 05:12:14
7722,54,3,428,55,483,7637,2021-01-17 14:21:16
7723,616,2,598,77,675,7638,2021-01-17 10:16:03
7724,730,6,1735,225,1960,7639,2021-01-18 00:20:10
7725,927,4,1196,155,1351,7640,2021-01-16 19:31:39
7726,632,2,798,103,901,7641,2021-01-17 06:58:47
7727,111,6,1874,243,2117,7642,2021-01-17 08:19:59
7728,403,3,997,129,1126,7643,2021-01-17 18:34:20
7729,517,3,1047,136,1183,7644,2021-01-17 18:56:32
7730,45,2,598,77,675,7645,2021-01-17 23:27:34
7731,851,3,808,105,913,7646,2021-01-17 09:04:39
7732,181,3,478,62,540,7647,2021-01-17 18:39:34
7733,499,4,996,129,1125,7648,2021-01-17 14:53:24
7734,342,2,898,116,1014,7649,2021-01-17 11:05:04
7735,206,2,598,77,675,7650,2021-01-16 19:28:14
7736,115,3,827,107,934,7651,2021-01-16 18:24:35
7737,34,2,598,77,675,7652,2021-01-16 15:30:05
7738,291,2,498,64,562,7653,2021-01-18 08:45:59
7739,372,3,478,62,540,7654,2021-01-18 07:26:33
7740,962,2,898,116,1014,7655,2021-01-17 21:55:33
7741,699,5,1525,198,1723,7656,2021-01-18 10:54:28
7742,307,5,1386,180,1566,7657,2021-01-18 16:51:50
7743,353,3,747,97,844,7658,2021-01-18 04:22:03
7744,275,3,1247,162,1409,7659,2021-01-17 22:10:21
7745,980,3,997,129,1126,7660,2021-01-17 20:28:31
7746,578,1,149,19,168,7661,2021-01-18 09:11:36
7747,596,6,1455,189,1644,7662,2021-01-18 02:24:53
7748,825,3,697,90,787,7663,2021-01-18 07:36:25
7749,447,6,1405,182,1587,7664,2021-01-17 04:21:21
7750,146,3,997,129,1126,7665,2021-01-17 13:16:07
7751,990,2,698,90,788,7666,2021-01-17 10:19:28
7752,300,3,558,72,630,7667,2021-01-17 18:44:49
7753,707,2,698,90,788,7668,2021-01-17 17:55:27
7754,575,2,398,51,449,7669,2021-01-17 13:00:02
7755,326,3,697,90,787,7670,2021-01-17 07:41:54
7756,549,3,688,89,777,7671,2021-01-17 10:34:57
7757,765,3,558,72,630,7672,2021-01-18 15:25:11
7758,62,2,1098,142,1240,7673,2021-01-18 08:38:58
7759,94,3,888,115,1003,7674,2021-01-18 11:12:14
7760,604,3,797,103,900,7675,2021-01-18 09:13:52
7761,892,3,997,129,1126,7676,2021-01-18 07:41:54
7762,464,2,329,42,371,7677,2021-01-18 07:13:08
7763,973,3,1047,136,1183,7678,2021-01-18 10:05:39
7764,100,2,598,77,675,7679,2021-01-18 06:20:01
7765,938,3,528,68,596,7680,2021-01-18 02:09:24
7766,577,3,688,89,777,7681,2021-01-18 01:23:08
7767,14,2,598,77,675,7682,2021-01-17 23:02:20
7768,229,3,897,116,1013,7683,2021-01-17 22:43:29
7769,123,4,1146,148,1294,7684,2021-01-17 19:46:24
7770,292,3,927,120,1047,7685,2021-01-17 19:49:57
7771,726,6,1255,163,1418,7686,2021-01-18 07:08:42
7772,853,3,478,62,540,7687,2021-01-18 13:59:15
7773,638,3,808,105,913,7688,2021-01-18 08:19:46
7774,690,5,1245,161,1406,7689,2021-01-18 00:40:41
7775,195,4,1426,185,1611,7690,2021-01-17 00:34:59
7776,202,3,747,97,844,7691,2021-01-17 04:42:00
7777,849,5,1545,200,1745,7692,2021-01-17 02:34:28
7778,603,1,229,29,258,7693,2021-01-17 04:38:13
7779,662,2,498,64,562,7694,2021-01-17 11:49:43
7780,22,5,1306,169,1475,7695,2021-01-17 15:54:44
7781,264,2,498,64,562,7696,2021-01-17 17:25:38
7782,537,3,578,75,653,7697,2021-01-17 19:01:45
7783,96,2,898,116,1014,7698,2021-01-18 12:07:15
7784,765,2,429,55,484,7699,2021-01-17 01:15:55
7785,499,3,1197,155,1352,7700,2021-01-17 10:51:21
7786,580,3,578,75,653,7701,2021-01-17 18:53:03
7787,919,3,428,55,483,7702,2021-01-17 16:52:32
7788,706,3,1047,136,1183,7703,2021-01-17 19:56:23
7789,875,3,727,94,821,7704,2021-01-18 00:33:22
7790,724,2,398,51,449,7705,2021-01-18 05:16:14
7791,975,3,1127,146,1273,7706,2021-01-17 08:31:40
7792,481,2,628,81,709,7707,2021-01-17 07:28:33
7793,310,2,429,55,484,7708,2021-01-17 04:00:41
7794,705,3,927,120,1047,7709,2021-01-17 08:03:59
7795,41,3,827,107,934,7710,2021-01-17 01:14:57
7796,670,1,399,51,450,7711,2021-01-17 11:15:26
7797,641,3,697,90,787,7712,2021-01-18 00:00:19
7798,360,3,997,129,1126,7713,2021-01-17 03:04:56
7799,554,5,2175,282,2457,7714,2021-01-17 16:17:50
7800,542,3,827,107,934,7715,2021-01-17 00:58:58
7801,801,5,1686,219,1905,7716,2021-01-17 10:39:48
7802,209,3,1027,133,1160,7717,2021-01-17 09:46:18
7803,239,2,329,42,371,7718,2021-01-18 04:38:06
7804,922,3,647,84,731,7719,2021-01-18 05:03:40
7805,623,3,428,55,483,7720,2021-01-18 07:03:29
7806,123,3,1027,133,1160,7721,2021-01-18 01:38:55
7807,7,3,1127,146,1273,7722,2021-01-18 05:26:57
7808,887,2,659,85,744,7723,2021-01-18 07:28:10
7809,574,3,997,129,1126,7724,2021-01-17 16:19:43
7810,809,3,478,62,540,7725,2021-01-17 11:27:50
7811,261,6,2135,277,2412,7726,2021-01-18 01:54:48
7812,999,5,1845,239,2084,7727,2021-01-16 21:21:03
7813,736,3,558,72,630,7728,2021-01-17 09:34:22
7814,450,3,1127,146,1273,7729,2021-01-17 10:18:53
7815,58,3,758,98,856,7730,2021-01-17 20:53:42
7816,28,3,997,129,1126,7731,2021-01-17 19:48:16
7817,799,3,847,110,957,7732,2021-01-18 01:39:18
7818,383,5,1095,142,1237,7733,2021-01-17 10:43:43
7819,333,3,747,97,844,7734,2021-01-17 20:20:19
7820,739,3,647,84,731,7735,2021-01-17 17:26:31
7821,178,4,1226,159,1385,7736,2021-01-17 13:21:27
7822,733,3,797,103,900,7737,2021-01-16 19:55:24
7823,282,2,698,90,788,7738,2021-01-16 19:27:25
7824,827,3,688,89,777,7739,2021-01-16 16:33:26
7825,386,6,1794,233,2027,7740,2021-01-18 11:24:24
7826,992,3,1197,155,1352,7741,2021-01-18 09:04:59
7827,157,2,659,85,744,7742,2021-01-17 22:08:51
7828,280,3,478,62,540,7743,2021-01-18 11:01:54
7829,96,3,688,89,777,7744,2021-01-18 18:09:23
7830,281,2,498,64,562,7745,2021-01-18 06:55:22
7831,467,3,578,75,653,7746,2021-01-17 23:19:53
7832,690,3,528,68,596,7747,2021-01-17 21:25:22
7833,662,3,827,107,934,7748,2021-01-18 09:53:15
7834,911,4,1056,137,1193,7749,2021-01-18 04:56:10
7835,491,3,578,75,653,7750,2021-01-18 08:49:08
7836,205,4,1087,141,1228,7751,2021-01-17 04:46:59
7837,988,2,459,59,518,7752,2021-01-17 13:30:03
7838,733,3,1127,146,1273,7753,2021-01-17 11:41:29
7839,532,3,827,107,934,7754,2021-01-17 19:11:44
7840,145,2,798,103,901,7755,2021-01-17 19:47:12
7841,700,3,478,62,540,7756,2021-01-17 13:31:37
7842,533,2,598,77,675,7757,2021-01-17 09:29:27
7843,300,6,1116,145,1261,7758,2021-01-17 11:52:29
7844,521,2,1098,142,1240,7759,2021-01-18 17:04:27
7845,13,3,647,84,731,7760,2021-01-18 09:15:53
7846,701,2,498,64,562,7761,2021-01-18 13:17:50
7847,65,3,947,123,1070,7762,2021-01-18 10:56:47
7848,70,3,927,120,1047,7763,2021-01-18 08:11:53
7849,70,3,927,120,1047,7763,2021-01-18 08:11:53
7850,751,3,997,129,1126,7764,2021-01-18 08:59:27
7851,395,2,898,116,1014,7765,2021-01-18 11:16:03
7852,259,2,698,90,788,7766,2021-01-18 07:26:22
7853,686,3,658,85,743,7767,2021-01-18 02:16:44
7854,657,3,697,90,787,7768,2021-01-18 03:26:39
7855,753,3,1047,136,1183,7769,2021-01-18 00:01:22
7856,554,3,747,97,844,7770,2021-01-17 23:49:58
7857,694,3,747,97,844,7771,2021-01-17 20:01:33
7858,948,3,1247,162,1409,7772,2021-01-17 21:33:22
7859,927,2,498,64,562,7773,2021-01-18 08:31:23
7860,1,3,1127,146,1273,7774,2021-01-18 15:44:43
7861,888,5,1645,213,1858,7775,2021-01-18 10:50:22
7862,41,3,658,85,743,7776,2021-01-18 02:05:35
7863,363,3,608,79,687,7777,2021-01-17 01:24:03
7864,648,2,898,116,1014,7778,2021-01-17 05:37:57
7865,848,3,897,116,1013,7779,2021-01-17 03:57:36
7866,466,2,898,116,1014,7780,2021-01-17 06:53:42
7867,754,4,1057,137,1194,7781,2021-01-17 13:12:40
7868,128,2,898,116,1014,7782,2021-01-17 16:26:40
7869,465,3,558,72,630,7783,2021-01-17 20:08:18
7870,114,3,827,107,934,7784,2021-01-17 21:38:06
7871,684,3,1047,136,1183,7785,2021-01-18 14:05:55
7872,161,3,697,90,787,7786,2021-01-17 02:34:05
7873,177,3,428,55,483,7787,2021-01-17 13:04:08
7874,804,5,1256,163,1419,7788,2021-01-17 19:17:27
7875,199,2,798,103,901,7789,2021-01-17 18:13:07
7876,638,3,947,123,1070,7790,2021-01-17 20:22:22
7877,499,2,459,59,518,7791,2021-01-18 01:21:19
7878,432,2,659,85,744,7792,2021-01-18 05:25:28
7879,377,2,598,77,675,7793,2021-01-17 10:22:59
7880,29,6,1705,221,1926,7794,2021-01-17 08:07:24
7881,993,5,1375,178,1553,7795,2021-01-17 06:12:30
7882,993,5,1375,178,1553,7795,2021-01-17 06:12:30
7883,477,2,1098,142,1240,7796,2021-01-17 09:41:48
7884,150,3,847,110,957,7797,2021-01-17 02:24:33
7885,367,3,1047,136,1183,7798,2021-01-17 13:19:54
7886,994,3,897,116,1013,7799,2021-01-18 02:09:57
7887,408,3,688,89,777,7800,2021-01-17 03:41:33
7888,815,3,827,107,934,7801,2021-01-17 17:29:00
7889,623,1,499,64,563,7802,2021-01-17 03:03:56
7890,709,6,2024,263,2287,7803,2021-01-17 10:55:52
7891,703,3,997,129,1126,7804,2021-01-17 12:28:15
7892,794,2,1098,142,1240,7805,2021-01-18 05:45:37
7893,570,3,558,72,630,7806,2021-01-18 06:59:51
7894,377,2,1098,142,1240,7807,2021-01-18 08:24:47
7895,20,3,827,107,934,7808,2021-01-18 03:46:28
7896,708,3,597,77,674,7809,2021-01-18 07:25:00
7897,990,2,459,59,518,7810,2021-01-18 09:26:11
7898,135,2,1098,142,1240,7811,2021-01-17 19:02:12
7899,77,3,428,55,483,7812,2021-01-17 13:51:47
7900,651,3,658,85,743,7813,2021-01-18 02:48:07
7901,380,3,1127,146,1273,7814,2021-01-16 23:01:19
7902,603,4,1126,146,1272,7815,2021-01-17 10:34:54
7903,382,5,1495,194,1689,7816,2021-01-17 12:56:25
7904,12,3,1127,146,1273,7817,2021-01-17 22:13:46
7905,198,2,498,64,562,7818,2021-01-17 22:34:21
7906,592,2,798,103,901,7819,2021-01-18 03:55:10
7907,103,3,758,98,856,7820,2021-01-17 11:24:21
7908,764,3,1197,155,1352,7821,2021-01-17 20:55:26
7909,25,3,688,89,777,7822,2021-01-17 20:09:24
7910,603,4,1596,207,1803,7823,2021-01-17 14:44:30
7911,282,3,1047,136,1183,7824,2021-01-16 20:02:26
7912,202,3,478,62,540,7825,2021-01-16 22:06:33
7913,358,6,2324,302,2626,7826,2021-01-16 18:44:00
7914,395,3,597,77,674,7827,2021-01-18 11:36:32
7915,694,2,429,55,484,7828,2021-01-18 09:46:39
7916,700,5,1525,198,1723,7829,2021-01-18 00:30:09
7917,384,2,1098,142,1240,7830,2021-01-18 11:46:35
7918,613,3,747,97,844,7831,2021-01-18 18:32:09
7919,360,2,898,116,1014,7832,2021-01-18 09:36:15
7920,265,1,399,51,450,7833,2021-01-18 01:18:21
7921,370,2,498,64,562,7834,2021-01-17 22:21:23
7922,481,3,578,75,653,7835,2021-01-18 09:58:18
7923,921,4,1346,174,1520,7836,2021-01-18 07:31:14
7924,628,6,1515,196,1711,7837,2021-01-18 09:58:35
7925,524,3,747,97,844,7838,2021-01-17 04:55:35
7926,308,3,727,94,821,7839,2021-01-17 15:40:55
7927,704,3,897,116,1013,7840,2021-01-17 12:46:12
7928,455,2,329,42,371,7841,2021-01-17 19:31:05
7929,226,3,697,90,787,7842,2021-01-17 22:25:55
7930,410,3,478,62,540,7843,2021-01-17 14:04:50
7931,775,3,758,98,856,7844,2021-01-17 10:35:21
7932,280,3,927,120,1047,7845,2021-01-17 12:57:10
7933,695,2,398,51,449,7846,2021-01-18 17:55:45
7934,957,3,608,79,687,7847,2021-01-18 10:16:44
7935,607,2,798,103,901,7848,2021-01-18 16:01:47
7936,847,3,947,123,1070,7849,2021-01-18 13:04:31
7937,476,5,1076,139,1215,7850,2021-01-18 10:03:22
7938,27,2,628,81,709,7851,2021-01-18 08:44:57
7939,818,3,927,120,1047,7852,2021-01-18 10:40:20
7940,396,2,698,90,788,7853,2021-01-18 12:12:37
7941,698,3,697,90,787,7854,2021-01-18 09:25:46
7942,970,5,1376,178,1554,7855,2021-01-18 03:12:42
7943,465,3,688,89,777,7856,2021-01-18 04:10:35
7944,489,2,1098,142,1240,7857,2021-01-18 02:23:28
7945,648,2,898,116,1014,7858,2021-01-18 02:11:34
7946,791,5,1655,215,1870,7859,2021-01-17 20:18:06
7947,958,3,808,105,913,7860,2021-01-17 23:30:04
7948,47,3,647,84,731,7861,2021-01-18 09:40:00
7949,954,2,598,77,675,7862,2021-01-18 17:06:42
7950,261,3,888,115,1003,7863,2021-01-18 11:15:24
7951,4,2,798,103,901,7864,2021-01-18 02:57:21
7952,545,2,798,103,901,7865,2021-01-17 03:07:13
7953,216,4,1346,174,1520,7866,2021-01-17 07:44:31
7954,285,3,1127,146,1273,7867,2021-01-17 04:40:28
7955,200,2,329,42,371,7868,2021-01-17 08:09:29
7956,248,3,1127,146,1273,7869,2021-01-17 14:30:40
7957,413,3,1047,136,1183,7870,2021-01-17 18:55:22
7958,474,2,798,103,901,7871,2021-01-17 20:16:40
7959,188,2,659,85,744,7872,2021-01-18 00:11:14
7960,188,2,659,85,744,7872,2021-01-18 00:11:14
7961,478,3,1047,136,1183,7873,2021-01-18 14:55:48
7962,943,2,698,90,788,7874,2021-01-17 02:39:10
7963,1,2,598,77,675,7875,2021-01-17 14:05:45
7964,480,3,897,116,1013,7876,2021-01-17 20:05:14
7965,174,2,898,116,1014,7877,2021-01-17 20:13:00
7966,758,4,2026,263,2289,7878,2021-01-17 20:48:09
7967,534,2,498,64,562,7879,2021-01-18 01:58:41
7968,366,1,229,29,258,7880,2021-01-18 07:24:57
7969,507,2,498,64,562,7881,2021-01-17 12:16:07
7970,348,3,658,85,743,7882,2021-01-17 09:51:34
7971,248,3,797,103,900,7883,2021-01-17 06:26:43
7972,947,3,597,77,674,7884,2021-01-17 07:33:25
7973,42,4,1287,167,1454,7885,2021-01-17 12:18:07
7974,643,5,1326,172,1498,7886,2021-01-17 04:57:47
7975,794,3,1047,136,1183,7887,2021-01-17 15:57:43
7976,449,2,329,42,371,7888,2021-01-18 02:36:47
7977,557,2,1098,142,1240,7889,2021-01-17 06:06:57
7978,919,2,429,55,484,7890,2021-01-17 18:36:45
7979,379,6,1605,208,1813,7891,2021-01-17 04:45:37
7980,204,1,699,90,789,7892,2021-01-17 13:12:51
7981,238,3,747,97,844,7893,2021-01-17 14:02:45
7982,996,2,798,103,901,7894,2021-01-18 05:49:36
7983,554,2,598,77,675,7895,2021-01-18 07:54:11
7984,14,2,498,64,562,7896,2021-01-18 09:09:20
7985,174,4,1296,168,1464,7897,2021-01-18 05:49:10
7986,87,2,598,77,675,7898,2021-01-18 07:49:33
7987,726,3,997,129,1126,7899,2021-01-18 10:37:36
7988,707,2,898,116,1014,7900,2021-01-17 19:33:50
7989,365,3,558,72,630,7901,2021-01-17 14:32:58
7990,17,3,927,120,1047,7902,2021-01-18 04:33:29
7991,108,6,2074,269,2343,7903,2021-01-17 01:30:07
7992,258,3,888,115,1003,7904,2021-01-17 13:13:02
7993,491,3,1127,146,1273,7905,2021-01-17 14:54:42
7994,468,3,558,72,630,7906,2021-01-17 23:37:43
7995,663,3,558,72,630,7907,2021-01-17 23:53:20
7996,257,2,798,103,901,7908,2021-01-18 06:24:09
7997,896,3,947,123,1070,7909,2021-01-17 13:08:09
7998,839,2,329,42,371,7910,2021-01-17 23:27:12
7999,842,5,907,117,1024,7911,2021-01-17 20:37:21
8000,129,3,897,116,1013,7912,2021-01-17 16:25:03
8001,684,2,429,55,484,7913,2021-01-16 20:38:31
8002,461,3,528,68,596,7914,2021-01-16 23:33:30
8003,351,2,628,81,709,7915,2021-01-16 19:52:02
8004,328,1,99,12,111,7916,2021-01-18 12:07:21
8005,645,2,698,90,788,7917,2021-01-18 10:57:05
8006,270,2,398,51,449,7918,2021-01-18 02:07:02
8007,579,2,528,68,596,7919,2021-01-18 11:57:46
8008,351,3,797,103,900,7920,2021-01-18 18:57:04
8009,876,4,1626,211,1837,7921,2021-01-18 09:54:45
8010,700,3,947,123,1070,7922,2021-01-18 03:22:32
8011,860,4,1446,187,1633,7923,2021-01-18 00:44:55
8012,18,3,797,103,900,7924,2021-01-18 10:41:05
8013,458,3,608,79,687,7925,2021-01-18 08:53:49
8014,992,3,888,115,1003,7926,2021-01-18 12:16:30
8015,970,3,888,115,1003,7927,2021-01-17 07:34:14
8016,999,3,597,77,674,7928,2021-01-17 16:52:47
8017,374,3,827,107,934,7929,2021-01-17 13:32:55
8018,129,3,847,110,957,7930,2021-01-17 20:28:55
8019,28,2,1098,142,1240,7931,2021-01-17 22:46:57
8020,996,3,758,98,856,7932,2021-01-17 16:50:49
8021,155,3,1197,155,1352,7933,2021-01-17 13:11:01
8022,934,3,747,97,844,7934,2021-01-17 15:05:34
8023,57,2,798,103,901,7935,2021-01-18 18:35:00
8024,585,3,997,129,1126,7936,2021-01-18 12:43:02
8025,865,4,696,90,786,7937,2021-01-18 16:10:57
8026,581,2,398,51,449,7938,2021-01-18 14:48:12
8027,116,1,149,19,168,7939,2021-01-18 11:27:00
8028,181,3,947,123,1070,7940,2021-01-18 09:32:27
8029,440,2,659,85,744,7941,2021-01-18 11:58:02
8030,198,6,1605,208,1813,7942,2021-01-18 12:55:39
8031,549,3,897,116,1013,7943,2021-01-18 10:00:45
8032,154,5,1855,241,2096,7944,2021-01-18 03:24:27
8033,68,3,1247,162,1409,7945,2021-01-18 06:12:23
8034,789,3,697,90,787,7946,2021-01-18 03:22:18
8035,928,3,697,90,787,7947,2021-01-18 04:10:31
8036,864,3,797,103,900,7948,2021-01-17 22:59:03
8037,177,3,688,89,777,7949,2021-01-18 00:52:54
8038,194,2,329,42,371,7950,2021-01-18 09:48:33
8039,579,2,429,55,484,7951,2021-01-18 17:28:11
8040,510,2,429,55,484,7952,2021-01-18 12:24:26
8041,652,2,798,103,901,7953,2021-01-18 05:18:00
8042,332,2,659,85,744,7954,2021-01-17 05:21:21
8043,961,3,827,107,934,7955,2021-01-17 09:55:30
8044,99,2,748,97,845,7956,2021-01-17 06:55:03
8045,957,2,898,116,1014,7957,2021-01-17 08:58:06
8046,538,2,898,116,1014,7958,2021-01-17 14:51:24
8047,767,2,798,103,901,7959,2021-01-17 19:27:40
8048,805,3,758,98,856,7960,2021-01-17 22:27:35
8049,437,2,659,85,744,7961,2021-01-18 00:47:04
8050,455,2,828,107,935,7962,2021-01-18 00:37:28
8051,545,3,697,90,787,7963,2021-01-18 15:34:42
8052,824,2,798,103,901,7964,2021-01-17 04:59:11
8053,980,1,149,19,168,7965,2021-01-17 16:31:34
8054,264,3,1247,162,1409,7966,2021-01-17 22:20:17
8055,141,3,847,110,957,7967,2021-01-17 21:49:18
8056,268,3,1127,146,1273,7968,2021-01-17 21:06:52
8057,123,3,658,85,743,7969,2021-01-18 04:18:36
8058,164,3,558,72,630,7970,2021-01-18 09:41:27
8059,261,2,598,77,675,7971,2021-01-17 12:55:25
8060,828,2,898,116,1014,7972,2021-01-17 12:07:43
8061,237,3,697,90,787,7973,2021-01-17 07:48:53
8062,960,3,997,129,1126,7974,2021-01-17 08:24:08
8063,811,3,797,103,900,7975,2021-01-17 14:19:44
8064,802,2,498,64,562,7976,2021-01-17 05:17:18
8065,78,6,1286,167,1453,7977,2021-01-17 17:37:28
8066,205,3,1127,146,1273,7978,2021-01-18 04:06:06
8067,378,2,498,64,562,7979,2021-01-17 06:14:01
8068,804,5,1995,259,2254,7980,2021-01-17 19:13:53
8069,795,3,927,120,1047,7981,2021-01-17 07:32:05
8070,609,2,398,51,449,7982,2021-01-17 14:17:05
8071,325,5,1486,193,1679,7983,2021-01-17 15:54:13
8072,325,3,608,79,687,7984,2021-01-18 08:12:55
8073,332,2,498,64,562,7985,2021-01-18 08:22:02
8074,760,3,608,79,687,7986,2021-01-18 09:52:46
8075,137,5,1545,200,1745,7987,2021-01-18 07:22:06
8076,75,2,329,42,371,7988,2021-01-18 09:21:26
8077,443,3,747,97,844,7989,2021-01-18 11:53:18
8078,248,3,597,77,674,7990,2021-01-17 21:58:26
8079,989,6,1694,220,1914,7991,2021-01-17 14:40:22
8080,939,2,548,71,619,7992,2021-01-18 06:43:53
8081,645,2,498,64,562,7993,2021-01-17 02:11:33
8082,668,3,578,75,653,7994,2021-01-17 14:44:55
8083,955,2,429,55,484,7995,2021-01-17 17:40:45
8084,198,4,1696,220,1916,7996,2021-01-18 00:39:54
8085,687,3,558,72,630,7997,2021-01-18 02:28:26
8086,426,3,808,105,913,7998,2021-01-18 09:07:08
8087,759,3,558,72,630,7999,2021-01-17 14:24:09
8088,173,3,697,90,787,8000,2021-01-18 00:37:10
8089,506,3,747,97,844,8001,2021-01-17 20:40:30
8090,448,3,997,129,1126,8002,2021-01-17 17:47:01
8091,523,3,478,62,540,8003,2021-01-16 22:53:41
8092,236,6,1546,200,1746,8004,2021-01-17 00:46:45
8093,69,2,448,58,506,8005,2021-01-16 21:05:07
8094,599,3,1027,133,1160,8006,2021-01-18 13:23:36
8095,212,2,429,55,484,8007,2021-01-18 11:16:11
8096,805,3,947,123,1070,8008,2021-01-18 04:39:32
8097,655,6,1405,182,1587,8009,2021-01-18 14:09:27
8098,116,2,329,42,371,8010,2021-01-18 20:33:42
8099,336,3,688,89,777,8011,2021-01-18 09:58:49
8100,456,3,997,129,1126,8012,2021-01-18 04:07:07
8101,336,5,887,115,1002,8013,2021-01-18 01:38:14
8102,661,3,747,97,844,8014,2021-01-18 12:41:53
8103,235,2,648,84,732,8015,2021-01-18 10:15:02
8104,563,3,608,79,687,8016,2021-01-18 15:01:32
8105,656,1,229,29,258,8017,2021-01-17 08:12:51
8106,371,3,597,77,674,8018,2021-01-17 17:33:41
8107,53,2,598,77,675,8019,2021-01-17 14:30:44
8108,245,5,1395,181,1576,8020,2021-01-17 21:25:12
8109,378,3,808,105,913,8021,2021-01-18 00:12:52
8110,341,2,898,116,1014,8022,2021-01-17 18:29:29
8111,630,2,598,77,675,8023,2021-01-17 13:22:56
8112,786,5,1455,189,1644,8024,2021-01-17 17:01:15
8113,123,2,628,81,709,8025,2021-01-18 19:43:30
8114,92,3,808,105,913,8026,2021-01-18 13:41:55
8115,819,3,558,72,630,8027,2021-01-18 17:42:06
8116,63,1,299,38,337,8028,2021-01-18 16:20:25
8117,451,3,758,98,856,8029,2021-01-18 11:46:06
8118,146,3,1047,136,1183,8030,2021-01-18 10:57:00
8119,983,3,647,84,731,8031,2021-01-18 12:55:53
8120,252,3,558,72,630,8032,2021-01-18 13:13:55
8121,777,2,898,116,1014,8033,2021-01-18 12:04:02
8122,861,3,827,107,934,8034,2021-01-18 05:13:46
8123,18,2,598,77,675,8035,2021-01-18 06:16:53
8124,520,3,1127,146,1273,8036,2021-01-18 03:34:29
8125,224,3,1047,136,1183,8037,2021-01-18 06:25:02
8126,919,1,399,51,450,8038,2021-01-17 23:07:59
8127,320,5,1286,167,1453,8039,2021-01-18 00:53:50
8128,145,3,608,79,687,8040,2021-01-18 10:02:01
8129,781,3,777,101,878,8041,2021-01-18 19:50:24
8130,192,2,698,90,788,8042,2021-01-18 14:22:06
8131,334,3,1047,136,1183,8043,2021-01-18 07:39:36
8132,171,2,429,55,484,8044,2021-01-17 07:49:43
8133,356,3,1127,146,1273,8045,2021-01-17 10:19:36
8134,724,4,1646,213,1859,8046,2021-01-17 07:13:04
8135,973,2,498,64,562,8047,2021-01-17 10:39:34
8136,485,5,1206,156,1362,8048,2021-01-17 15:41:02
8137,267,1,99,12,111,8049,2021-01-17 20:54:26
8138,491,2,898,116,1014,8050,2021-01-17 22:41:50
8139,384,3,1327,172,1499,8051,2021-01-18 00:53:34
8140,80,2,598,77,675,8052,2021-01-18 01:53:57
8141,194,2,698,90,788,8053,2021-01-18 18:13:33
8142,808,2,798,103,901,8054,2021-01-17 05:21:21
8143,466,3,747,97,844,8055,2021-01-17 18:59:10
8144,966,2,698,90,788,8056,2021-01-17 22:59:16
8145,447,5,1906,247,2153,8057,2021-01-17 22:37:40
8146,130,3,1127,146,1273,8058,2021-01-17 22:10:12
8147,632,3,428,55,483,8059,2021-01-18 04:23:49
8148,731,6,1006,130,1136,8060,2021-01-18 09:45:53
8149,852,3,597,77,674,8061,2021-01-17 13:56:42
8150,844,3,558,72,630,8062,2021-01-17 14:21:27
8151,103,2,329,42,371,8063,2021-01-17 07:58:03
8152,381,3,997,129,1126,8064,2021-01-17 08:33:40
8153,770,2,798,103,901,8065,2021-01-17 16:50:31
8154,51,3,428,55,483,8066,2021-01-17 07:19:25
8155,149,2,659,85,744,8067,2021-01-17 18:45:52
8156,13,3,797,103,900,8068,2021-01-18 04:13:03
8157,7,2,329,42,371,8069,2021-01-17 06:19:20
8158,125,3,997,129,1126,8070,2021-01-17 21:48:58
8159,453,3,727,94,821,8071,2021-01-17 09:09:06
8160,992,3,1127,146,1273,8072,2021-01-17 14:32:01
8161,332,3,1127,146,1273,8073,2021-01-17 16:09:35
8162,40,2,429,55,484,8074,2021-01-18 09:19:46
8163,393,3,827,107,934,8075,2021-01-18 10:19:56
8164,592,5,1456,189,1645,8076,2021-01-18 10:46:36
8165,639,2,459,59,518,8077,2021-01-18 10:01:54
8166,871,2,748,97,845,8078,2021-01-18 11:28:58
8167,181,2,698,90,788,8079,2021-01-18 13:48:50
8168,181,2,698,90,788,8079,2021-01-18 13:48:50
8169,235,2,828,107,935,8080,2021-01-17 22:49:06
8170,235,2,828,107,935,8080,2021-01-17 22:49:06
8171,472,2,898,116,1014,8081,2021-01-17 15:51:42
8172,299,3,528,68,596,8082,2021-01-18 08:57:55
8173,135,3,558,72,630,8083,2021-01-17 03:42:04
8174,785,3,1197,155,1352,8084,2021-01-17 14:54:04
8175,139,6,1405,182,1587,8085,2021-01-17 19:18:59
8176,383,2,598,77,675,8086,2021-01-18 01:27:07
8177,642,3,847,110,957,8087,2021-01-18 03:58:07
8178,372,3,1127,146,1273,8088,2021-01-18 10:24:03
8179,30,3,727,94,821,8089,2021-01-17 17:10:03
8180,160,2,698,90,788,8090,2021-01-18 01:10:53
8181,748,2,1098,142,1240,8091,2021-01-17 21:57:49
8182,147,2,448,58,506,8092,2021-01-17 18:07:38
8183,370,3,1027,133,1160,8093,2021-01-17 01:34:14
8184,497,6,1475,191,1666,8094,2021-01-17 00:48:37
8185,899,1,699,90,789,8095,2021-01-16 23:01:28
8186,764,3,747,97,844,8096,2021-01-18 15:00:48
8187,971,3,797,103,900,8097,2021-01-18 11:58:00
8188,114,3,758,98,856,8098,2021-01-18 05:08:28
8189,0,3,688,89,777,8099,2021-01-18 14:36:42
8190,502,3,597,77,674,8100,2021-01-18 21:14:00
8191,645,2,898,116,1014,8101,2021-01-18 11:43:26
8192,923,5,1445,187,1632,8102,2021-01-18 04:36:46
8193,577,3,747,97,844,8103,2021-01-18 01:43:41
8194,491,3,797,103,900,8104,2021-01-18 12:52:56
8195,140,3,1047,136,1183,8105,2021-01-18 10:54:28
8196,729,6,1316,171,1487,8106,2021-01-18 16:26:13
8197,122,3,1327,172,1499,8107,2021-01-17 09:07:28
8198,793,3,647,84,731,8108,2021-01-17 19:35:42
8199,78,3,688,89,777,8109,2021-01-17 15:16:07
8200,861,2,828,107,935,8110,2021-01-17 22:34:42
8201,794,3,608,79,687,8111,2021-01-18 00:18:42
8202,79,3,597,77,674,8112,2021-01-17 19:51:52
8203,107,3,897,116,1013,8113,2021-01-17 14:10:46
8204,955,3,727,94,821,8114,2021-01-17 18:44:25
8205,858,3,478,62,540,8115,2021-01-18 22:16:08
8206,458,3,697,90,787,8116,2021-01-18 15:30:03
8207,232,3,697,90,787,8117,2021-01-18 18:39:55
8208,379,2,598,77,675,8118,2021-01-18 17:31:34
8209,63,3,578,75,653,8119,2021-01-18 14:18:08
8210,177,4,927,120,1047,8120,2021-01-18 12:47:27
8211,189,3,758,98,856,8121,2021-01-18 15:17:16
8212,518,3,697,90,787,8122,2021-01-18 13:37:56
8213,71,4,1026,133,1159,8123,2021-01-18 13:30:44
8214,270,3,697,90,787,8124,2021-01-18 07:17:55
8215,31,2,459,59,518,8125,2021-01-18 07:42:00
8216,599,3,758,98,856,8126,2021-01-18 05:44:16
8217,250,4,1187,154,1341,8127,2021-01-18 07:39:18
8218,418,5,1175,152,1327,8128,2021-01-18 00:54:15
8219,311,2,798,103,901,8129,2021-01-18 01:18:06
8220,629,3,1047,136,1183,8130,2021-01-18 10:45:57
8221,453,3,428,55,483,8131,2021-01-18 20:35:12
8222,715,2,628,81,709,8132,2021-01-18 16:26:01
8223,3,3,897,116,1013,8133,2021-01-18 08:48:01
8224,291,5,1456,189,1645,8134,2021-01-17 10:27:30
8225,342,5,1176,152,1328,8135,2021-01-17 12:40:32
8226,207,4,857,111,968,8136,2021-01-17 08:43:25
8227,145,3,947,123,1070,8137,2021-01-17 11:13:31
8228,251,3,747,97,844,8138,2021-01-17 16:34:48
8229,906,2,898,116,1014,8139,2021-01-17 22:10:22
8230,388,2,1098,142,1240,8140,2021-01-18 01:10:25
8231,352,3,558,72,630,8141,2021-01-18 02:55:39
8232,372,3,1197,155,1352,8142,2021-01-18 02:49:09
8233,158,5,1456,189,1645,8143,2021-01-18 18:20:58
8234,808,3,1127,146,1273,8144,2021-01-17 05:25:11
8235,582,3,688,89,777,8145,2021-01-17 20:39:35
8236,43,3,827,107,934,8146,2021-01-18 00:01:28
8237,266,2,329,42,371,8147,2021-01-17 22:43:38
8238,960,3,558,72,630,8148,2021-01-18 00:36:41
8239,435,1,229,29,258,8149,2021-01-18 05:47:55
8240,129,3,608,79,687,8150,2021-01-18 10:25:31
8241,639,4,1296,168,1464,8151,2021-01-17 15:49:45
8242,837,3,747,97,844,8152,2021-01-17 15:38:41
8243,670,3,658,85,743,8153,2021-01-17 10:39:35
8244,838,3,927,120,1047,8154,2021-01-17 09:18:13
8245,901,3,827,107,934,8155,2021-01-17 19:09:03
8246,383,3,1027,133,1160,8156,2021-01-17 08:55:42
8247,786,2,698,90,788,8157,2021-01-17 21:05:10
8248,245,3,797,103,900,8158,2021-01-18 06:47:45
8249,374,2,598,77,675,8159,2021-01-17 07:58:50
8250,885,3,608,79,687,8160,2021-01-17 23:04:37
8251,261,3,927,120,1047,8161,2021-01-17 11:15:06
8252,572,2,498,64,562,8162,2021-01-17 16:17:58
8253,610,3,647,84,731,8163,2021-01-17 16:34:56
8254,964,2,498,64,562,8164,2021-01-18 10:27:38
8255,342,3,1047,136,1183,8165,2021-01-18 11:33:16
8256,872,2,329,42,371,8166,2021-01-18 13:21:36
8257,672,2,798,103,901,8167,2021-01-18 11:26:00
8258,440,3,888,115,1003,8168,2021-01-18 13:02:44
8259,125,2,598,77,675,8169,2021-01-18 15:30:04
8260,9,3,1197,155,1352,8170,2021-01-18 14:13:02
8261,772,3,747,97,844,8171,2021-01-18 01:04:15
8262,978,3,747,97,844,8172,2021-01-17 22:59:34
8263,816,3,1247,162,1409,8173,2021-01-17 16:51:21
8264,476,2,659,85,744,8174,2021-01-18 11:02:06
8265,537,3,428,55,483,8175,2021-01-17 05:57:29
8266,729,4,1127,146,1273,8176,2021-01-17 16:29:52
8267,667,3,897,116,1013,8177,2021-01-17 21:14:05
8268,280,5,1117,145,1262,8178,2021-01-18 03:37:45
8269,670,3,747,97,844,8179,2021-01-18 05:34:59
8270,17,3,578,75,653,8180,2021-01-18 11:26:50
8271,17,3,578,75,653,8180,2021-01-18 11:26:50
8272,12,6,1505,195,1700,8181,2021-01-17 18:47:27
8273,943,3,1247,162,1409,8182,2021-01-18 01:54:45
8274,59,3,888,115,1003,8183,2021-01-18 00:24:50
8275,904,3,847,110,957,8184,2021-01-17 19:14:17
8276,313,3,747,97,844,8185,2021-01-17 03:13:41
8277,456,2,429,55,484,8186,2021-01-17 03:13:19
8278,33,3,808,105,913,8187,2021-01-17 00:37:26
8279,458,2,429,55,484,8188,2021-01-18 15:20:24
8280,344,3,758,98,856,8189,2021-01-18 12:52:47
8281,716,2,798,103,901,8190,2021-01-18 06:26:43
8282,894,3,697,90,787,8191,2021-01-18 16:20:54
8283,199,3,847,110,957,8192,2021-01-18 21:46:34
8284,139,3,1027,133,1160,8193,2021-01-18 12:47:32
8285,256,3,1027,133,1160,8194,2021-01-18 06:20:49
8286,940,6,1774,230,2004,8195,2021-01-18 01:48:42
8287,772,3,747,97,844,8196,2021-01-18 14:47:48
8288,724,3,797,103,900,8197,2021-01-18 12:24:10
8289,296,3,478,62,540,8198,2021-01-18 19:08:48
8290,541,1,149,19,168,8199,2021-01-17 09:17:23
8291,743,3,697,90,787,8200,2021-01-17 21:46:15
8292,567,2,329,42,371,8201,2021-01-17 15:54:46
8293,348,3,608,79,687,8202,2021-01-17 23:28:19
8294,666,3,888,115,1003,8203,2021-01-18 02:14:19
8295,296,3,827,107,934,8204,2021-01-17 21:16:30
8296,649,2,828,107,935,8205,2021-01-17 15:09:21
8297,330,3,758,98,856,8206,2021-01-17 21:15:26
8298,121,5,1745,226,1971,8207,2021-01-18 22:58:30
8299,154,3,688,89,777,8208,2021-01-18 16:09:58
8300,759,3,727,94,821,8209,2021-01-18 21:09:44
8301,361,3,758,98,856,8210,2021-01-18 19:03:07
8302,917,3,1327,172,1499,8211,2021-01-18 14:19:48
8303,954,2,329,42,371,8212,2021-01-18 14:01:05
8304,100,3,578,75,653,8213,2021-01-18 15:56:33
8305,958,3,688,89,777,8214,2021-01-18 14:57:42
8306,229,3,1027,133,1160,8215,2021-01-18 13:57:26
8307,635,6,1655,215,1870,8216,2021-01-18 07:26:27
8308,677,3,997,129,1126,8217,2021-01-18 08:06:31
8309,386,2,698,90,788,8218,2021-01-18 07:09:52
8310,135,2,459,59,518,8219,2021-01-18 10:20:10
8311,275,2,498,64,562,8220,2021-01-18 03:08:50
8312,965,2,898,116,1014,8221,2021-01-18 02:05:44
8313,147,3,1197,155,1352,8222,2021-01-18 11:24:17
8314,302,3,428,55,483,8223,2021-01-18 23:16:59
8315,913,2,498,64,562,8224,2021-01-18 16:37:34
8316,13,3,688,89,777,8225,2021-01-18 11:03:45
8317,805,4,1496,194,1690,8226,2021-01-17 12:13:47
8318,484,4,1146,148,1294,8227,2021-01-17 12:47:46
8319,94,2,498,64,562,8228,2021-01-17 11:01:11
8320,0,5,1645,213,1858,8229,2021-01-17 12:22:10
8321,72,3,1047,136,1183,8230,2021-01-17 18:24:19
8322,516,3,1327,172,1499,8231,2021-01-17 23:52:48
8323,826,3,997,129,1126,8232,2021-01-18 03:35:40
8324,217,3,1327,172,1499,8233,2021-01-18 05:04:25
8325,619,3,947,123,1070,8234,2021-01-18 03:38:53
8326,306,3,608,79,687,8235,2021-01-18 20:48:00
8327,794,3,597,77,674,8236,2021-01-17 06:03:09
8328,291,4,1057,137,1194,8237,2021-01-17 22:36:14
8329,942,2,928,120,1048,8238,2021-01-18 02:34:44
8330,197,3,1327,172,1499,8239,2021-01-17 23:25:09
8331,234,3,1127,146,1273,8240,2021-01-18 01:22:57
8332,97,2,1098,142,1240,8241,2021-01-18 07:02:25
8333,393,2,698,90,788,8242,2021-01-18 11:55:49
8334,545,3,797,103,900,8243,2021-01-17 18:31:04
8335,305,1,229,29,258,8244,2021-01-17 17:29:26
8336,442,5,1026,133,1159,8245,2021-01-17 11:35:44
8337,291,1,99,12,111,8246,2021-01-17 09:44:43
8338,390,5,1675,217,1892,8247,2021-01-17 19:53:13
8339,487,3,1127,146,1273,8248,2021-01-17 09:08:43
8340,723,5,1456,189,1645,8249,2021-01-17 22:10:25
8341,196,5,1395,181,1576,8250,2021-01-18 07:06:01
8342,770,3,997,129,1126,8251,2021-01-17 10:39:40
8343,624,3,688,89,777,8252,2021-01-18 01:13:25
8344,279,2,798,103,901,8253,2021-01-17 11:51:05
8345,158,3,808,105,913,8254,2021-01-17 17:03:10
8346,597,2,448,58,506,8255,2021-01-17 19:12:23
8347,882,2,459,59,518,8256,2021-01-18 12:49:19
8348,379,3,1127,146,1273,8257,2021-01-18 11:39:48
8349,224,3,847,110,957,8258,2021-01-18 15:55:51
8350,597,2,459,59,518,8259,2021-01-18 13:56:08
8351,452,3,558,72,630,8260,2021-01-18 13:05:45
8352,344,3,927,120,1047,8261,2021-01-18 15:35:29
8353,494,5,1126,146,1272,8262,2021-01-18 16:26:05
8354,717,2,459,59,518,8263,2021-01-18 01:38:57
8355,161,2,798,103,901,8264,2021-01-18 00:04:26
8356,147,2,459,59,518,8265,2021-01-17 19:34:58
8357,600,5,1017,132,1149,8266,2021-01-18 11:46:36
8358,872,2,898,116,1014,8267,2021-01-17 06:56:46
8359,571,2,698,90,788,8268,2021-01-17 18:47:54
8360,799,2,498,64,562,8269,2021-01-17 22:18:32
8361,686,2,548,71,619,8270,2021-01-18 04:02:57
8362,98,3,927,120,1047,8271,2021-01-18 06:40:20
8363,922,3,827,107,934,8272,2021-01-18 12:13:03
8364,306,2,329,42,371,8273,2021-01-18 11:40:17
8365,350,3,578,75,653,8274,2021-01-17 19:59:27
8366,611,3,1197,155,1352,8275,2021-01-18 03:33:52
8367,926,3,997,129,1126,8276,2021-01-18 00:34:58
8368,556,6,1775,230,2005,8277,2021-01-17 21:33:55
8369,674,3,888,115,1003,8278,2021-01-17 04:29:39
8370,185,3,997,129,1126,8279,2021-01-17 03:58:38
8371,388,3,1047,136,1183,8280,2021-01-17 01:09:53
8372,609,1,599,77,676,8281,2021-01-18 17:06:50
8373,431,2,459,59,518,8282,2021-01-18 14:04:31
8374,269,3,1027,133,1160,8283,2021-01-18 08:24:43
8375,721,2,429,55,484,8284,2021-01-18 16:59:33
8376,295,2,898,116,1014,8285,2021-01-18 22:06:23
8377,807,5,1425,185,1610,8286,2021-01-18 14:07:17
8378,338,3,528,68,596,8287,2021-01-18 07:40:06
8379,520,3,747,97,844,8288,2021-01-18 02:50:37
8380,62,2,798,103,901,8289,2021-01-18 17:24:32
8381,822,2,329,42,371,8290,2021-01-18 15:01:41
8382,429,4,1587,206,1793,8291,2021-01-18 20:02:20
8383,986,5,1026,133,1159,8292,2021-01-17 09:37:50
8384,75,3,697,90,787,8293,2021-01-17 22:04:22
8385,649,5,1606,208,1814,8294,2021-01-17 18:29:24
8386,732,3,558,72,630,8295,2021-01-17 23:37:47
8387,824,3,528,68,596,8296,2021-01-18 02:41:16
8388,162,6,1575,204,1779,8297,2021-01-17 22:38:19
8389,224,1,399,51,450,8298,2021-01-17 16:15:56
8390,653,3,758,98,856,8299,2021-01-17 21:16:29
8391,817,3,1327,172,1499,8300,2021-01-19 00:16:47
8392,939,2,498,64,562,8301,2021-01-18 18:51:14
8393,813,2,698,90,788,8302,2021-01-18 21:25:09
8394,224,2,659,85,744,8303,2021-01-18 21:01:15
8395,281,3,558,72,630,8304,2021-01-18 16:49:45
8396,669,3,1197,155,1352,8305,2021-01-18 16:34:43
8397,652,3,808,105,913,8306,2021-01-18 16:13:38
8398,687,1,229,29,258,8307,2021-01-18 16:46:37
8399,242,3,747,97,844,8308,2021-01-18 15:46:32
8400,52,5,757,98,855,8309,2021-01-18 07:30:43
8401,729,2,728,94,822,8310,2021-01-18 10:42:05
8402,697,3,997,129,1126,8311,2021-01-18 08:50:39
8403,886,3,1247,162,1409,8312,2021-01-18 10:36:11
8404,280,2,598,77,675,8313,2021-01-18 04:12:25
8405,430,4,1026,133,1159,8314,2021-01-18 04:24:53
8406,621,3,528,68,596,8315,2021-01-18 13:24:52
8407,251,4,1726,224,1950,8316,2021-01-19 00:32:38
8408,290,3,997,129,1126,8317,2021-01-18 18:28:05
8409,646,2,898,116,1014,8318,2021-01-18 12:57:10
8410,262,1,699,90,789,8319,2021-01-17 13:53:42
8411,5,3,997,129,1126,8320,2021-01-17 13:37:41
8412,86,2,429,55,484,8321,2021-01-17 11:53:46
8413,414,3,808,105,913,8322,2021-01-17 12:30:57
8414,39,3,1027,133,1160,8323,2021-01-17 20:18:51
8415,228,4,996,129,1125,8324,2021-01-18 01:41:25
8416,253,5,1495,194,1689,8325,2021-01-18 04:55:36
8417,123,3,827,107,934,8326,2021-01-18 06:47:32
8418,924,3,428,55,483,8327,2021-01-18 05:50:29
8419,476,4,1126,146,1272,8328,2021-01-18 21:58:55
8420,985,2,748,97,845,8329,2021-01-17 07:51:28
8421,597,3,897,116,1013,8330,2021-01-18 00:29:32
8422,988,3,797,103,900,8331,2021-01-18 05:19:46
8423,965,6,1705,221,1926,8332,2021-01-18 01:53:02
8424,566,2,498,64,562,8333,2021-01-18 03:47:23
8425,516,2,498,64,562,8334,2021-01-18 09:05:00
8426,356,3,808,105,913,8335,2021-01-18 12:21:48
8427,228,4,1346,174,1520,8336,2021-01-17 20:46:28
8428,477,3,797,103,900,8337,2021-01-17 19:25:28
8429,348,1,399,51,450,8338,2021-01-17 13:26:53
8430,967,3,428,55,483,8339,2021-01-17 09:55:59
8431,344,3,847,110,957,8340,2021-01-17 21:39:39
8432,915,1,99,12,111,8341,2021-01-17 11:53:40
8433,863,2,498,64,562,8342,2021-01-17 23:43:22
8434,407,2,498,64,562,8343,2021-01-18 09:06:40
8435,19,3,1027,133,1160,8344,2021-01-17 11:14:48
8436,55,3,758,98,856,8345,2021-01-18 01:34:15
8437,822,2,329,42,371,8346,2021-01-17 12:56:49
8438,137,3,1127,146,1273,8347,2021-01-17 18:51:55
8439,202,1,699,90,789,8348,2021-01-17 19:40:36
8440,451,4,876,113,989,8349,2021-01-18 13:12:11
8441,88,2,429,55,484,8350,2021-01-18 12:02:13
8442,66,3,888,115,1003,8351,2021-01-18 17:01:54
8443,842,3,897,116,1013,8352,2021-01-18 14:57:10
8444,227,2,459,59,518,8353,2021-01-18 14:49:41
8445,246,2,598,77,675,8354,2021-01-18 16:16:48
8446,509,3,897,116,1013,8355,2021-01-18 17:48:46
8447,208,3,1247,162,1409,8356,2021-01-18 03:19:15
8448,567,3,658,85,743,8357,2021-01-18 00:26:04
8449,617,3,478,62,540,8358,2021-01-17 19:58:56
8450,386,5,1126,146,1272,8359,2021-01-18 14:17:35
8451,493,2,598,77,675,8360,2021-01-17 08:03:08
8452,468,2,598,77,675,8361,2021-01-17 19:27:54
8453,708,3,1197,155,1352,8362,2021-01-18 00:25:51
8454,248,2,598,77,675,8363,2021-01-18 06:28:36
8455,593,2,429,55,484,8364,2021-01-18 07:09:45
8456,119,3,608,79,687,8365,2021-01-18 14:39:41
8457,793,3,897,116,1013,8366,2021-01-18 14:11:44
8458,10,3,1127,146,1273,8367,2021-01-17 21:33:40
8459,448,3,888,115,1003,8368,2021-01-18 05:25:21
8460,833,3,1027,133,1160,8369,2021-01-18 02:02:57
8461,833,3,1027,133,1160,8369,2021-01-18 02:02:57
8462,926,3,608,79,687,8370,2021-01-17 23:51:02
8463,293,3,758,98,856,8371,2021-01-17 06:10:02
8464,53,3,608,79,687,8372,2021-01-17 05:06:15
8465,225,3,797,103,900,8373,2021-01-17 01:27:40
8466,319,3,747,97,844,8374,2021-01-18 17:08:45
8467,529,2,498,64,562,8375,2021-01-18 15:32:04
8468,885,3,558,72,630,8376,2021-01-18 08:53:12
8469,652,2,1098,142,1240,8377,2021-01-18 18:11:55
8470,422,2,598,77,675,8378,2021-01-18 22:48:35
8471,171,3,697,90,787,8379,2021-01-18 15:43:02
8472,897,2,329,42,371,8380,2021-01-18 09:06:03
8473,929,3,608,79,687,8381,2021-01-18 04:22:42
8474,136,3,747,97,844,8382,2021-01-18 19:06:54
8475,834,4,877,114,991,8383,2021-01-18 16:23:21
8476,439,1,299,38,337,8384,2021-01-18 22:15:38
8477,552,2,429,55,484,8385,2021-01-17 11:03:24
8478,145,3,927,120,1047,8386,2021-01-17 23:22:29
8479,74,2,329,42,371,8387,2021-01-17 21:15:56
8480,297,1,599,77,676,8388,2021-01-17 23:48:40
8481,297,1,599,77,676,8388,2021-01-17 23:48:40
8482,800,3,688,89,777,8389,2021-01-18 03:54:20
8483,474,4,1526,198,1724,8390,2021-01-18 01:04:07
8484,107,2,329,42,371,8391,2021-01-17 18:01:42
8485,476,5,1225,159,1384,8392,2021-01-17 22:20:07
8486,294,3,997,129,1126,8393,2021-01-19 02:11:56
8487,24,3,597,77,674,8394,2021-01-18 20:39:11
8488,926,3,797,103,900,8395,2021-01-18 21:43:07
8489,14,3,827,107,934,8396,2021-01-18 23:46:06
8490,544,3,558,72,630,8397,2021-01-18 17:47:37
8491,369,2,898,116,1014,8398,2021-01-18 18:46:57
8492,464,2,698,90,788,8399,2021-01-18 17:00:42
8493,696,2,698,90,788,8400,2021-01-18 17:46:39
8494,543,3,597,77,674,8401,2021-01-18 16:35:15
8495,776,2,659,85,744,8402,2021-01-18 09:44:24
8496,857,2,429,55,484,8403,2021-01-18 11:25:26
8497,657,4,858,111,969,8404,2021-01-18 11:20:15
8498,358,3,1197,155,1352,8405,2021-01-18 12:07:38
8499,389,3,888,115,1003,8406,2021-01-18 04:19:57
8500,80,3,1047,136,1183,8407,2021-01-18 05:17:06
8501,313,3,1127,146,1273,8408,2021-01-18 15:14:12
8502,559,3,747,97,844,8409,2021-01-19 01:44:39
8503,367,2,459,59,518,8410,2021-01-18 19:20:28
8504,591,5,1486,193,1679,8411,2021-01-18 14:46:18
8505,507,3,1127,146,1273,8412,2021-01-17 14:32:26
8506,562,3,997,129,1126,8413,2021-01-17 14:19:49
8507,857,2,598,77,675,8414,2021-01-17 14:29:14
8508,554,3,997,129,1126,8415,2021-01-17 14:28:02
8509,210,3,997,129,1126,8416,2021-01-17 22:35:49
8510,847,2,898,116,1014,8417,2021-01-18 02:33:44
8511,44,2,1098,142,1240,8418,2021-01-18 05:25:01
8512,673,3,847,110,957,8419,2021-01-18 09:08:38
8513,300,5,907,117,1024,8420,2021-01-18 07:14:22
8514,741,5,1145,148,1293,8421,2021-01-19 00:27:19
8515,40,3,1127,146,1273,8422,2021-01-17 08:49:53
8516,993,3,888,115,1003,8423,2021-01-18 03:05:23
8517,651,3,747,97,844,8424,2021-01-18 06:38:59
8518,651,3,747,97,844,8424,2021-01-18 06:38:59
8519,861,3,578,75,653,8425,2021-01-18 04:08:33
8520,383,3,1047,136,1183,8426,2021-01-18 05:14:11
8521,616,3,597,77,674,8427,2021-01-18 11:38:53
8522,337,3,478,62,540,8428,2021-01-18 13:43:53
8523,736,3,758,98,856,8429,2021-01-17 23:30:31
8524,801,6,1316,171,1487,8430,2021-01-17 20:45:28
8525,513,5,1226,159,1385,8431,2021-01-17 14:37:06
8526,557,1,99,12,111,8432,2021-01-17 12:08:51
8527,176,3,697,90,787,8433,2021-01-18 00:20:46
8528,918,2,898,116,1014,8434,2021-01-17 12:57:11
8529,721,6,1625,211,1836,8435,2021-01-18 01:19:23
8530,247,2,898,116,1014,8436,2021-01-18 09:44:20
8531,256,3,947,123,1070,8437,2021-01-17 11:52:10
8532,863,3,1127,146,1273,8438,2021-01-18 03:56:58
8533,758,3,478,62,540,8439,2021-01-17 13:02:15
8534,365,3,597,77,674,8440,2021-01-17 20:54:19
8535,728,2,828,107,935,8441,2021-01-17 20:11:14
8536,282,3,727,94,821,8442,2021-01-18 15:02:08
8537,829,3,1047,136,1183,8443,2021-01-18 13:00:32
8538,55,3,758,98,856,8444,2021-01-18 18:11:32
8539,282,3,827,107,934,8445,2021-01-18 16:50:56
8540,922,2,498,64,562,8446,2021-01-18 16:32:24
8541,933,3,1327,172,1499,8447,2021-01-18 17:23:08
8542,799,2,398,51,449,8448,2021-01-18 18:20:14
8543,930,3,428,55,483,8449,2021-01-18 04:19:47
8544,942,3,658,85,743,8450,2021-01-18 02:20:22
8545,462,3,658,85,743,8451,2021-01-17 22:15:25
8546,533,3,1197,155,1352,8452,2021-01-18 16:33:57
8547,336,3,1047,136,1183,8453,2021-01-17 08:31:26
8548,591,3,747,97,844,8454,2021-01-17 21:40:19
8549,535,3,688,89,777,8455,2021-01-18 02:57:20
8550,708,3,1247,162,1409,8456,2021-01-18 06:52:44
8551,888,5,1295,168,1463,8457,2021-01-18 08:17:18
8552,708,3,478,62,540,8458,2021-01-18 16:53:17
8553,577,3,1047,136,1183,8459,2021-01-18 16:17:41
8554,544,3,747,97,844,8460,2021-01-17 23:04:16
8555,425,3,647,84,731,8461,2021-01-18 07:04:09
8556,297,3,997,129,1126,8462,2021-01-18 02:18:06
8557,708,3,428,55,483,8463,2021-01-18 02:51:36
8558,370,2,459,59,518,8464,2021-01-18 01:14:22
8559,488,1,599,77,676,8465,2021-01-17 06:34:21
8560,946,3,808,105,913,8466,2021-01-17 05:23:15
8561,357,4,1796,233,2029,8467,2021-01-17 03:39:27
8562,286,3,428,55,483,8468,2021-01-18 17:30:48
8563,183,6,1854,241,2095,8469,2021-01-18 15:42:34
8564,145,3,747,97,844,8470,2021-01-18 08:58:52
8565,812,3,888,115,1003,8471,2021-01-18 20:53:42
8566,483,2,798,103,901,8472,2021-01-18 22:59:52
8567,138,3,578,75,653,8473,2021-01-18 17:18:28
8568,495,3,658,85,743,8474,2021-01-18 11:01:05
8569,66,2,898,116,1014,8475,2021-01-18 05:21:05
8570,880,2,798,103,901,8476,2021-01-18 20:49:18
8571,903,2,798,103,901,8477,2021-01-18 18:15:14
8572,269,6,1294,168,1462,8478,2021-01-18 22:18:29
8573,568,2,1098,142,1240,8479,2021-01-17 13:44:19
8574,706,2,459,59,518,8480,2021-01-18 00:15:48
8575,191,3,558,72,630,8481,2021-01-17 22:08:07
8576,882,6,1554,202,1756,8482,2021-01-18 00:40:38
8577,882,6,1554,202,1756,8482,2021-01-18 00:40:38
8578,461,3,478,62,540,8483,2021-01-18 00:10:48
8579,557,3,597,77,674,8484,2021-01-18 03:54:48
8580,905,3,1327,172,1499,8485,2021-01-18 01:33:02
8581,608,3,608,79,687,8486,2021-01-17 18:19:07
8582,123,3,647,84,731,8487,2021-01-17 23:10:53
8583,65,4,1826,237,2063,8488,2021-01-19 02:59:05
8584,489,3,947,123,1070,8489,2021-01-18 21:46:59
8585,261,3,997,129,1126,8490,2021-01-18 22:38:59
8586,455,3,897,116,1013,8491,2021-01-19 02:29:41
8587,647,3,478,62,540,8492,2021-01-18 18:38:18
8588,988,3,947,123,1070,8493,2021-01-18 20:24:45
8589,591,2,598,77,675,8494,2021-01-18 18:47:20
8590,391,3,1027,133,1160,8495,2021-01-18 18:35:25
8591,57,3,827,107,934,8496,2021-01-18 17:21:29
8592,350,2,659,85,744,8497,2021-01-18 11:30:11
8593,958,1,149,19,168,8498,2021-01-18 12:00:53
8594,741,2,798,103,901,8499,2021-01-18 11:33:04
8595,862,3,847,110,957,8500,2021-01-18 14:24:53
8596,348,6,2124,276,2400,8501,2021-01-18 05:43:23
8597,785,3,747,97,844,8502,2021-01-18 07:57:29
8598,801,3,1047,136,1183,8503,2021-01-18 16:38:48
8599,512,5,1506,195,1701,8504,2021-01-19 03:50:06
8600,883,6,1585,206,1791,8505,2021-01-18 19:24:01
8601,846,5,1286,167,1453,8506,2021-01-18 17:23:52
8602,9,3,688,89,777,8507,2021-01-17 15:42:00
8603,648,1,699,90,789,8508,2021-01-17 16:54:59
8604,139,2,498,64,562,8509,2021-01-17 16:42:43
8605,798,6,1355,176,1531,8510,2021-01-17 16:54:43
8606,975,3,727,94,821,8511,2021-01-17 23:34:34
8607,156,3,808,105,913,8512,2021-01-18 03:09:13
8608,480,3,747,97,844,8513,2021-01-18 06:25:27
8609,0,3,478,62,540,8514,2021-01-18 11:10:28
8610,290,2,798,103,901,8515,2021-01-18 09:44:39
8611,194,3,927,120,1047,8516,2021-01-19 00:47:21
8612,817,2,898,116,1014,8517,2021-01-17 10:00:13
8613,689,2,1098,142,1240,8518,2021-01-18 04:31:38
8614,365,3,697,90,787,8519,2021-01-18 08:33:53
8615,208,3,1197,155,1352,8520,2021-01-18 07:13:31
8616,352,6,1805,234,2039,8521,2021-01-18 04:30:09
8617,462,5,1286,167,1453,8522,2021-01-18 07:19:46
8618,673,3,558,72,630,8523,2021-01-18 13:25:49
8619,779,3,697,90,787,8524,2021-01-18 13:56:53
8620,426,4,1726,224,1950,8525,2021-01-18 00:16:29
8621,719,3,897,116,1013,8526,2021-01-17 21:37:22
8622,532,3,847,110,957,8527,2021-01-17 14:38:47
8623,720,3,1197,155,1352,8528,2021-01-17 14:05:06
8624,131,6,1075,139,1214,8529,2021-01-18 01:49:05
8625,979,3,578,75,653,8530,2021-01-17 15:42:43
8626,649,2,898,116,1014,8531,2021-01-18 02:16:25
8627,419,2,898,116,1014,8532,2021-01-18 11:58:14
8628,948,6,1525,198,1723,8533,2021-01-17 13:26:42
8629,676,2,498,64,562,8534,2021-01-18 04:51:07
8630,711,3,1127,146,1273,8535,2021-01-17 14:48:00
8631,517,3,888,115,1003,8536,2021-01-17 21:24:32
8632,971,6,1544,200,1744,8537,2021-01-17 22:49:54
8633,141,3,428,55,483,8538,2021-01-18 17:22:20
8634,654,2,429,55,484,8539,2021-01-18 13:16:34
8635,86,3,1127,146,1273,8540,2021-01-18 20:39:33
8636,139,2,598,77,675,8541,2021-01-18 17:10:41
8637,748,2,498,64,562,8542,2021-01-18 18:18:48
8638,277,3,647,84,731,8543,2021-01-18 18:46:37
8639,167,3,727,94,821,8544,2021-01-18 20:09:00
8640,888,5,1556,202,1758,8545,2021-01-18 06:02:43
8641,314,2,498,64,562,8546,2021-01-18 04:24:01
8642,51,3,1127,146,1273,8547,2021-01-17 23:24:20
8643,537,2,498,64,562,8548,2021-01-18 19:18:40
8644,62,2,329,42,371,8549,2021-01-17 09:28:15
8645,768,3,758,98,856,8550,2021-01-17 22:02:47
8646,848,5,1695,220,1915,8551,2021-01-18 04:35:14
8647,51,2,548,71,619,8552,2021-01-18 08:16:18
8648,29,2,698,90,788,8553,2021-01-18 08:25:21
8649,916,3,697,90,787,8554,2021-01-18 19:25:41
8650,819,2,459,59,518,8555,2021-01-18 18:27:43
8651,943,2,429,55,484,8556,2021-01-18 01:28:07
8652,44,3,1247,162,1409,8557,2021-01-18 07:46:14
8653,225,3,647,84,731,8558,2021-01-18 03:34:59
8654,135,2,828,107,935,8559,2021-01-18 03:33:16
8655,430,2,828,107,935,8560,2021-01-18 01:38:26
8656,804,2,1098,142,1240,8561,2021-01-17 07:25:57
8657,971,3,947,123,1070,8562,2021-01-17 05:44:13
8658,109,2,329,42,371,8563,2021-01-17 05:20:07
8659,52,2,798,103,901,8564,2021-01-18 19:29:18
8660,67,3,888,115,1003,8565,2021-01-18 17:26:21
8661,315,3,808,105,913,8566,2021-01-18 09:38:32
8662,885,6,1455,189,1644,8567,2021-01-18 21:32:04
8663,65,2,398,51,449,8568,2021-01-19 01:37:01
8664,133,3,797,103,900,8569,2021-01-18 18:10:57
8665,359,3,927,120,1047,8570,2021-01-18 12:54:49
8666,856,2,498,64,562,8571,2021-01-18 07:53:07
8667,196,3,827,107,934,8572,2021-01-18 23:34:15
8668,577,2,459,59,518,8573,2021-01-18 19:31:50
8669,708,2,598,77,675,8574,2021-01-19 00:58:45
8670,69,2,429,55,484,8575,2021-01-17 16:29:52
8671,377,5,2025,263,2288,8576,2021-01-18 02:49:26
8672,732,2,498,64,562,8577,2021-01-18 00:14:52
8673,302,3,1247,162,1409,8578,2021-01-18 03:19:35
8674,557,3,997,129,1126,8579,2021-01-18 01:28:38
8675,195,3,808,105,913,8580,2021-01-18 02:12:16
8676,596,2,1098,142,1240,8581,2021-01-18 06:15:14
8677,590,2,329,42,371,8582,2021-01-18 03:59:07
8678,590,2,329,42,371,8582,2021-01-18 03:59:07
8679,790,4,1196,155,1351,8583,2021-01-17 18:28:28
8680,201,3,897,116,1013,8584,2021-01-18 01:23:09
8681,565,2,798,103,901,8585,2021-01-19 03:04:05
8682,386,3,747,97,844,8586,2021-01-18 23:33:40
8683,452,2,898,116,1014,8587,2021-01-18 23:16:06
8684,86,2,828,107,935,8588,2021-01-19 04:11:09
8685,741,3,827,107,934,8589,2021-01-18 19:39:13
8686,423,5,1147,149,1296,8590,2021-01-18 20:52:43
8687,396,1,229,29,258,8591,2021-01-18 18:56:28
8688,888,2,498,64,562,8592,2021-01-18 20:50:34
8689,131,3,688,89,777,8593,2021-01-18 17:26:20
8690,580,3,1327,172,1499,8594,2021-01-18 12:15:49
8691,362,6,1225,159,1384,8595,2021-01-18 12:34:17
8692,660,4,2026,263,2289,8596,2021-01-18 11:55:24
8693,191,3,1247,162,1409,8597,2021-01-18 15:20:19
8694,585,2,459,59,518,8598,2021-01-18 07:23:02
8695,890,4,1196,155,1351,8599,2021-01-18 08:23:50
8696,230,3,1127,146,1273,8600,2021-01-18 16:51:41
8697,20,2,498,64,562,8601,2021-01-19 05:24:52
8698,758,3,997,129,1126,8602,2021-01-18 19:32:52
8699,998,2,598,77,675,8603,2021-01-18 17:37:47
8700,316,3,558,72,630,8604,2021-01-17 15:56:47
8701,276,3,1247,162,1409,8605,2021-01-17 18:43:38
8702,791,1,299,38,337,8606,2021-01-17 17:33:25
8703,251,2,598,77,675,8607,2021-01-17 18:13:30
8704,771,3,478,62,540,8608,2021-01-18 01:05:59
8705,325,3,1027,133,1160,8609,2021-01-18 03:59:13
8706,36,2,659,85,744,8610,2021-01-18 09:10:49
8707,591,3,578,75,653,8611,2021-01-18 13:21:05
8708,139,3,1327,172,1499,8612,2021-01-18 10:42:30
8709,837,3,888,115,1003,8613,2021-01-19 02:43:37
8710,830,5,1625,211,1836,8614,2021-01-17 10:50:04
8711,555,3,827,107,934,8615,2021-01-18 06:40:48
8712,962,3,1047,136,1183,8616,2021-01-18 10:12:08
8713,939,5,1925,250,2175,8617,2021-01-18 08:02:19
8714,992,5,1595,207,1802,8618,2021-01-18 07:07:39
8715,602,3,1127,146,1273,8619,2021-01-18 08:12:14
8716,975,2,429,55,484,8620,2021-01-18 13:34:57
8717,770,2,598,77,675,8621,2021-01-18 15:42:11
8718,18,3,478,62,540,8622,2021-01-18 00:28:18
8719,756,2,898,116,1014,8623,2021-01-17 23:33:43
8720,636,2,628,81,709,8624,2021-01-17 15:45:36
8721,665,3,1327,172,1499,8625,2021-01-17 14:19:39
8722,578,3,997,129,1126,8626,2021-01-18 04:21:20
8723,126,3,897,116,1013,8627,2021-01-17 17:16:47
8724,910,3,997,129,1126,8628,2021-01-18 03:36:11
8725,526,3,927,120,1047,8629,2021-01-18 14:25:06
8726,46,3,558,72,630,8630,2021-01-17 14:39:22
8727,500,2,798,103,901,8631,2021-01-18 06:55:28
8728,686,3,797,103,900,8632,2021-01-17 15:57:09
8729,698,3,888,115,1003,8633,2021-01-17 23:33:26
8730,198,3,1047,136,1183,8634,2021-01-18 00:41:12
8731,226,2,798,103,901,8635,2021-01-18 17:42:05
8732,493,3,888,115,1003,8636,2021-01-18 16:00:30
8733,52,3,1127,146,1273,8637,2021-01-18 21:43:11
8734,882,3,1027,133,1160,8638,2021-01-18 17:40:34
8735,658,3,1047,136,1183,8639,2021-01-18 19:03:55
8736,558,2,898,116,1014,8640,2021-01-18 18:50:27
8737,656,2,498,64,562,8641,2021-01-18 21:49:00
8738,435,2,648,84,732,8642,2021-01-18 08:02:24
8739,517,4,1296,168,1464,8643,2021-01-18 05:01:08
8740,147,3,827,107,934,8644,2021-01-17 23:36:13
8741,607,2,1098,142,1240,8645,2021-01-18 20:19:43
8742,416,2,498,64,562,8646,2021-01-17 12:08:30
8743,739,3,747,97,844,8647,2021-01-17 23:07:12
8744,339,3,1197,155,1352,8648,2021-01-18 06:46:00
8745,298,2,459,59,518,8649,2021-01-18 08:25:05
8746,951,3,827,107,934,8650,2021-01-18 10:26:35
8747,967,3,897,116,1013,8651,2021-01-18 22:07:49
8748,952,5,1495,194,1689,8652,2021-01-18 18:45:46
8749,224,3,1047,136,1183,8653,2021-01-18 02:54:41
8750,211,3,758,98,856,8654,2021-01-18 10:08:21
8751,381,3,797,103,900,8655,2021-01-18 04:43:01
8752,66,3,897,116,1013,8656,2021-01-18 05:00:11
8753,209,1,599,77,676,8657,2021-01-18 03:50:34
8754,822,5,1217,158,1375,8658,2021-01-17 09:56:39
8755,579,3,827,107,934,8659,2021-01-17 08:20:21
8756,545,2,429,55,484,8660,2021-01-17 07:21:35
8757,540,3,597,77,674,8661,2021-01-18 20:41:55
8758,325,3,647,84,731,8662,2021-01-18 19:15:43
8759,659,3,658,85,743,8663,2021-01-18 11:00:26
8760,415,6,1824,237,2061,8664,2021-01-18 22:45:27
8761,856,3,897,116,1013,8665,2021-01-19 02:22:40
8762,672,2,828,107,935,8666,2021-01-18 20:01:09
8763,807,3,608,79,687,8667,2021-01-18 14:20:19
8764,292,4,1146,148,1294,8668,2021-01-18 08:18:30
8765,859,3,608,79,687,8669,2021-01-19 00:12:57
8766,205,2,828,107,935,8670,2021-01-18 20:59:56
8767,78,2,898,116,1014,8671,2021-01-19 03:33:30
8768,558,1,499,64,563,8672,2021-01-17 19:15:39
8769,940,2,698,90,788,8673,2021-01-18 03:12:25
8770,883,2,898,116,1014,8674,2021-01-18 01:18:58
8771,812,6,1374,178,1552,8675,2021-01-18 03:32:57
8772,89,5,1625,211,1836,8676,2021-01-18 01:40:50
8773,892,3,997,129,1126,8677,2021-01-18 03:52:54
8774,521,3,808,105,913,8678,2021-01-18 08:21:44
8775,113,3,1197,155,1352,8679,2021-01-18 04:41:54
8776,973,2,429,55,484,8680,2021-01-18 04:29:18
8777,465,3,688,89,777,8681,2021-01-17 19:10:33
8778,365,3,888,115,1003,8682,2021-01-18 01:34:48
8779,293,3,827,107,934,8683,2021-01-19 05:33:58
8780,712,3,997,129,1126,8684,2021-01-19 02:15:18
8781,120,3,658,85,743,8685,2021-01-18 23:35:31
8782,602,2,329,42,371,8686,2021-01-19 04:58:30
8783,820,2,429,55,484,8687,2021-01-18 19:46:33
8784,247,3,947,123,1070,8688,2021-01-18 21:36:00
8785,754,5,1245,161,1406,8689,2021-01-18 21:38:05
8786,973,3,997,129,1126,8690,2021-01-18 22:23:38
8787,825,2,429,55,484,8691,2021-01-18 20:06:19
8788,906,3,1027,133,1160,8692,2021-01-18 14:36:26
8789,689,5,1586,206,1792,8693,2021-01-18 13:15:11
8790,524,3,608,79,687,8694,2021-01-18 14:01:18
8791,393,3,697,90,787,8695,2021-01-18 16:41:20
8792,922,2,329,42,371,8696,2021-01-18 10:03:44
8793,252,3,797,103,900,8697,2021-01-18 11:06:38
8794,612,2,528,68,596,8698,2021-01-18 19:29:47
8795,312,3,1127,146,1273,8699,2021-01-19 06:38:05
8796,495,3,1027,133,1160,8700,2021-01-18 19:43:27
8797,61,3,897,116,1013,8701,2021-01-18 19:30:49
8798,557,4,1196,155,1351,8702,2021-01-17 16:31:50
8799,425,1,499,64,563,8703,2021-01-17 19:51:45
8800,307,4,1596,207,1803,8704,2021-01-17 18:46:33
8801,949,3,608,79,687,8705,2021-01-17 18:13:39
8802,890,3,1127,146,1273,8706,2021-01-18 01:08:03
8803,98,3,428,55,483,8707,2021-01-18 05:52:57
8804,734,3,428,55,483,8708,2021-01-18 11:08:45
8805,954,2,598,77,675,8709,2021-01-18 13:28:48
8806,424,4,827,107,934,8710,2021-01-18 12:11:13
8807,30,2,1098,142,1240,8711,2021-01-19 04:17:47
8808,380,3,827,107,934,8712,2021-01-17 11:57:40
8809,453,3,1027,133,1160,8713,2021-01-18 07:35:46
8810,187,3,1127,146,1273,8714,2021-01-18 11:40:38
8811,60,3,697,90,787,8715,2021-01-18 09:03:38
8812,523,2,928,120,1048,8716,2021-01-18 09:00:39
8813,657,2,898,116,1014,8717,2021-01-18 09:11:40
8814,101,3,1047,136,1183,8718,2021-01-18 14:37:40
8815,656,2,659,85,744,8719,2021-01-18 17:29:28
8816,591,5,1256,163,1419,8720,2021-01-18 03:06:32
8817,48,3,997,129,1126,8721,2021-01-18 01:45:14
8818,120,3,697,90,787,8722,2021-01-17 17:33:03
8819,694,2,398,51,449,8723,2021-01-17 15:44:47
8820,779,4,1296,168,1464,8724,2021-01-18 06:59:47
8821,242,3,597,77,674,8725,2021-01-17 19:41:18
8822,143,3,747,97,844,8726,2021-01-18 04:22:23
8823,509,2,429,55,484,8727,2021-01-18 15:53:54
8824,525,3,847,110,957,8728,2021-01-17 15:23:20
8825,968,3,1247,162,1409,8729,2021-01-18 09:37:42
8826,729,3,428,55,483,8730,2021-01-17 16:04:11
8827,855,3,1127,146,1273,8731,2021-01-17 23:56:41
8828,317,2,748,97,845,8732,2021-01-18 02:19:27
8829,837,3,597,77,674,8733,2021-01-18 18:31:18
8830,273,3,997,129,1126,8734,2021-01-18 16:08:22
8831,82,3,1127,146,1273,8735,2021-01-18 23:02:29
8832,209,2,898,116,1014,8736,2021-01-18 18:04:27
8833,45,3,827,107,934,8737,2021-01-18 21:19:38
8834,12,5,2125,276,2401,8738,2021-01-18 19:30:40
8835,833,3,808,105,913,8739,2021-01-18 22:00:32
8836,419,5,1486,193,1679,8740,2021-01-18 08:52:56
8837,690,2,329,42,371,8741,2021-01-18 06:01:40
8838,479,2,429,55,484,8742,2021-01-18 01:25:27
8839,444,3,608,79,687,8743,2021-01-18 22:57:35
8840,390,3,1327,172,1499,8744,2021-01-17 14:43:34
8841,783,6,1694,220,1914,8745,2021-01-18 01:21:21
8842,167,2,1098,142,1240,8746,2021-01-18 07:28:16
8843,768,2,898,116,1014,8747,2021-01-18 09:59:35
8844,888,3,827,107,934,8748,2021-01-18 12:22:52
8845,124,3,1247,162,1409,8749,2021-01-18 22:20:54
8846,541,2,898,116,1014,8750,2021-01-18 21:13:31
8847,902,2,429,55,484,8751,2021-01-18 03:36:15
8848,851,2,1098,142,1240,8752,2021-01-18 12:47:41
8849,977,3,597,77,674,8753,2021-01-18 06:44:32
8850,305,4,727,94,821,8754,2021-01-18 05:50:11
8851,363,2,459,59,518,8755,2021-01-18 05:18:08
8852,93,1,229,29,258,8756,2021-01-17 10:44:16
8853,523,3,797,103,900,8757,2021-01-17 08:57:52
8854,617,2,459,59,518,8758,2021-01-17 08:47:06
8855,798,5,1925,250,2175,8759,2021-01-18 23:07:49
8856,12,2,329,42,371,8760,2021-01-18 21:08:48
8857,689,3,608,79,687,8761,2021-01-18 11:18:45
8858,555,3,697,90,787,8762,2021-01-18 23:34:50
8859,305,3,888,115,1003,8763,2021-01-19 04:47:56
8860,754,3,727,94,821,8764,2021-01-18 20:24:44
8861,343,3,528,68,596,8765,2021-01-18 17:06:43
8862,33,3,697,90,787,8766,2021-01-18 10:24:23
8863,739,2,659,85,744,8767,2021-01-19 00:24:16
8864,483,3,688,89,777,8768,2021-01-18 23:05:01
8865,358,3,1197,155,1352,8769,2021-01-19 05:32:54
8866,788,2,548,71,619,8770,2021-01-17 19:43:57
8867,312,2,429,55,484,8771,2021-01-18 04:35:44
8868,89,3,697,90,787,8772,2021-01-18 01:42:56
8869,421,2,329,42,371,8773,2021-01-18 06:12:46
8870,835,2,498,64,562,8774,2021-01-18 01:41:41
8871,245,3,478,62,540,8775,2021-01-18 04:28:53
8872,169,3,528,68,596,8776,2021-01-18 09:34:18
8873,220,2,659,85,744,8777,2021-01-18 06:19:57
8874,687,3,528,68,596,8778,2021-01-18 06:33:47
8875,958,3,897,116,1013,8779,2021-01-17 19:18:15
8876,427,3,1527,198,1725,8780,2021-01-18 02:55:03
8877,320,2,429,55,484,8781,2021-01-19 05:39:33
8878,260,3,997,129,1126,8782,2021-01-19 02:23:25
8879,368,3,758,98,856,8783,2021-01-18 23:52:29
8880,311,2,828,107,935,8784,2021-01-19 07:12:15
8881,93,6,1724,224,1948,8785,2021-01-18 22:25:57
8882,394,3,827,107,934,8786,2021-01-18 21:47:50
8883,747,2,598,77,675,8787,2021-01-18 23:16:30
8884,868,2,459,59,518,8788,2021-01-19 00:16:07
8885,500,3,578,75,653,8789,2021-01-18 20:31:52
8886,71,4,1526,198,1724,8790,2021-01-18 14:40:03
8887,668,3,827,107,934,8791,2021-01-18 13:46:11
8888,178,3,528,68,596,8792,2021-01-18 15:32:51
8889,739,2,648,84,732,8793,2021-01-18 18:18:08
8890,48,3,897,116,1013,8794,2021-01-18 10:05:49
8891,72,2,528,68,596,8795,2021-01-18 11:33:51
8892,569,3,897,116,1013,8796,2021-01-18 21:23:00
8893,342,2,898,116,1014,8797,2021-01-19 08:08:23
8894,453,4,1296,168,1464,8798,2021-01-18 20:37:41
8895,55,3,647,84,731,8799,2021-01-18 21:58:04
8896,410,3,1197,155,1352,8800,2021-01-17 18:32:27
8897,829,6,1744,226,1970,8801,2021-01-17 20:47:20
8898,343,2,548,71,619,8802,2021-01-17 21:15:20
8899,363,6,1216,158,1374,8803,2021-01-17 19:05:18
8900,851,3,827,107,934,8804,2021-01-18 03:12:04
8901,561,3,528,68,596,8805,2021-01-18 07:41:47
8902,286,5,1136,147,1283,8806,2021-01-18 12:53:08
8903,403,2,1098,142,1240,8807,2021-01-18 13:42:58
8904,537,3,888,115,1003,8808,2021-01-18 13:35:23
8905,689,3,888,115,1003,8809,2021-01-19 05:01:50
8906,715,3,647,84,731,8810,2021-01-17 12:34:29
8907,220,2,448,58,506,8811,2021-01-18 09:44:33
8908,927,3,578,75,653,8812,2021-01-18 12:20:10
8909,821,5,1137,147,1284,8813,2021-01-18 10:44:05
8910,350,2,659,85,744,8814,2021-01-18 11:44:39
8911,607,2,659,85,744,8815,2021-01-18 10:40:55
8912,529,3,727,94,821,8816,2021-01-18 16:30:04
8913,423,3,1327,172,1499,8817,2021-01-18 18:14:16
8914,639,1,99,12,111,8818,2021-01-18 04:42:12
8915,880,3,1247,162,1409,8819,2021-01-18 04:19:58
8916,996,3,747,97,844,8820,2021-01-17 19:14:33
8917,107,3,597,77,674,8821,2021-01-17 17:40:02
8918,237,3,847,110,957,8822,2021-01-18 08:11:36
8919,82,3,697,90,787,8823,2021-01-17 20:09:34
8920,269,3,927,120,1047,8824,2021-01-18 05:18:55
8921,264,3,528,68,596,8825,2021-01-18 17:57:39
8922,990,5,1006,130,1136,8826,2021-01-17 17:28:42
8923,870,3,528,68,596,8827,2021-01-18 10:54:08
8924,191,2,1098,142,1240,8828,2021-01-17 17:16:38
8925,443,3,827,107,934,8829,2021-01-18 01:51:55
8926,533,2,329,42,371,8830,2021-01-18 04:39:50
8927,586,3,797,103,900,8831,2021-01-18 20:31:35
8928,969,3,1247,162,1409,8832,2021-01-18 17:09:02
8929,453,3,997,129,1126,8833,2021-01-18 23:23:38
8930,898,2,698,90,788,8834,2021-01-18 20:32:01
8931,873,3,808,105,913,8835,2021-01-18 23:06:29
8932,194,3,1027,133,1160,8836,2021-01-18 19:38:53
8933,192,3,1127,146,1273,8837,2021-01-18 23:02:33
8934,515,3,608,79,687,8838,2021-01-18 08:58:27
8935,115,3,827,107,934,8839,2021-01-18 07:06:48
8936,724,3,808,105,913,8840,2021-01-18 02:14:03
8937,913,3,747,97,844,8841,2021-01-18 23:29:21
8938,968,1,599,77,676,8842,2021-01-17 17:11:26
8939,829,3,997,129,1126,8843,2021-01-18 03:51:35
8940,640,3,927,120,1047,8844,2021-01-18 07:47:47
8941,91,3,1247,162,1409,8845,2021-01-18 10:28:40
8942,366,2,798,103,901,8846,2021-01-18 13:51:32
8943,679,4,1446,187,1633,8847,2021-01-19 01:03:43
8944,550,2,659,85,744,8848,2021-01-18 21:22:06
8945,775,3,608,79,687,8849,2021-01-18 06:01:53
8946,482,5,1156,150,1306,8850,2021-01-18 14:42:41
8947,823,3,658,85,743,8851,2021-01-18 08:59:13
8948,49,3,1327,172,1499,8852,2021-01-18 06:22:11
8949,122,1,99,12,111,8853,2021-01-18 07:03:19
8950,59,3,1197,155,1352,8854,2021-01-17 13:01:53
8951,966,2,659,85,744,8855,2021-01-17 11:34:32
8952,143,3,697,90,787,8856,2021-01-17 10:39:49
8953,850,2,898,116,1014,8857,2021-01-18 23:12:09
8954,870,3,947,123,1070,8858,2021-01-18 21:17:03
8955,599,2,659,85,744,8859,2021-01-18 11:33:35
8956,463,5,1895,246,2141,8860,2021-01-19 01:13:12
8957,498,3,578,75,653,8861,2021-01-19 06:01:53
8958,88,3,797,103,900,8862,2021-01-18 20:50:21
8959,116,3,597,77,674,8863,2021-01-18 18:07:59
8960,195,3,578,75,653,8864,2021-01-18 13:00:54
8961,920,2,459,59,518,8865,2021-01-19 01:08:00
8962,937,2,898,116,1014,8866,2021-01-19 00:26:08
8963,190,3,1027,133,1160,8867,2021-01-19 05:45:48
8964,917,2,498,64,562,8868,2021-01-17 20:48:07
8965,554,3,897,116,1013,8869,2021-01-18 06:05:20
8966,634,3,808,105,913,8870,2021-01-18 02:51:31
8967,823,2,398,51,449,8871,2021-01-18 06:45:24
8968,698,3,697,90,787,8872,2021-01-18 03:30:32
8969,511,3,1327,172,1499,8873,2021-01-18 05:07:26
8970,351,5,1695,220,1915,8874,2021-01-18 09:45:12
8971,893,3,478,62,540,8875,2021-01-18 08:05:52
8972,395,3,727,94,821,8876,2021-01-18 06:58:06
8973,473,2,598,77,675,8877,2021-01-17 21:32:28
8974,792,5,1156,150,1306,8878,2021-01-18 05:14:15
8975,933,3,927,120,1047,8879,2021-01-19 05:55:54
8976,305,3,827,107,934,8880,2021-01-19 03:47:14
8977,509,5,1317,171,1488,8881,2021-01-19 00:39:50
8978,392,2,748,97,845,8882,2021-01-19 07:26:11
8979,475,3,827,107,934,8883,2021-01-18 23:40:30
8980,38,3,727,94,821,8884,2021-01-18 23:32:22
8981,420,2,598,77,675,8885,2021-01-19 00:08:33
8982,946,3,747,97,844,8886,2021-01-19 01:15:56
8983,816,2,429,55,484,8887,2021-01-18 21:16:08
8984,933,3,1327,172,1499,8888,2021-01-18 16:16:48
8985,325,3,1127,146,1273,8889,2021-01-18 15:46:18
8986,354,3,528,68,596,8890,2021-01-18 17:39:28
8987,60,3,688,89,777,8891,2021-01-18 19:24:45
8988,776,4,1296,168,1464,8892,2021-01-18 12:37:46
8989,789,2,898,116,1014,8893,2021-01-18 13:13:54
8990,786,5,1456,189,1645,8894,2021-01-18 23:18:15
8991,118,1,149,19,168,8895,2021-01-19 10:13:07
8992,671,3,1127,146,1273,8896,2021-01-18 23:02:51
8993,52,3,697,90,787,8897,2021-01-18 22:10:08
8994,21,1,599,77,676,8898,2021-01-17 20:07:54
8995,446,3,647,84,731,8899,2021-01-17 21:28:32
8996,842,5,1225,159,1384,8900,2021-01-17 23:46:20
8997,829,3,528,68,596,8901,2021-01-17 21:34:50
8998,206,2,798,103,901,8902,2021-01-18 05:37:18
8999,289,2,498,64,562,8903,2021-01-18 10:03:30
9000,899,2,659,85,744,8904,2021-01-18 14:19:07
9001,186,3,688,89,777,8905,2021-01-18 16:11:03
9002,382,2,598,77,675,8906,2021-01-18 14:56:02
9003,91,5,1176,152,1328,8907,2021-01-19 05:15:21
9004,39,3,997,129,1126,8908,2021-01-17 12:42:21
9005,58,4,1296,168,1464,8909,2021-01-18 10:58:00
9006,91,3,897,116,1013,8910,2021-01-18 12:31:22
9007,182,3,558,72,630,8911,2021-01-18 11:23:19
9008,773,2,498,64,562,8912,2021-01-18 12:19:09
9009,3,1,99,12,111,8913,2021-01-18 11:41:44
9010,105,3,897,116,1013,8914,2021-01-18 18:04:00
9011,211,5,1506,195,1701,8915,2021-01-18 19:16:16
9012,72,1,399,51,450,8916,2021-01-18 05:13:22
9013,981,1,99,12,111,8917,2021-01-18 05:32:56
9014,107,4,1446,187,1633,8918,2021-01-17 20:12:24
9015,331,3,1157,150,1307,8919,2021-01-17 19:51:45
9016,857,2,828,107,935,8920,2021-01-18 09:59:40
9017,686,3,558,72,630,8921,2021-01-17 21:13:06
9018,205,3,747,97,844,8922,2021-01-18 06:44:14
9019,331,3,808,105,913,8923,2021-01-18 19:30:01
9020,848,2,1098,142,1240,8924,2021-01-17 18:48:40
9021,398,2,628,81,709,8925,2021-01-18 13:30:23
9022,615,3,647,84,731,8926,2021-01-17 17:26:33
9023,232,2,1098,142,1240,8927,2021-01-18 02:22:02
9024,550,2,598,77,675,8928,2021-01-18 05:06:21
9025,799,5,1945,252,2197,8929,2021-01-18 20:38:20
9026,329,3,597,77,674,8930,2021-01-18 18:23:29
9027,260,3,1197,155,1352,8931,2021-01-19 01:03:04
9028,915,2,898,116,1014,8932,2021-01-18 22:33:35
9029,596,2,498,64,562,8933,2021-01-19 01:19:00
9030,697,5,1345,174,1519,8934,2021-01-18 20:50:57
9031,622,2,548,71,619,8935,2021-01-19 00:31:21
9032,136,3,1127,146,1273,8936,2021-01-18 11:21:13
9033,534,5,1925,250,2175,8937,2021-01-18 09:33:13
9034,133,3,1197,155,1352,8938,2021-01-18 03:57:04
9035,780,3,727,94,821,8939,2021-01-19 00:47:05
9036,288,3,697,90,787,8940,2021-01-17 17:29:33
9037,467,2,798,103,901,8941,2021-01-18 05:23:30
9038,471,2,798,103,901,8942,2021-01-18 08:39:31
9039,318,3,528,68,596,8943,2021-01-18 12:10:32
9040,369,3,578,75,653,8944,2021-01-18 14:39:27
9041,960,3,578,75,653,8945,2021-01-19 02:57:40
9042,219,3,827,107,934,8946,2021-01-18 22:02:06
9043,728,3,528,68,596,8947,2021-01-18 06:58:11
9044,277,2,798,103,901,8948,2021-01-18 17:11:37
9045,327,5,1536,199,1735,8949,2021-01-18 11:30:22
9046,26,2,698,90,788,8950,2021-01-18 06:36:39
9047,948,1,699,90,789,8951,2021-01-18 08:42:46
9048,993,3,847,110,957,8952,2021-01-17 13:41:21
9049,449,4,1196,155,1351,8953,2021-01-17 11:41:51
9050,624,2,898,116,1014,8954,2021-01-17 13:21:19
9051,316,2,329,42,371,8955,2021-01-19 01:34:25
9052,536,3,797,103,900,8956,2021-01-18 22:51:43
9053,290,3,897,116,1013,8957,2021-01-18 12:47:08
9054,123,5,1126,146,1272,8958,2021-01-19 03:02:43
9055,767,3,597,77,674,8959,2021-01-19 07:20:16
9056,566,3,827,107,934,8960,2021-01-18 21:52:52
9057,532,3,1247,162,1409,8961,2021-01-18 18:35:51
9058,495,2,898,116,1014,8962,2021-01-18 14:32:53
9059,232,3,847,110,957,8963,2021-01-19 03:42:34
9060,184,3,647,84,731,8964,2021-01-19 02:13:52
9061,343,3,428,55,483,8965,2021-01-19 06:09:22
9062,524,3,897,116,1013,8966,2021-01-17 22:52:18
9063,920,3,1047,136,1183,8967,2021-01-18 07:19:06
9064,166,2,429,55,484,8968,2021-01-18 03:34:18
9065,704,2,698,90,788,8969,2021-01-18 09:10:59
9066,342,3,947,123,1070,8970,2021-01-18 03:45:19
9067,402,3,478,62,540,8971,2021-01-18 07:21:20
9068,33,2,598,77,675,8972,2021-01-18 12:23:36
9069,77,3,1047,136,1183,8973,2021-01-18 09:35:24
9070,646,2,898,116,1014,8974,2021-01-18 07:03:42
9071,369,2,698,90,788,8975,2021-01-17 23:23:15
9072,870,2,659,85,744,8976,2021-01-18 06:10:40
9073,11,3,888,115,1003,8977,2021-01-19 08:14:24
9074,217,2,329,42,371,8978,2021-01-19 04:15:26
9075,292,4,1696,220,1916,8979,2021-01-19 03:10:23
9076,674,3,847,110,957,8980,2021-01-19 09:45:11
9077,872,3,747,97,844,8981,2021-01-19 01:20:38
9078,944,5,1486,193,1679,8982,2021-01-19 01:45:32
9079,294,3,747,97,844,8983,2021-01-19 02:11:37
9080,355,3,847,110,957,8984,2021-01-19 01:43:17
9081,747,3,578,75,653,8985,2021-01-18 23:24:49
9082,471,2,598,77,675,8986,2021-01-18 17:03:16
9083,502,3,1047,136,1183,8987,2021-01-18 16:17:25
9084,158,3,897,116,1013,8988,2021-01-18 19:53:14
9085,374,2,329,42,371,8989,2021-01-18 19:33:30
9086,226,3,997,129,1126,8990,2021-01-18 13:52:05
9087,672,2,498,64,562,8991,2021-01-18 14:31:33
9088,223,2,598,77,675,8992,2021-01-19 00:24:09
9089,432,3,808,105,913,8993,2021-01-19 12:46:14
9090,170,2,459,59,518,8994,2021-01-19 01:20:35
9091,830,3,747,97,844,8995,2021-01-18 23:45:51
9092,258,3,1327,172,1499,8996,2021-01-17 22:20:14
9093,657,3,658,85,743,8997,2021-01-17 21:52:32
9094,347,3,827,107,934,8998,2021-01-18 01:53:37
9095,20,3,1127,146,1273,8999,2021-01-17 23:11:49
9096,154,5,1376,178,1554,9000,2021-01-18 06:51:39
9097,324,3,997,129,1126,9001,2021-01-18 10:32:04
9098,287,3,478,62,540,9002,2021-01-18 16:04:41
9099,997,6,1944,252,2196,9003,2021-01-18 18:42:40
9100,654,3,428,55,483,9004,2021-01-18 15:14:24
9101,618,2,498,64,562,9005,2021-01-19 06:05:22
9102,120,3,428,55,483,9006,2021-01-17 13:10:11
9103,531,3,808,105,913,9007,2021-01-18 13:21:36
9104,973,3,997,129,1126,9008,2021-01-18 14:34:52
9105,182,3,847,110,957,9009,2021-01-18 11:57:54
9106,316,3,597,77,674,9010,2021-01-18 13:56:57
9107,528,3,528,68,596,9011,2021-01-18 14:15:08
9108,12,2,659,85,744,9012,2021-01-18 19:04:49
9109,898,3,1027,133,1160,9013,2021-01-18 19:58:21
9110,741,3,647,84,731,9014,2021-01-18 05:27:53
9111,605,2,329,42,371,9015,2021-01-18 07:48:38
9112,189,2,429,55,484,9016,2021-01-17 21:51:09
9113,485,3,558,72,630,9017,2021-01-17 21:37:38
9114,137,2,598,77,675,9018,2021-01-18 12:39:49
9115,97,6,1244,161,1405,9019,2021-01-17 21:39:07
9116,748,4,1107,143,1250,9020,2021-01-18 08:39:51
9117,284,2,798,103,901,9021,2021-01-18 20:45:28
9118,161,2,698,90,788,9022,2021-01-17 19:40:25
9119,13,5,1006,130,1136,9023,2021-01-18 13:41:53
9120,842,2,429,55,484,9024,2021-01-17 19:12:08
9121,115,3,1247,162,1409,9025,2021-01-18 04:17:25
9122,125,3,1197,155,1352,9026,2021-01-18 05:27:29
9123,811,3,747,97,844,9027,2021-01-18 21:48:55
9124,504,2,459,59,518,9028,2021-01-18 19:44:42
9125,421,1,99,12,111,9029,2021-01-19 02:53:52
9126,271,3,758,98,856,9030,2021-01-19 00:25:08
9127,767,3,528,68,596,9031,2021-01-19 02:03:44
9128,475,3,847,110,957,9032,2021-01-18 21:42:56
9129,806,1,599,77,676,9033,2021-01-19 03:15:31
9130,610,3,727,94,821,9034,2021-01-18 13:40:16
9131,877,3,888,115,1003,9035,2021-01-18 11:36:29
9132,882,3,1047,136,1183,9036,2021-01-18 04:54:44
9133,374,5,1406,182,1588,9037,2021-01-19 03:04:55
9134,223,3,747,97,844,9038,2021-01-17 18:44:49
9135,824,3,927,120,1047,9039,2021-01-18 07:53:57
9136,230,1,229,29,258,9040,2021-01-18 11:05:02
9137,218,3,1327,172,1499,9041,2021-01-18 14:40:29
9138,33,2,628,81,709,9042,2021-01-18 15:16:03
9139,733,3,578,75,653,9043,2021-01-19 04:15:34
9140,801,2,459,59,518,9044,2021-01-19 00:32:48
9141,850,6,1186,154,1340,9045,2021-01-18 07:15:01
9142,337,3,888,115,1003,9046,2021-01-18 19:20:00
9143,932,2,898,116,1014,9047,2021-01-18 12:05:20
9144,718,3,578,75,653,9048,2021-01-18 08:20:50
9145,3,3,658,85,743,9049,2021-01-18 11:14:27
9146,403,2,548,71,619,9050,2021-01-17 14:07:12
9147,520,6,2124,276,2400,9051,2021-01-17 11:49:47
9148,765,3,1047,136,1183,9052,2021-01-17 14:23:06
9149,458,3,578,75,653,9053,2021-01-19 03:07:34
9150,800,5,1106,143,1249,9054,2021-01-19 00:42:22
9151,407,2,698,90,788,9055,2021-01-18 12:53:12
9152,899,1,399,51,450,9056,2021-01-19 03:23:37
9153,323,2,898,116,1014,9057,2021-01-19 07:56:07
9154,146,5,1495,194,1689,9058,2021-01-18 22:22:58
9155,787,3,1197,155,1352,9059,2021-01-18 19:04:54
9156,784,2,459,59,518,9060,2021-01-18 15:01:32
9157,360,3,997,129,1126,9061,2021-01-19 06:19:15
9158,359,3,558,72,630,9062,2021-01-19 02:40:24
9159,999,3,947,123,1070,9063,2021-01-19 07:32:51
9160,869,2,329,42,371,9064,2021-01-18 00:06:47
9161,157,3,558,72,630,9065,2021-01-18 09:08:34
9162,521,3,697,90,787,9066,2021-01-18 03:43:32
9163,521,2,498,64,562,9067,2021-01-18 11:36:58
9164,640,3,658,85,743,9068,2021-01-18 04:05:08
9165,321,5,1375,178,1553,9069,2021-01-18 09:40:15
9166,960,2,528,68,596,9070,2021-01-18 14:45:10
9167,519,3,597,77,674,9071,2021-01-18 10:11:24
9168,126,3,558,72,630,9072,2021-01-18 08:22:46
9169,1,2,598,77,675,9073,2021-01-18 00:28:09
9170,83,3,428,55,483,9074,2021-01-18 06:27:12
9171,939,3,647,84,731,9075,2021-01-19 08:15:17
9172,970,3,947,123,1070,9076,2021-01-19 07:01:27
9173,345,4,896,116,1012,9077,2021-01-19 05:37:13
9174,272,2,798,103,901,9078,2021-01-19 12:05:22
9175,6,3,1127,146,1273,9079,2021-01-19 01:36:48
9176,935,3,428,55,483,9080,2021-01-19 02:29:25
9177,366,3,658,85,743,9081,2021-01-19 04:02:51
9178,437,2,329,42,371,9082,2021-01-19 03:58:15
9179,258,3,747,97,844,9083,2021-01-18 23:56:22
9180,52,3,1247,162,1409,9084,2021-01-18 18:29:32
9181,823,2,498,64,562,9085,2021-01-18 16:27:53
9182,570,3,558,72,630,9086,2021-01-18 21:19:47
9183,197,2,498,64,562,9087,2021-01-18 20:20:25
9184,560,1,499,64,563,9088,2021-01-18 16:08:47
9185,118,3,658,85,743,9089,2021-01-18 16:02:37
9186,432,5,1856,241,2097,9090,2021-01-19 00:41:34
9187,752,1,229,29,258,9091,2021-01-19 14:02:19
9188,463,3,847,110,957,9092,2021-01-19 02:33:58
9189,867,3,897,116,1013,9093,2021-01-19 01:28:50
9190,621,4,1196,155,1351,9094,2021-01-17 22:31:48
9191,286,3,578,75,653,9095,2021-01-17 22:12:22
9192,142,2,329,42,371,9096,2021-01-18 02:16:15
9193,16,2,898,116,1014,9097,2021-01-18 00:40:56
9194,978,3,997,129,1126,9098,2021-01-18 08:41:59
9195,340,3,827,107,934,9099,2021-01-18 11:49:28
9196,44,3,647,84,731,9100,2021-01-18 17:16:44
9197,472,3,558,72,630,9101,2021-01-18 19:39:04
9198,84,3,658,85,743,9102,2021-01-18 17:40:10
9199,508,2,498,64,562,9103,2021-01-19 07:48:59
9200,595,3,428,55,483,9104,2021-01-17 14:13:47
9201,310,3,697,90,787,9105,2021-01-18 13:43:21
9202,886,3,1327,172,1499,9106,2021-01-18 17:07:37
9203,809,3,428,55,483,9107,2021-01-18 11:58:15
9204,281,2,598,77,675,9108,2021-01-18 14:34:34
9205,817,3,827,107,934,9109,2021-01-18 16:36:26
9206,427,3,927,120,1047,9110,2021-01-18 20:58:04
9207,354,6,986,128,1114,9111,2021-01-18 21:09:08
9208,809,6,1435,186,1621,9112,2021-01-18 06:35:34
9209,446,3,758,98,856,9113,2021-01-18 08:18:43
9210,514,2,329,42,371,9114,2021-01-17 23:21:17
9211,466,3,697,90,787,9115,2021-01-17 22:23:31
9212,525,2,898,116,1014,9116,2021-01-18 13:53:51
9213,848,2,548,71,619,9117,2021-01-18 00:01:33
9214,354,5,2145,278,2423,9118,2021-01-18 10:23:03
9215,414,3,827,107,934,9119,2021-01-18 22:20:39
9216,856,2,798,103,901,9120,2021-01-17 20:38:47
9217,587,2,1098,142,1240,9121,2021-01-18 16:16:43
9218,416,5,1186,154,1340,9122,2021-01-17 19:47:53
9219,515,1,599,77,676,9123,2021-01-18 06:27:51
9220,37,4,1246,161,1407,9124,2021-01-18 05:40:27
9221,427,3,558,72,630,9125,2021-01-18 22:48:53
9222,695,2,898,116,1014,9126,2021-01-18 20:21:10
9223,970,3,688,89,777,9127,2021-01-19 03:32:00
9224,613,5,1345,174,1519,9128,2021-01-19 01:12:20
9225,195,2,898,116,1014,9129,2021-01-19 02:35:02
9226,329,3,747,97,844,9130,2021-01-18 21:49:08
9227,878,3,558,72,630,9131,2021-01-19 04:23:07
9228,956,3,1127,146,1273,9132,2021-01-18 14:08:24
9229,729,2,459,59,518,9133,2021-01-18 13:39:56
9230,930,3,1197,155,1352,9134,2021-01-18 06:50:16
9231,347,3,1127,146,1273,9135,2021-01-19 04:51:24
9232,251,3,827,107,934,9136,2021-01-17 19:40:06
9233,10,3,1047,136,1183,9137,2021-01-18 09:49:55
9234,822,1,299,38,337,9138,2021-01-18 13:22:37
9235,695,3,758,98,856,9139,2021-01-18 16:06:19
9236,111,2,728,94,822,9140,2021-01-18 15:58:48
9237,492,3,528,68,596,9141,2021-01-19 04:23:31
9238,272,3,1258,163,1421,9142,2021-01-19 01:37:46
9239,303,3,727,94,821,9143,2021-01-18 07:51:41
9240,59,3,888,115,1003,9144,2021-01-18 21:50:51
9241,896,5,1045,135,1180,9145,2021-01-18 12:38:22
9242,113,3,1127,146,1273,9146,2021-01-18 08:33:33
9243,801,2,598,77,675,9147,2021-01-18 11:47:23
9244,702,3,688,89,777,9148,2021-01-17 15:02:57
9245,926,3,1247,162,1409,9149,2021-01-17 12:28:13
9246,304,3,747,97,844,9150,2021-01-17 15:30:33
9247,282,2,898,116,1014,9151,2021-01-19 04:47:27
9248,238,3,428,55,483,9152,2021-01-19 02:18:02
9249,441,2,598,77,675,9153,2021-01-18 14:13:10
9250,4,3,947,123,1070,9154,2021-01-19 04:15:33
9251,212,1,229,29,258,9155,2021-01-19 08:12:41
9252,127,3,758,98,856,9156,2021-01-19 00:43:17
9253,504,3,747,97,844,9157,2021-01-18 20:30:25
9254,768,2,1098,142,1240,9158,2021-01-18 17:15:28
9255,327,3,697,90,787,9159,2021-01-19 08:11:44
9256,332,3,927,120,1047,9160,2021-01-19 04:06:20
9257,303,3,758,98,856,9161,2021-01-19 09:04:31
9258,176,5,1326,172,1498,9162,2021-01-18 01:04:17
9259,781,2,1098,142,1240,9163,2021-01-18 09:59:48
9260,739,3,727,94,821,9164,2021-01-18 05:29:23
9261,74,3,658,85,743,9165,2021-01-18 12:45:12
9262,191,5,1456,189,1645,9166,2021-01-18 06:11:21
9263,970,3,1127,146,1273,9167,2021-01-18 11:18:51
9264,624,2,329,42,371,9168,2021-01-18 15:09:43
9265,561,5,1245,161,1406,9169,2021-01-18 12:14:32
9266,362,3,428,55,483,9170,2021-01-18 09:36:28
9267,886,2,459,59,518,9171,2021-01-18 02:39:12
9268,606,3,1127,146,1273,9172,2021-01-18 06:30:31
9269,944,2,598,77,675,9173,2021-01-19 10:14:28
9270,684,2,659,85,744,9174,2021-01-19 07:32:24
9271,432,4,1296,168,1464,9175,2021-01-19 07:56:34
9272,419,2,828,107,935,9176,2021-01-19 13:12:39
9273,43,3,808,105,913,9177,2021-01-19 04:00:25
9274,909,4,1446,187,1633,9178,2021-01-19 05:05:41
9275,682,3,997,129,1126,9179,2021-01-19 05:53:11
9276,535,3,997,129,1126,9180,2021-01-19 04:16:00
9277,121,3,808,105,913,9181,2021-01-19 02:04:35
9278,202,3,847,110,957,9182,2021-01-18 20:20:26
9279,314,3,688,89,777,9183,2021-01-18 16:36:10
9280,324,2,628,81,709,9184,2021-01-18 23:36:38
9281,882,2,498,64,562,9185,2021-01-18 21:31:40
9282,641,3,927,120,1047,9186,2021-01-18 16:31:46
9283,544,3,1047,136,1183,9187,2021-01-18 16:32:25
9284,514,3,927,120,1047,9188,2021-01-19 03:23:47
9285,600,3,597,77,674,9189,2021-01-19 16:35:39
9286,67,3,947,123,1070,9190,2021-01-19 04:39:22
9287,398,3,997,129,1126,9191,2021-01-19 02:36:00
9288,266,3,808,105,913,9192,2021-01-18 00:09:34
9289,752,2,698,90,788,9193,2021-01-18 00:29:00
9290,67,3,608,79,687,9194,2021-01-18 03:04:20
9291,418,5,1245,161,1406,9195,2021-01-18 02:36:06
9292,522,2,598,77,675,9196,2021-01-18 09:51:09
9293,228,2,598,77,675,9197,2021-01-18 13:38:12
9294,923,2,598,77,675,9198,2021-01-18 17:55:16
9295,851,3,1047,136,1183,9199,2021-01-18 22:18:30
9296,197,3,727,94,821,9200,2021-01-18 18:06:10
9297,312,3,1047,136,1183,9201,2021-01-19 08:24:41
9298,165,3,647,84,731,9202,2021-01-17 16:08:03
9299,463,1,399,51,450,9203,2021-01-18 15:13:17
9300,965,3,428,55,483,9204,2021-01-18 18:10:37
9301,387,2,898,116,1014,9205,2021-01-18 12:18:37
9302,124,3,997,129,1126,9206,2021-01-18 15:01:02
9303,362,2,1098,142,1240,9207,2021-01-18 18:09:36
9304,431,2,498,64,562,9208,2021-01-18 22:24:28
9305,760,3,1027,133,1160,9209,2021-01-18 22:01:41
9306,720,6,1805,234,2039,9210,2021-01-18 06:57:25
9307,854,3,428,55,483,9211,2021-01-18 08:19:32
9308,438,3,608,79,687,9212,2021-01-18 00:41:28
9309,736,1,699,90,789,9213,2021-01-17 23:32:38
9310,669,3,727,94,821,9214,2021-01-18 15:49:25
9311,801,2,429,55,484,9215,2021-01-18 01:02:09
9312,801,2,429,55,484,9215,2021-01-18 01:02:09
9313,662,6,2324,302,2626,9216,2021-01-18 12:48:21
9314,265,3,1047,136,1183,9217,2021-01-18 23:35:45
9315,71,6,2374,308,2682,9218,2021-01-17 21:23:35
9316,437,3,1047,136,1183,9219,2021-01-18 16:17:21
9317,896,3,947,123,1070,9220,2021-01-17 20:18:01
9318,256,3,827,107,934,9221,2021-01-18 07:29:59
9319,296,3,1047,136,1183,9222,2021-01-18 07:43:08
9320,929,5,1495,194,1689,9223,2021-01-18 23:25:49
9321,383,3,1127,146,1273,9224,2021-01-18 21:45:57
9322,371,2,898,116,1014,9225,2021-01-19 04:22:31
9323,816,2,659,85,744,9226,2021-01-19 03:43:17
9324,681,3,888,115,1003,9227,2021-01-19 02:48:30
9325,819,3,847,110,957,9228,2021-01-18 23:07:07
9326,819,3,847,110,957,9228,2021-01-18 23:07:07
9327,93,3,688,89,777,9229,2021-01-19 04:41:02
9328,727,5,1326,172,1498,9230,2021-01-18 15:23:02
9329,102,2,828,107,935,9231,2021-01-18 14:44:05
9330,787,2,628,81,709,9232,2021-01-18 08:17:12
9331,423,2,628,81,709,9233,2021-01-19 07:00:46
9332,252,2,698,90,788,9234,2021-01-17 22:24:27
9333,523,3,697,90,787,9235,2021-01-18 10:34:14
9334,101,5,2055,267,2322,9236,2021-01-18 15:05:03
9335,397,3,558,72,630,9237,2021-01-18 16:22:49
9336,934,5,1625,211,1836,9238,2021-01-18 18:42:19
9337,117,2,329,42,371,9239,2021-01-19 04:38:01
9338,979,3,827,107,934,9240,2021-01-19 02:51:59
9339,551,2,329,42,371,9241,2021-01-18 08:14:52
9340,199,2,828,107,935,9242,2021-01-19 00:10:40
9341,654,3,747,97,844,9243,2021-01-18 14:18:59
9342,948,3,428,55,483,9244,2021-01-18 10:07:25
9343,389,3,827,107,934,9245,2021-01-18 13:15:31
9344,613,3,947,123,1070,9246,2021-01-17 17:16:41
9345,31,3,897,116,1013,9247,2021-01-17 14:21:13
9346,556,3,1197,155,1352,9248,2021-01-17 17:34:09
9347,297,3,697,90,787,9249,2021-01-19 06:42:38
9348,106,3,1027,133,1160,9250,2021-01-19 02:52:27
9349,461,2,898,116,1014,9251,2021-01-18 15:06:35
9350,165,3,697,90,787,9252,2021-01-19 05:46:30
9351,220,2,429,55,484,9253,2021-01-19 10:48:39
9352,843,3,658,85,743,9254,2021-01-19 02:55:47
9353,338,2,898,116,1014,9255,2021-01-18 21:46:10
9354,258,3,597,77,674,9256,2021-01-18 18:07:01
9355,192,6,1855,241,2096,9257,2021-01-19 10:03:04
9356,360,3,808,105,913,9258,2021-01-19 06:08:24
9357,727,3,528,68,596,9259,2021-01-19 09:16:34
9358,138,3,997,129,1126,9260,2021-01-18 02:11:05
9359,665,3,797,103,900,9261,2021-01-18 11:01:38
9360,865,3,1047,136,1183,9262,2021-01-18 07:05:58
9361,877,3,758,98,856,9263,2021-01-18 14:58:57
9362,81,2,398,51,449,9264,2021-01-18 06:48:22
9363,29,5,1725,224,1949,9265,2021-01-18 13:03:34
9364,739,2,498,64,562,9266,2021-01-18 17:10:52
9365,727,3,1127,146,1273,9267,2021-01-18 12:50:35
9366,970,3,1127,146,1273,9268,2021-01-18 11:22:27
9367,225,3,697,90,787,9269,2021-01-18 04:34:22
9368,42,1,149,19,168,9270,2021-01-18 07:56:28
9369,591,3,727,94,821,9271,2021-01-19 11:03:24
9370,76,3,847,110,957,9272,2021-01-19 09:21:59
9371,676,3,927,120,1047,9273,2021-01-19 08:19:14
9372,690,3,888,115,1003,9274,2021-01-19 13:49:24
9373,508,3,697,90,787,9275,2021-01-19 05:54:52
9374,793,5,1925,250,2175,9276,2021-01-19 06:05:43
9375,655,3,727,94,821,9277,2021-01-19 06:36:38
9376,304,3,997,129,1126,9278,2021-01-19 05:28:37
9377,583,3,997,129,1126,9279,2021-01-19 04:10:32
9378,703,3,797,103,900,9280,2021-01-18 22:20:13
9379,938,3,558,72,630,9281,2021-01-18 19:01:33
9380,18,3,1197,155,1352,9282,2021-01-19 01:12:39
9381,707,3,647,84,731,9283,2021-01-18 22:06:59
9382,353,1,149,19,168,9284,2021-01-18 19:14:07
9383,874,6,1585,206,1791,9285,2021-01-18 18:46:50
9384,467,3,697,90,787,9286,2021-01-19 04:16:08
9385,434,5,1375,178,1553,9287,2021-01-19 18:58:48
9386,773,3,1247,162,1409,9288,2021-01-19 06:02:25
9387,987,3,827,107,934,9289,2021-01-19 02:54:08
9388,987,3,827,107,934,9289,2021-01-19 02:54:08
9389,160,1,229,29,258,9290,2021-01-18 00:21:32
9390,23,3,1027,133,1160,9291,2021-01-18 01:01:15
9391,292,1,149,19,168,9292,2021-01-18 04:50:30
9392,512,5,1506,195,1701,9293,2021-01-18 05:00:11
9393,938,1,399,51,450,9294,2021-01-18 11:09:36
9394,89,3,758,98,856,9295,2021-01-18 15:48:37
9395,122,2,329,42,371,9296,2021-01-18 19:00:47
9396,242,2,798,103,901,9297,2021-01-18 23:27:17
9397,212,3,697,90,787,9298,2021-01-18 19:43:00
9398,647,2,498,64,562,9299,2021-01-19 09:43:58
9399,420,3,1127,146,1273,9300,2021-01-17 17:02:13
9400,681,3,927,120,1047,9301,2021-01-18 17:21:47
9401,344,2,659,85,744,9302,2021-01-18 20:25:06
9402,275,2,459,59,518,9303,2021-01-18 14:35:15
9403,478,3,1127,146,1273,9304,2021-01-18 15:18:42
9404,508,3,947,123,1070,9305,2021-01-18 18:56:36
9405,513,3,808,105,913,9306,2021-01-18 23:26:02
9406,918,2,828,107,935,9307,2021-01-18 22:39:46
9407,565,6,1785,232,2017,9308,2021-01-18 08:52:07
9408,112,2,598,77,675,9309,2021-01-18 09:35:28
9409,507,2,659,85,744,9310,2021-01-18 02:21:08
9410,982,3,697,90,787,9311,2021-01-18 00:43:38
9411,68,2,928,120,1048,9312,2021-01-18 15:54:31
9412,913,2,628,81,709,9313,2021-01-18 03:34:30
9413,896,2,429,55,484,9314,2021-01-18 01:53:00
9414,621,6,1266,164,1430,9315,2021-01-18 12:50:01
9415,933,2,498,64,562,9316,2021-01-19 00:53:56
9416,287,5,1026,133,1159,9317,2021-01-17 22:01:39
9417,20,2,598,77,675,9318,2021-01-18 18:02:05
9418,783,3,827,107,934,9319,2021-01-17 22:02:14
9419,683,2,598,77,675,9320,2021-01-18 09:08:52
9420,647,2,659,85,744,9321,2021-01-18 08:54:51
9421,185,1,299,38,337,9322,2021-01-19 00:12:55
9422,643,3,758,98,856,9323,2021-01-18 23:16:35
9423,60,5,1325,172,1497,9324,2021-01-19 05:06:09
9424,142,6,1694,220,1914,9325,2021-01-19 05:46:10
9425,516,3,727,94,821,9326,2021-01-19 03:20:50
9426,544,3,827,107,934,9327,2021-01-19 00:09:06
9427,467,3,558,72,630,9328,2021-01-19 00:58:33
9428,648,3,847,110,957,9329,2021-01-19 06:09:24
9429,551,2,898,116,1014,9330,2021-01-18 17:27:32
9430,927,3,597,77,674,9331,2021-01-18 15:10:44
9431,382,3,1027,133,1160,9332,2021-01-18 09:18:20
9432,165,3,1127,146,1273,9333,2021-01-19 07:53:20
9433,970,2,459,59,518,9334,2021-01-17 23:24:24
9434,308,2,498,64,562,9335,2021-01-18 13:11:05
9435,339,5,1276,165,1441,9336,2021-01-18 17:41:00
9436,863,2,698,90,788,9337,2021-01-18 18:46:06
9437,267,3,827,107,934,9338,2021-01-18 20:24:36
9438,441,3,1047,136,1183,9339,2021-01-19 07:10:38
9439,441,3,1047,136,1183,9339,2021-01-19 07:10:38
9440,101,6,1574,204,1778,9340,2021-01-19 05:20:55
9441,728,3,1027,133,1160,9341,2021-01-18 08:17:13
9442,190,1,99,12,111,9342,2021-01-19 00:54:50
9443,12,3,558,72,630,9343,2021-01-18 16:56:59
9444,61,3,578,75,653,9344,2021-01-18 12:01:12
9445,269,5,1356,176,1532,9345,2021-01-18 14:34:04
9446,261,3,688,89,777,9346,2021-01-17 17:21:57
9447,886,3,578,75,653,9347,2021-01-17 16:53:01
9448,554,2,898,116,1014,9348,2021-01-17 17:39:32
9449,833,2,548,71,619,9349,2021-01-19 07:43:44
9450,758,4,1226,159,1385,9350,2021-01-19 04:39:56
9451,907,3,997,129,1126,9351,2021-01-18 15:49:55
9452,705,2,398,51,449,9352,2021-01-19 07:29:00
9453,841,2,798,103,901,9353,2021-01-19 12:03:57
9454,215,5,1286,167,1453,9354,2021-01-19 04:28:03
9455,92,1,149,19,168,9355,2021-01-18 22:17:29
9456,911,3,927,120,1047,9356,2021-01-18 19:10:41
9457,812,3,578,75,653,9357,2021-01-19 10:50:45
9458,647,3,997,129,1126,9358,2021-01-19 07:56:45
9459,801,3,528,68,596,9359,2021-01-19 10:01:40
9460,472,2,498,64,562,9360,2021-01-18 04:44:18
9461,792,3,758,98,856,9361,2021-01-18 13:09:19
9462,649,4,1107,143,1250,9362,2021-01-18 09:13:38
9463,307,4,926,120,1046,9363,2021-01-18 15:23:03
9464,882,3,888,115,1003,9364,2021-01-18 08:23:34
9465,780,3,647,84,731,9365,2021-01-18 15:31:34
9466,44,3,808,105,913,9366,2021-01-18 19:09:04
9467,104,5,1725,224,1949,9367,2021-01-18 15:02:46
9468,960,2,798,103,901,9368,2021-01-18 13:25:57
9469,663,3,758,98,856,9369,2021-01-18 04:58:01
9470,381,2,659,85,744,9370,2021-01-18 10:42:55
9471,123,2,698,90,788,9371,2021-01-19 11:38:36
9472,432,3,888,115,1003,9372,2021-01-19 09:50:53
9473,849,2,898,116,1014,9373,2021-01-19 08:56:15
9474,289,3,428,55,483,9374,2021-01-19 14:58:02
9475,131,3,658,85,743,9375,2021-01-19 08:17:08
9476,28,3,847,110,957,9376,2021-01-19 06:46:52
9477,783,3,697,90,787,9377,2021-01-19 08:32:44
9478,176,3,727,94,821,9378,2021-01-19 07:58:57
9479,74,3,1327,172,1499,9379,2021-01-19 06:12:31
9480,504,3,808,105,913,9380,2021-01-18 22:37:16
9481,118,3,888,115,1003,9381,2021-01-18 21:07:17
9482,653,3,947,123,1070,9382,2021-01-19 02:21:56
9483,35,1,499,64,563,9383,2021-01-19 00:16:11
9484,845,3,558,72,630,9384,2021-01-18 21:33:16
9485,33,1,149,19,168,9385,2021-01-18 19:16:43
9486,77,2,429,55,484,9386,2021-01-19 06:49:53
9487,234,3,758,98,856,9387,2021-01-19 20:11:37
9488,740,2,1098,142,1240,9388,2021-01-19 06:43:27
9489,27,1,399,51,450,9389,2021-01-19 03:26:36
9490,718,2,898,116,1014,9390,2021-01-19 04:35:15
9491,440,2,1098,142,1240,9391,2021-01-18 01:48:42
9492,13,1,99,12,111,9392,2021-01-18 01:23:44
9493,485,3,947,123,1070,9393,2021-01-18 06:15:56
9494,917,3,1127,146,1273,9394,2021-01-18 05:07:36
9495,891,2,598,77,675,9395,2021-01-18 12:08:55
9496,236,2,1098,142,1240,9396,2021-01-18 16:02:11
9497,531,2,698,90,788,9397,2021-01-18 20:18:27
9498,894,2,498,64,562,9398,2021-01-19 01:14:01
9499,133,3,797,103,900,9399,2021-01-18 20:09:27
9500,969,6,1385,180,1565,9400,2021-01-19 11:51:51
9501,898,2,659,85,744,9401,2021-01-17 17:23:03
9502,222,5,1725,224,1949,9402,2021-01-18 17:26:39
9503,844,6,2324,302,2626,9403,2021-01-18 20:55:39
9504,358,3,1327,172,1499,9404,2021-01-18 15:18:34
9505,98,4,1226,159,1385,9405,2021-01-18 17:53:28
9506,415,2,1098,142,1240,9406,2021-01-18 20:20:48
9507,311,3,1247,162,1409,9407,2021-01-19 02:08:02
9508,355,4,1307,169,1476,9408,2021-01-18 23:00:00
9509,132,3,747,97,844,9409,2021-01-18 09:57:56
9510,104,2,828,107,935,9410,2021-01-18 12:15:48
9511,920,3,1047,136,1183,9411,2021-01-18 04:10:42
9512,968,3,847,110,957,9412,2021-01-18 01:29:11
9513,942,2,429,55,484,9413,2021-01-18 17:59:48
9514,495,3,558,72,630,9414,2021-01-18 04:22:00
9515,724,3,747,97,844,9415,2021-01-18 04:20:20
9516,718,5,1745,226,1971,9416,2021-01-18 12:54:08
9517,682,3,1247,162,1409,9417,2021-01-19 02:33:35
9518,318,2,898,116,1014,9418,2021-01-17 23:37:41
9519,251,2,429,55,484,9419,2021-01-18 19:59:27
9520,944,3,797,103,900,9420,2021-01-18 00:01:26
9521,207,3,747,97,844,9421,2021-01-18 11:30:24
9522,909,3,647,84,731,9422,2021-01-18 10:46:43
9523,621,3,727,94,821,9423,2021-01-19 00:48:55
9524,384,3,758,98,856,9424,2021-01-19 02:01:55
9525,713,5,1755,228,1983,9425,2021-01-19 07:21:59
9526,979,3,697,90,787,9426,2021-01-19 08:06:56
9527,270,3,997,129,1126,9427,2021-01-19 06:01:22
9528,117,2,429,55,484,9428,2021-01-19 00:16:58
9529,778,2,598,77,675,9429,2021-01-19 02:51:32
9530,534,3,688,89,777,9430,2021-01-19 07:43:17
9531,236,2,598,77,675,9431,2021-01-18 17:41:35
9532,763,3,697,90,787,9432,2021-01-18 16:51:57
9533,971,3,1197,155,1352,9433,2021-01-18 10:34:45
9534,129,2,898,116,1014,9434,2021-01-19 10:13:36
9535,889,3,597,77,674,9435,2021-01-18 01:40:41
9536,905,3,927,120,1047,9436,2021-01-18 13:50:19
9537,288,2,659,85,744,9437,2021-01-18 18:25:51
9538,339,3,897,116,1013,9438,2021-01-18 20:42:39
9539,733,2,459,59,518,9439,2021-01-18 20:33:30
9540,669,3,808,105,913,9440,2021-01-19 09:25:54
9541,847,2,698,90,788,9441,2021-01-19 07:51:35
9542,743,3,727,94,821,9442,2021-01-19 07:39:08
9543,380,3,997,129,1126,9443,2021-01-18 10:56:43
9544,755,3,608,79,687,9444,2021-01-19 01:57:29
9545,569,2,598,77,675,9445,2021-01-18 17:10:35
9546,225,3,658,85,743,9446,2021-01-18 12:59:26
9547,399,3,658,85,743,9447,2021-01-18 16:47:02
9548,26,3,1127,146,1273,9448,2021-01-17 17:23:19
9549,395,3,697,90,787,9449,2021-01-17 18:52:49
9550,698,3,1047,136,1183,9450,2021-01-17 20:11:03
9551,698,3,1047,136,1183,9450,2021-01-17 20:11:03
9552,723,3,1047,136,1183,9451,2021-01-19 09:51:10
9553,329,2,548,71,619,9452,2021-01-19 05:51:23
9554,947,3,478,62,540,9453,2021-01-18 15:53:35
9555,101,4,1246,161,1407,9454,2021-01-19 08:06:55
9556,348,3,1197,155,1352,9455,2021-01-19 12:44:02
9557,191,3,1247,162,1409,9456,2021-01-19 05:40:36
9558,452,3,1127,146,1273,9457,2021-01-19 00:18:37
9559,287,2,748,97,845,9458,2021-01-18 20:46:11
9560,391,3,558,72,630,9459,2021-01-19 12:09:17
9561,372,3,827,107,934,9460,2021-01-19 08:20:38
9562,650,3,797,103,900,9461,2021-01-19 10:29:48
9563,565,3,697,90,787,9462,2021-01-18 06:52:14
9564,775,3,558,72,630,9463,2021-01-18 13:11:06
9565,56,3,927,120,1047,9464,2021-01-18 10:33:57
9566,371,2,548,71,619,9465,2021-01-18 16:21:13
9567,619,3,897,116,1013,9466,2021-01-18 10:01:03
9568,840,2,898,116,1014,9467,2021-01-18 17:26:13
9569,368,2,598,77,675,9468,2021-01-18 19:45:28
9570,237,3,1127,146,1273,9469,2021-01-18 15:09:22
9571,757,2,429,55,484,9470,2021-01-18 14:10:04
9572,565,3,478,62,540,9471,2021-01-18 07:32:42
9573,454,6,1305,169,1474,9472,2021-01-18 11:41:42
9574,825,3,1247,162,1409,9473,2021-01-19 13:23:09
9575,241,1,399,51,450,9474,2021-01-19 10:03:57
9576,858,4,1057,137,1194,9475,2021-01-19 09:52:53
9577,850,2,598,77,675,9476,2021-01-19 15:04:28
9578,735,2,828,107,935,9477,2021-01-19 10:29:08
9579,971,3,947,123,1070,9478,2021-01-19 07:26:36
9580,298,2,659,85,744,9479,2021-01-19 09:05:43
9581,487,3,1127,146,1273,9480,2021-01-19 10:40:21
9582,791,3,888,115,1003,9481,2021-01-19 06:54:05
9583,401,5,1245,161,1406,9482,2021-01-18 23:51:05
9584,146,3,578,75,653,9483,2021-01-18 21:30:00
9585,39,3,747,97,844,9484,2021-01-19 05:04:48
9586,997,3,897,116,1013,9485,2021-01-19 01:26:58
9587,158,3,647,84,731,9486,2021-01-18 22:59:30
9588,991,3,558,72,630,9487,2021-01-18 20:11:37
9589,401,3,1047,136,1183,9488,2021-01-19 08:38:27
9590,775,4,1746,226,1972,9489,2021-01-19 20:46:38
9591,761,1,699,90,789,9490,2021-01-19 07:41:06
9592,374,3,1327,172,1499,9491,2021-01-19 06:05:33
9593,795,2,1098,142,1240,9492,2021-01-19 06:50:18
9594,237,2,459,59,518,9493,2021-01-18 03:26:36
9595,50,3,947,123,1070,9494,2021-01-18 01:44:20
9596,50,3,947,123,1070,9494,2021-01-18 01:44:20
9597,812,2,548,71,619,9495,2021-01-18 06:41:21
9598,588,3,797,103,900,9496,2021-01-18 07:17:23
9599,290,3,1197,155,1352,9497,2021-01-18 13:39:46
9600,653,2,498,64,562,9498,2021-01-18 16:04:07
9601,318,5,1825,237,2062,9499,2021-01-18 20:34:13
9602,420,3,727,94,821,9500,2021-01-19 01:41:28
9603,347,3,578,75,653,9501,2021-01-18 20:36:57
9604,640,3,997,129,1126,9502,2021-01-19 13:30:18
9605,732,3,827,107,934,9503,2021-01-17 18:36:56
9606,359,2,598,77,675,9504,2021-01-18 19:47:28
9607,865,2,329,42,371,9505,2021-01-18 21:07:11
9608,403,3,1327,172,1499,9506,2021-01-18 17:47:11
9609,473,3,647,84,731,9507,2021-01-18 19:11:23
9610,39,3,827,107,934,9508,2021-01-18 21:55:53
9611,618,2,898,116,1014,9509,2021-01-19 02:40:47
9612,890,3,1327,172,1499,9510,2021-01-18 23:52:47
9613,547,3,558,72,630,9511,2021-01-18 11:13:47
9614,238,4,1446,187,1633,9512,2021-01-18 13:54:08
9615,202,2,1098,142,1240,9513,2021-01-18 04:34:26
9616,588,1,229,29,258,9514,2021-01-18 02:22:43
9617,361,5,1445,187,1632,9515,2021-01-18 18:30:57
9618,390,3,1127,146,1273,9516,2021-01-18 04:31:57
9619,721,3,1127,146,1273,9517,2021-01-18 06:46:14
9620,590,2,698,90,788,9518,2021-01-18 13:20:38
9621,487,2,898,116,1014,9519,2021-01-19 04:10:42
9622,662,3,1197,155,1352,9520,2021-01-18 01:20:57
9623,554,3,808,105,913,9521,2021-01-18 20:01:42
9624,380,3,597,77,674,9522,2021-01-18 01:31:02
9625,234,3,558,72,630,9523,2021-01-18 11:40:48
9626,831,1,229,29,258,9524,2021-01-18 12:22:18
9627,861,3,558,72,630,9525,2021-01-19 01:53:29
9628,847,3,478,62,540,9526,2021-01-19 02:58:15
9629,890,2,598,77,675,9527,2021-01-19 10:07:54
9630,403,3,947,123,1070,9528,2021-01-19 08:57:53
9631,403,3,947,123,1070,9528,2021-01-19 08:57:53
9632,877,3,947,123,1070,9529,2021-01-19 08:24:22
9633,222,2,459,59,518,9530,2021-01-19 01:25:29
9634,286,2,798,103,901,9531,2021-01-19 05:15:21
9635,669,3,697,90,787,9532,2021-01-19 09:00:29
9636,696,4,1696,220,1916,9533,2021-01-18 17:45:54
9637,899,5,1395,181,1576,9534,2021-01-18 18:54:05
9638,82,2,798,103,901,9535,2021-01-18 13:14:43
9639,159,3,747,97,844,9536,2021-01-19 10:41:07
9640,360,2,598,77,675,9537,2021-01-18 02:39:58
9641,174,3,947,123,1070,9538,2021-01-18 15:49:20
9642,759,5,1445,187,1632,9539,2021-01-18 19:15:17
9643,852,3,888,115,1003,9540,2021-01-18 21:47:58
9644,619,3,658,85,743,9541,2021-01-18 22:13:18
9645,592,5,1616,210,1826,9542,2021-01-19 11:37:26
9646,941,4,857,111,968,9543,2021-01-19 08:57:23
9647,408,5,1845,239,2084,9544,2021-01-19 08:37:08
9648,143,3,558,72,630,9545,2021-01-18 12:57:49
9649,978,3,578,75,653,9546,2021-01-19 02:47:54
9650,736,3,558,72,630,9547,2021-01-18 17:36:21
9651,992,2,459,59,518,9548,2021-01-18 15:36:24
9652,601,3,747,97,844,9549,2021-01-18 18:52:42
9653,747,2,1098,142,1240,9550,2021-01-17 19:08:59
9654,955,3,1127,146,1273,9551,2021-01-17 19:51:16
9655,634,2,798,103,901,9552,2021-01-17 22:16:15
9656,472,3,727,94,821,9553,2021-01-17 21:44:07
9657,844,3,1127,146,1273,9554,2021-01-19 10:50:09
9658,149,4,1077,140,1217,9555,2021-01-19 06:19:59
9659,493,2,498,64,562,9556,2021-01-18 16:01:55
9660,824,3,578,75,653,9557,2021-01-19 10:26:17
9661,659,2,798,103,901,9558,2021-01-19 13:41:42
9662,290,2,598,77,675,9559,2021-01-19 06:09:17
9663,683,3,1247,162,1409,9560,2021-01-19 00:51:31
9664,818,2,898,116,1014,9561,2021-01-18 21:12:28
9665,657,3,478,62,540,9562,2021-01-19 14:02:29
9666,452,3,1047,136,1183,9563,2021-01-19 10:27:57
9667,670,3,727,94,821,9564,2021-01-19 13:05:27
9668,107,2,1098,142,1240,9565,2021-01-18 06:58:35
9669,58,3,888,115,1003,9566,2021-01-18 13:41:26
9670,449,3,1247,162,1409,9567,2021-01-18 12:46:05
9671,583,3,1247,162,1409,9568,2021-01-18 17:52:48
9672,450,5,1245,161,1406,9569,2021-01-18 11:52:01
9673,879,3,1347,175,1522,9570,2021-01-18 19:18:09
9674,742,3,528,68,596,9571,2021-01-18 20:11:53
9675,60,2,659,85,744,9572,2021-01-18 16:13:25
9676,730,3,747,97,844,9573,2021-01-18 15:57:07
9677,122,3,1127,146,1273,9574,2021-01-18 07:57:26
9678,522,3,647,84,731,9575,2021-01-18 12:57:44
9679,182,2,898,116,1014,9576,2021-01-19 13:52:17
9680,482,1,299,38,337,9577,2021-01-19 10:08:16
9681,973,3,478,62,540,9578,2021-01-19 12:09:54
9682,203,2,429,55,484,9579,2021-01-19 15:28:09
9683,573,3,888,115,1003,9580,2021-01-19 11:35:33
9684,832,3,797,103,900,9581,2021-01-19 08:25:37
9685,36,3,888,115,1003,9582,2021-01-19 09:24:14
9686,137,5,1095,142,1237,9583,2021-01-19 12:57:15
9687,608,2,898,116,1014,9584,2021-01-19 08:41:00
9688,824,3,558,72,630,9585,2021-01-19 00:01:08
9689,343,2,429,55,484,9586,2021-01-18 22:53:36
9690,533,2,448,58,506,9587,2021-01-19 05:56:50
9691,694,3,597,77,674,9588,2021-01-19 03:07:03
9692,294,3,1197,155,1352,9589,2021-01-18 23:25:24
9693,437,3,578,75,653,9590,2021-01-18 20:51:40
9694,634,2,498,64,562,9591,2021-01-19 09:25:30
9695,512,3,1197,155,1352,9592,2021-01-19 23:01:10
9696,528,2,498,64,562,9593,2021-01-19 09:24:17
9697,584,3,997,129,1126,9594,2021-01-19 07:57:30
9698,757,3,1047,136,1183,9595,2021-01-19 07:26:18
9699,218,3,478,62,540,9596,2021-01-18 05:49:14
9700,711,3,927,120,1047,9597,2021-01-18 03:47:28
9701,883,5,1506,195,1701,9598,2021-01-18 01:53:08
9702,16,1,599,77,676,9599,2021-01-18 08:58:07
9703,355,5,1295,168,1463,9600,2021-01-18 07:32:59
9704,820,4,1296,168,1464,9601,2021-01-18 14:49:37
9705,125,3,658,85,743,9602,2021-01-18 17:09:40
9706,385,3,478,62,540,9603,2021-01-18 21:19:06
9707,622,3,558,72,630,9604,2021-01-19 03:00:35
9708,176,3,697,90,787,9605,2021-01-18 23:18:14
9709,672,3,997,129,1126,9606,2021-01-19 16:12:11
9710,190,1,99,12,111,9607,2021-01-17 18:51:36
9711,737,2,429,55,484,9608,2021-01-18 20:58:16
9712,50,3,927,120,1047,9609,2021-01-18 21:49:34
9713,40,3,1047,136,1183,9610,2021-01-18 18:34:00
9714,443,2,628,81,709,9611,2021-01-18 20:14:29
9715,549,2,498,64,562,9612,2021-01-18 22:05:47
9716,786,3,808,105,913,9613,2021-01-19 03:03:08
9717,625,2,659,85,744,9614,2021-01-19 00:04:04
9718,578,1,229,29,258,9615,2021-01-18 11:54:57
9719,825,3,658,85,743,9616,2021-01-18 15:26:24
9720,340,2,698,90,788,9617,2021-01-18 06:08:16
9721,15,3,597,77,674,9618,2021-01-18 04:22:27
9722,722,3,927,120,1047,9619,2021-01-18 18:57:59
9723,83,2,598,77,675,9620,2021-01-18 04:50:00
9724,8,6,2024,263,2287,9621,2021-01-18 06:51:07
9725,972,3,808,105,913,9622,2021-01-18 13:47:09
9726,804,5,1845,239,2084,9623,2021-01-19 04:54:24
9727,996,2,498,64,562,9624,2021-01-18 01:31:37
9728,728,3,647,84,731,9625,2021-01-18 22:17:33
9729,835,4,1057,137,1194,9626,2021-01-18 03:47:16
9730,157,3,1327,172,1499,9627,2021-01-18 12:54:12
9731,996,2,698,90,788,9628,2021-01-18 12:45:23
9732,655,2,1098,142,1240,9629,2021-01-19 03:07:51
9733,206,3,847,110,957,9630,2021-01-19 05:26:00
9734,818,3,697,90,787,9631,2021-01-19 10:39:40
9735,192,3,747,97,844,9632,2021-01-19 10:48:35
9736,449,3,578,75,653,9633,2021-01-19 10:42:39
9737,588,2,598,77,675,9634,2021-01-19 10:52:36
9738,164,3,1247,162,1409,9635,2021-01-19 02:22:01
9739,473,2,429,55,484,9636,2021-01-19 07:24:48
9740,226,5,1286,167,1453,9637,2021-01-19 11:41:43
9741,487,3,578,75,653,9638,2021-01-18 18:59:48
9742,427,3,758,98,856,9639,2021-01-18 19:30:14
9743,819,3,747,97,844,9640,2021-01-18 13:44:10
9744,442,5,1656,215,1871,9641,2021-01-19 11:43:56
9745,280,2,659,85,744,9642,2021-01-18 05:26:00
9746,229,5,1595,207,1802,9643,2021-01-18 16:18:16
9747,106,2,1098,142,1240,9644,2021-01-18 20:03:17
9748,992,4,1546,200,1746,9645,2021-01-18 23:39:00
9749,548,2,1098,142,1240,9646,2021-01-18 23:11:31
9750,329,5,1545,200,1745,9647,2021-01-19 12:44:11
9751,572,3,888,115,1003,9648,2021-01-19 10:53:47
9752,18,3,597,77,674,9649,2021-01-19 08:49:52
9753,50,3,1197,155,1352,9650,2021-01-18 15:30:37
9754,543,1,499,64,563,9651,2021-01-19 04:55:28
9755,466,4,1207,156,1363,9652,2021-01-18 18:50:38
9756,80,3,997,129,1126,9653,2021-01-18 17:17:31
9757,701,2,628,81,709,9654,2021-01-18 20:02:08
9758,455,2,659,85,744,9655,2021-01-17 21:30:14
9759,866,4,1526,198,1724,9656,2021-01-17 21:41:39
9760,81,5,1895,246,2141,9657,2021-01-18 00:08:37
9761,814,3,997,129,1126,9658,2021-01-17 23:17:09
9762,116,3,847,110,957,9659,2021-01-19 10:57:00
9763,976,2,898,116,1014,9660,2021-01-19 08:22:06
9764,418,3,647,84,731,9661,2021-01-18 16:31:01
9765,658,3,897,116,1013,9662,2021-01-19 12:26:34
9766,47,6,2074,269,2343,9663,2021-01-19 16:17:04
9767,41,6,1724,224,1948,9664,2021-01-19 08:13:49
9768,258,3,558,72,630,9665,2021-01-19 03:03:41
9769,224,2,1098,142,1240,9666,2021-01-18 22:01:36
9770,415,3,888,115,1003,9667,2021-01-19 15:08:26
9771,239,3,1127,146,1273,9668,2021-01-19 10:43:14
9772,404,2,748,97,845,9669,2021-01-19 14:19:04
9773,853,2,598,77,675,9670,2021-01-18 08:37:04
9774,22,2,628,81,709,9671,2021-01-18 14:51:24
9775,788,3,1127,146,1273,9672,2021-01-18 14:25:28
9776,115,3,1327,172,1499,9673,2021-01-18 18:01:39
9777,327,6,1835,238,2073,9674,2021-01-18 12:39:07
9778,661,2,459,59,518,9675,2021-01-18 20:26:11
9779,278,2,798,103,901,9676,2021-01-18 21:50:53
9780,416,2,429,55,484,9677,2021-01-18 17:34:39
9781,829,3,647,84,731,9678,2021-01-18 18:08:30
9782,209,3,997,129,1126,9679,2021-01-18 08:04:23
9783,223,2,598,77,675,9680,2021-01-18 13:05:44
9784,336,2,898,116,1014,9681,2021-01-19 14:27:01
9785,345,6,1515,196,1711,9682,2021-01-19 11:18:40
9786,908,3,997,129,1126,9683,2021-01-19 14:19:14
9787,941,5,1556,202,1758,9684,2021-01-19 15:53:49
9788,612,1,599,77,676,9685,2021-01-19 11:45:57
9789,162,1,299,38,337,9686,2021-01-19 09:57:27
9790,677,2,848,110,958,9687,2021-01-19 11:55:57
9791,903,3,1047,136,1183,9688,2021-01-19 14:22:19
9792,947,3,597,77,674,9689,2021-01-19 09:32:01
9793,964,2,598,77,675,9690,2021-01-19 00:01:22
9794,831,5,1425,185,1610,9691,2021-01-18 23:38:38
9795,608,2,329,42,371,9692,2021-01-19 07:21:12
9796,220,3,528,68,596,9693,2021-01-19 03:55:52
9797,79,2,429,55,484,9694,2021-01-19 00:13:03
9798,470,2,498,64,562,9695,2021-01-18 23:34:18
9799,600,1,399,51,450,9696,2021-01-19 09:28:00
9800,477,3,727,94,821,9697,2021-01-20 01:22:21
9801,148,3,947,123,1070,9698,2021-01-19 09:55:45
9802,356,3,478,62,540,9699,2021-01-19 08:15:00
9803,40,3,808,105,913,9700,2021-01-19 09:39:47
9804,357,6,1685,219,1904,9701,2021-01-18 07:44:56
9805,38,2,498,64,562,9702,2021-01-18 05:05:34
9806,154,3,478,62,540,9703,2021-01-18 04:00:16
9807,790,3,727,94,821,9704,2021-01-18 10:35:21
9808,270,2,698,90,788,9705,2021-01-18 09:39:54
9809,636,3,578,75,653,9706,2021-01-18 15:26:48
9810,946,2,598,77,675,9707,2021-01-18 17:53:10
9811,654,1,229,29,258,9708,2021-01-18 23:01:57
9812,68,3,688,89,777,9709,2021-01-19 03:32:44
9813,404,2,429,55,484,9710,2021-01-19 00:04:47
9814,387,3,1127,146,1273,9711,2021-01-19 18:35:35
9815,825,3,647,84,731,9712,2021-01-17 19:31:08
9816,272,3,697,90,787,9713,2021-01-18 23:27:39
9817,532,3,578,75,653,9714,2021-01-18 23:51:59
9818,361,5,1575,204,1779,9715,2021-01-18 21:02:17
9819,165,3,688,89,777,9716,2021-01-18 21:44:51
9820,926,3,1247,162,1409,9717,2021-01-19 00:36:50
9821,809,2,898,116,1014,9718,2021-01-19 05:42:11
9822,681,2,329,42,371,9719,2021-01-19 00:44:08
9823,24,3,1247,162,1409,9720,2021-01-18 13:50:49
9824,716,2,598,77,675,9721,2021-01-18 17:11:26
9825,175,4,1146,148,1294,9722,2021-01-18 06:26:50
9826,423,2,1098,142,1240,9723,2021-01-18 06:55:44
9827,832,4,1546,200,1746,9724,2021-01-18 21:28:37
9828,933,3,608,79,687,9725,2021-01-18 07:17:36
9829,821,3,528,68,596,9726,2021-01-18 08:28:28
9830,283,3,797,103,900,9727,2021-01-18 15:27:33
9831,329,3,827,107,934,9728,2021-01-19 06:36:02
9832,222,2,628,81,709,9729,2021-01-18 03:49:26
9833,165,4,1277,166,1443,9730,2021-01-19 01:02:38
9834,553,4,956,124,1080,9731,2021-01-18 05:43:01
9835,39,3,758,98,856,9732,2021-01-18 13:52:46
9836,309,3,1327,172,1499,9733,2021-01-18 14:38:16
9837,578,3,658,85,743,9734,2021-01-19 03:35:30
9838,90,3,558,72,630,9735,2021-01-19 06:44:45
9839,61,2,898,116,1014,9736,2021-01-19 13:13:43
9840,425,2,659,85,744,9737,2021-01-19 11:55:00
9841,108,3,1027,133,1160,9738,2021-01-19 12:30:14
9842,550,2,1098,142,1240,9739,2021-01-19 12:13:12
9843,599,3,597,77,674,9740,2021-01-19 02:25:07
9844,865,3,647,84,731,9741,2021-01-19 08:48:12
9845,253,3,558,72,630,9742,2021-01-19 14:14:28
9846,953,2,659,85,744,9743,2021-01-18 21:25:59
9847,403,3,558,72,630,9744,2021-01-18 20:58:14
9848,395,3,697,90,787,9745,2021-01-18 13:53:34
9849,163,4,1746,226,1972,9746,2021-01-19 12:22:40
9850,391,3,1047,136,1183,9747,2021-01-18 06:13:10
9851,4,3,888,115,1003,9748,2021-01-18 16:24:47
9852,0,3,1047,136,1183,9749,2021-01-18 20:10:27
9853,863,3,1047,136,1183,9750,2021-01-19 00:10:20
9854,606,2,898,116,1014,9751,2021-01-19 01:04:32
9855,658,3,428,55,483,9752,2021-01-19 15:16:55
9856,95,2,698,90,788,9753,2021-01-19 11:00:41
9857,898,2,459,59,518,9754,2021-01-19 11:09:06
9858,107,3,558,72,630,9755,2021-01-18 17:35:10
9859,70,3,658,85,743,9756,2021-01-19 05:01:01
9860,664,2,898,116,1014,9757,2021-01-18 21:00:52
9861,98,3,558,72,630,9758,2021-01-18 18:32:38
9862,183,6,1585,206,1791,9759,2021-01-18 20:26:14
9863,245,2,698,90,788,9760,2021-01-17 23:56:06
9864,918,4,1196,155,1351,9761,2021-01-17 23:08:51
9865,640,3,797,103,900,9762,2021-01-18 01:34:31
9866,928,3,608,79,687,9763,2021-01-18 01:29:45
9867,930,2,648,84,732,9764,2021-01-19 12:36:25
9868,350,2,1098,142,1240,9765,2021-01-19 09:25:45
9869,955,2,898,116,1014,9766,2021-01-18 17:39:43
9870,623,3,1027,133,1160,9767,2021-01-19 14:37:32
9871,971,1,499,64,563,9768,2021-01-19 16:54:44
9872,288,3,1047,136,1183,9769,2021-01-19 10:03:51
9873,809,3,727,94,821,9770,2021-01-19 03:49:24
9874,100,3,747,97,844,9771,2021-01-18 23:12:52
9875,197,3,558,72,630,9772,2021-01-19 15:33:35
9876,943,2,798,103,901,9773,2021-01-19 13:12:36
9877,9,3,688,89,777,9774,2021-01-19 16:10:56
9878,268,3,997,129,1126,9775,2021-01-18 08:51:21
9879,360,2,329,42,371,9776,2021-01-18 16:03:44
9880,476,2,898,116,1014,9777,2021-01-18 15:49:57
9881,336,5,1755,228,1983,9778,2021-01-18 20:38:57
9882,222,3,578,75,653,9779,2021-01-18 15:14:00
9883,909,3,808,105,913,9780,2021-01-18 20:45:55
9884,672,5,1276,165,1441,9781,2021-01-18 23:02:04
9885,279,6,2024,263,2287,9782,2021-01-18 18:53:51
9886,976,2,498,64,562,9783,2021-01-18 19:08:25
9887,979,1,99,12,111,9784,2021-01-18 10:10:06
9888,905,3,827,107,934,9785,2021-01-18 15:43:12
9889,294,3,1047,136,1183,9786,2021-01-19 15:24:12
9890,787,2,659,85,744,9787,2021-01-19 13:34:15
9891,670,3,528,68,596,9788,2021-01-19 15:50:20
9892,411,3,1247,162,1409,9789,2021-01-19 17:50:21
9893,24,3,608,79,687,9790,2021-01-19 12:37:23
9894,237,3,1027,133,1160,9791,2021-01-19 12:39:37
9895,330,2,498,64,562,9792,2021-01-19 13:17:33
9896,330,2,498,64,562,9792,2021-01-19 13:17:33
9897,238,2,429,55,484,9793,2021-01-19 16:35:26
9898,24,3,1127,146,1273,9794,2021-01-19 11:09:47
9899,225,2,459,59,518,9795,2021-01-19 02:37:00
9900,230,2,598,77,675,9796,2021-01-19 00:59:09
9901,575,4,1407,182,1589,9797,2021-01-19 08:46:51
9902,584,3,897,116,1013,9798,2021-01-19 06:16:05
9903,808,1,149,19,168,9799,2021-01-19 02:00:49
9904,783,2,1098,142,1240,9800,2021-01-18 23:55:26
9905,131,3,528,68,596,9801,2021-01-19 09:39:13
9906,802,6,2124,276,2400,9802,2021-01-20 02:30:37
9907,237,3,808,105,913,9803,2021-01-19 11:26:33
9908,525,2,528,68,596,9804,2021-01-19 09:50:31
9909,824,4,827,107,934,9805,2021-01-19 09:45:58
9910,778,2,648,84,732,9806,2021-01-18 10:09:07
9911,867,6,1125,146,1271,9807,2021-01-18 06:35:47
9912,118,3,558,72,630,9808,2021-01-18 04:32:49
9913,107,2,498,64,562,9809,2021-01-18 11:10:57
9914,875,2,598,77,675,9810,2021-01-18 09:46:41
9915,120,2,548,71,619,9811,2021-01-18 17:01:02
9916,768,2,728,94,822,9812,2021-01-18 18:45:55
9917,905,6,2294,298,2592,9813,2021-01-18 23:09:12
9918,411,2,429,55,484,9814,2021-01-19 05:21:45
9919,403,3,747,97,844,9815,2021-01-19 01:08:07
9920,84,3,997,129,1126,9816,2021-01-19 19:24:00
9921,294,3,697,90,787,9817,2021-01-17 20:41:15
9922,188,2,528,68,596,9818,2021-01-19 01:24:20
9923,939,3,597,77,674,9819,2021-01-19 02:09:46
9924,741,2,329,42,371,9820,2021-01-18 23:43:37
9925,307,2,928,120,1048,9821,2021-01-18 23:03:05
9926,379,3,528,68,596,9822,2021-01-19 02:27:54
9927,772,6,1755,228,1983,9823,2021-01-19 07:02:30
9928,774,2,429,55,484,9824,2021-01-19 00:53:08
9929,413,3,897,116,1013,9825,2021-01-18 15:29:36
9930,951,2,898,116,1014,9826,2021-01-18 19:49:31
9931,647,3,478,62,540,9827,2021-01-18 09:11:16
9932,429,3,597,77,674,9828,2021-01-18 08:08:18
9933,372,3,697,90,787,9829,2021-01-18 23:04:46
9934,886,3,808,105,913,9830,2021-01-18 09:39:50
9935,722,2,498,64,562,9831,2021-01-18 09:38:34
9936,653,2,898,116,1014,9832,2021-01-18 17:55:34
9937,647,3,1197,155,1352,9833,2021-01-19 08:00:47
9938,319,1,499,64,563,9834,2021-01-18 05:13:24
9939,224,1,699,90,789,9835,2021-01-19 03:31:40
9940,840,1,599,77,676,9836,2021-01-18 05:55:55
9941,115,3,888,115,1003,9837,2021-01-18 14:17:25
9942,543,2,659,85,744,9838,2021-01-18 16:59:24
9943,852,3,808,105,913,9839,2021-01-19 05:38:46
9944,235,3,658,85,743,9840,2021-01-19 07:56:37
9945,55,6,1885,245,2130,9841,2021-01-19 14:34:30
9946,432,3,688,89,777,9842,2021-01-19 12:07:35
9947,185,3,528,68,596,9843,2021-01-19 15:06:41
9948,783,3,658,85,743,9844,2021-01-19 13:14:19
9949,667,2,598,77,675,9845,2021-01-19 03:18:11
9950,951,2,698,90,788,9846,2021-01-19 09:21:02
9951,673,3,558,72,630,9847,2021-01-19 16:01:05
9952,386,3,1047,136,1183,9848,2021-01-18 22:52:09
9953,665,3,797,103,900,9849,2021-01-18 22:53:10
9954,741,2,429,55,484,9850,2021-01-18 15:19:28
9955,878,6,1515,196,1711,9851,2021-01-19 13:15:27
9956,726,3,658,85,743,9852,2021-01-18 08:05:35
9957,402,3,647,84,731,9853,2021-01-18 16:40:37
9958,471,2,798,103,901,9854,2021-01-18 20:20:01
9959,966,1,599,77,676,9855,2021-01-19 02:05:40
9960,946,2,798,103,901,9856,2021-01-19 03:23:48
9961,243,2,459,59,518,9857,2021-01-19 17:09:16
9962,729,2,659,85,744,9858,2021-01-19 13:10:13
9963,637,3,808,105,913,9859,2021-01-19 12:43:32
9964,165,3,997,129,1126,9860,2021-01-18 19:23:29
9965,669,2,648,84,732,9861,2021-01-19 06:13:14
9966,46,3,847,110,957,9862,2021-01-18 21:55:59
9967,243,2,329,42,371,9863,2021-01-18 20:12:11
9968,675,2,898,116,1014,9864,2021-01-18 21:43:14
9969,45,3,697,90,787,9865,2021-01-18 01:42:56
9970,31,3,428,55,483,9866,2021-01-17 23:37:37
9971,155,2,1098,142,1240,9867,2021-01-18 01:58:20
9972,80,3,808,105,913,9868,2021-01-18 03:32:28
9973,300,3,947,123,1070,9869,2021-01-19 14:07:51
9974,14,3,558,72,630,9870,2021-01-19 11:06:54
9975,771,3,1027,133,1160,9871,2021-01-18 20:21:03
9976,704,3,688,89,777,9872,2021-01-19 14:37:54
9977,292,3,747,97,844,9873,2021-01-19 18:08:58
9978,828,3,758,98,856,9874,2021-01-19 10:16:34
9979,415,5,1286,167,1453,9875,2021-01-19 04:09:22
9980,757,2,698,90,788,9876,2021-01-18 23:55:01
9981,800,3,558,72,630,9877,2021-01-19 15:53:52
9982,303,2,429,55,484,9878,2021-01-19 13:32:49
9983,290,3,797,103,900,9879,2021-01-19 17:32:56
9984,947,3,997,129,1126,9880,2021-01-18 09:44:35
9985,975,3,827,107,934,9881,2021-01-18 17:35:38
9986,318,2,898,116,1014,9882,2021-01-18 17:06:07
9987,610,3,758,98,856,9883,2021-01-18 22:28:27
9988,521,3,647,84,731,9884,2021-01-18 17:59:32
9989,454,2,698,90,788,9885,2021-01-18 23:25:12
9990,718,3,428,55,483,9886,2021-01-19 01:34:42
9991,996,4,1396,181,1577,9887,2021-01-18 19:21:54
9992,267,2,498,64,562,9888,2021-01-18 21:29:46
9993,934,2,459,59,518,9889,2021-01-18 12:02:26
9994,522,3,688,89,777,9890,2021-01-18 18:20:24
9995,775,4,957,124,1081,9891,2021-01-19 15:53:53
9996,555,5,1586,206,1792,9892,2021-01-19 14:41:27
9997,519,2,659,85,744,9893,2021-01-19 17:20:16
9998,736,2,898,116,1014,9894,2021-01-19 18:26:50
9999,205,2,498,64,562,9895,2021-01-19 13:26:19
10000,128,3,647,84,731,9896,2021-01-19 14:29:18
10001,529,2,898,116,1014,9897,2021-01-19 15:08:24
10002,827,3,647,84,731,9898,2021-01-19 14:23:36
10003,891,3,997,129,1126,9899,2021-01-19 16:56:12
10004,350,2,728,94,822,9900,2021-01-19 12:16:07
10005,891,3,608,79,687,9901,2021-01-19 02:51:03
10006,371,3,927,120,1047,9902,2021-01-19 03:43:42
10007,188,3,428,55,483,9903,2021-01-19 09:38:34
10008,839,3,827,107,934,9904,2021-01-19 08:41:02
10009,257,2,329,42,371,9905,2021-01-19 04:44:00
10010,342,3,847,110,957,9906,2021-01-19 00:33:03
10011,948,3,578,75,653,9907,2021-01-19 11:25:35
10012,44,3,428,55,483,9908,2021-01-20 02:47:14
10013,719,3,727,94,821,9909,2021-01-19 13:52:59
10014,190,2,548,71,619,9910,2021-01-19 11:54:16
10015,334,3,997,129,1126,9911,2021-01-19 11:17:53
10016,727,3,797,103,900,9912,2021-01-18 11:07:20
10017,291,1,599,77,676,9913,2021-01-18 06:42:56
10018,162,3,697,90,787,9914,2021-01-18 05:31:15
10019,883,3,1047,136,1183,9915,2021-01-18 13:44:29
10020,156,2,798,103,901,9916,2021-01-18 10:07:48
10021,700,2,598,77,675,9917,2021-01-18 17:44:03
10022,21,3,528,68,596,9918,2021-01-18 18:56:42
10023,338,3,808,105,913,9919,2021-01-19 00:23:00
10024,937,4,1487,193,1680,9920,2021-01-19 07:49:37
10025,296,3,1197,155,1352,9921,2021-01-19 03:18:49
10026,384,3,888,115,1003,9922,2021-01-19 21:30:46
10027,726,2,1098,142,1240,9923,2021-01-17 21:52:16
10028,518,3,688,89,777,9924,2021-01-19 01:29:24
10029,460,3,947,123,1070,9925,2021-01-19 03:58:14
10030,383,2,459,59,518,9926,2021-01-19 01:42:41
10031,201,5,1595,207,1802,9927,2021-01-19 00:55:49
10032,867,1,149,19,168,9928,2021-01-19 02:47:44
10033,1,3,1027,133,1160,9929,2021-01-19 08:55:06
10034,13,5,1276,165,1441,9930,2021-01-19 02:15:22
10035,396,1,499,64,563,9931,2021-01-18 17:59:37
10036,130,3,808,105,913,9932,2021-01-18 22:29:21
10037,86,2,748,97,845,9933,2021-01-18 11:26:02
10038,341,3,727,94,821,9934,2021-01-18 09:42:41
10039,350,3,647,84,731,9935,2021-01-19 01:08:38
10040,57,5,1895,246,2141,9936,2021-01-18 10:04:22
10041,839,3,578,75,653,9937,2021-01-18 10:55:58
10042,21,1,499,64,563,9938,2021-01-18 20:30:11
10043,93,6,1935,251,2186,9939,2021-01-19 10:44:10
10044,117,2,598,77,675,9940,2021-01-18 06:30:55
10045,760,3,1197,155,1352,9941,2021-01-19 03:35:37
10046,278,6,1994,259,2253,9942,2021-01-18 07:43:19
10047,571,2,598,77,675,9943,2021-01-18 15:49:48
10048,852,3,428,55,483,9944,2021-01-18 18:28:28
10049,316,6,1305,169,1474,9945,2021-01-19 07:51:43
10050,495,1,399,51,450,9946,2021-01-19 10:17:56
10051,226,1,399,51,450,9947,2021-01-19 16:49:55
10052,629,2,898,116,1014,9948,2021-01-19 12:34:16
10053,630,2,898,116,1014,9949,2021-01-19 15:44:20
10054,793,3,897,116,1013,9950,2021-01-19 13:46:32
10055,134,3,808,105,913,9951,2021-01-19 05:14:40
10056,321,3,897,116,1013,9952,2021-01-19 10:56:23
10057,610,5,1895,246,2141,9953,2021-01-19 17:18:24
10058,451,2,498,64,562,9954,2021-01-19 00:06:35
10059,110,5,1306,169,1475,9955,2021-01-19 00:49:46
10060,919,2,429,55,484,9956,2021-01-18 17:06:46
10061,314,3,1127,146,1273,9957,2021-01-19 13:37:56
10062,540,3,608,79,687,9958,2021-01-18 09:35:18
10063,339,3,827,107,934,9959,2021-01-18 16:46:24
10064,573,3,947,123,1070,9960,2021-01-18 21:18:05
10065,141,2,329,42,371,9961,2021-01-19 03:25:15
10066,91,3,528,68,596,9962,2021-01-19 03:42:46
10067,312,2,329,42,371,9963,2021-01-19 18:01:29
10068,141,3,827,107,934,9964,2021-01-19 13:13:09
10069,665,3,947,123,1070,9965,2021-01-19 12:54:00
10070,335,2,898,116,1014,9966,2021-01-18 20:03:30
10071,672,3,747,97,844,9967,2021-01-19 06:39:29
10072,117,4,1596,207,1803,9968,2021-01-18 21:56:57
10073,468,3,747,97,844,9969,2021-01-18 21:29:55
10074,942,3,528,68,596,9970,2021-01-18 22:30:41
10075,692,2,498,64,562,9971,2021-01-18 01:47:20
10076,830,3,597,77,674,9972,2021-01-18 00:29:25
10077,456,5,1136,147,1283,9973,2021-01-18 04:21:10
10078,539,4,1596,207,1803,9974,2021-01-18 05:45:14
10079,880,3,478,62,540,9975,2021-01-19 16:01:04
10080,699,2,498,64,562,9976,2021-01-19 13:03:57
10081,154,6,2244,291,2535,9977,2021-01-18 22:44:10
10082,693,3,997,129,1126,9978,2021-01-19 15:28:40
10083,803,2,329,42,371,9979,2021-01-19 20:38:52
10084,174,2,1098,142,1240,9980,2021-01-19 11:22:10
10085,359,1,499,64,563,9981,2021-01-19 04:49:26
10086,539,3,478,62,540,9982,2021-01-19 00:35:50
10087,629,5,1755,228,1983,9983,2021-01-19 16:31:56
10088,564,2,898,116,1014,9984,2021-01-19 14:12:00
10089,904,3,1047,136,1183,9985,2021-01-19 20:01:18
10090,511,5,1456,189,1645,9986,2021-01-18 12:01:01
10091,210,2,798,103,901,9987,2021-01-18 18:41:11
10092,261,3,1047,136,1183,9988,2021-01-18 19:36:09
10093,976,2,598,77,675,9989,2021-01-18 23:46:13
10094,88,5,1975,256,2231,9990,2021-01-18 20:34:07
10095,243,2,598,77,675,9991,2021-01-19 00:13:58
10096,940,5,1056,137,1193,9992,2021-01-19 03:57:03
10097,141,3,1027,133,1160,9993,2021-01-18 21:28:55
10098,908,2,698,90,788,9994,2021-01-18 21:53:58
10099,498,2,898,116,1014,9995,2021-01-18 12:48:55
10100,31,1,149,19,168,9996,2021-01-18 18:48:25
10101,285,3,658,85,743,9997,2021-01-19 16:25:29
10102,883,3,1247,162,1409,9998,2021-01-19 16:13:30
10103,240,6,1036,134,1170,9999,2021-01-19 17:45:46
10104,725,5,1995,259,2254,10000,2021-01-19 18:37:03
